reviewerID,reviewerName,date(YYYYMMDD),reviewCount,Avgrating,avg_wordcount,sum_helpful_votes,sum_unhelpful_votes,overall_helpfulness
A10063PJ5C9WQQ,D. Seelye,20121017,21,4.380952380952381,90.19047619047619,8,3,5
A100NGGXRQF0AQ,"M. Hyman ""Artist at large""",20030828,22,3.772727272727273,275.72727272727275,72,26,46
A100UD67AHFODS,"Expressed Reviews ""Expressed Reviews""",20031208,102,4.5588235294117645,251.64705882352942,2328,319,2009
A100WO06OQR8BQ,"Duffer. ""Bo""",20080404,121,3.6611570247933884,149.98347107438016,379,243,136
A1016Q5UDME15Z,Shon,20120606,21,4.714285714285714,49.19047619047619,11,4,7
A102F7EHNVW30Q,N. Hedgeman,20130831,24,4.5,88.5,22,5,17
A102RLOGIBBDMW,"Cool Chris ""Cool C""",20081124,26,4.423076923076923,350.0769230769231,242,42,200
A103QH6R6A4FT1,"Rick ""Las Vegas Dealer""",20090601,21,4.666666666666667,80.0952380952381,5,1,4
A10471FSILZ25C,J. S. White,20080604,29,4.172413793103448,117.20689655172414,100,5,95
A105OCSP35YJG9,R. Cormier,20070111,21,5.0,53.857142857142854,7,3,4
A105S56ODHGJEK,"Peace Daddy ""Eclectic ReflectionZ""",20071014,67,3.8805970149253732,149.70149253731344,132,44,88
A105TOJ6LTVMBG,"Aless ""&#34;I came like Water, and like Wind ...",20090702,64,3.859375,55.15625,28,22,6
A106K1RIUF902A,"Derek Dean ""musician, home-recordist, photogr...",20100804,23,4.782608695652174,158.8695652173913,31,9,22
A106Q1A6LGU4DP,gnapye,20060610,21,4.333333333333333,220.38095238095238,83,10,73
A107CTGSINY3GJ,"Masao Miwa ""MDM""",20070331,34,4.705882352941177,94.82352941176471,75,14,61
A107K10JTO8NSH,jonnii,20120622,33,3.8484848484848486,45.75757575757576,10,6,4
A108EEYSHGDL6O,"3:23 Tech ""txplshrk""",20100205,23,4.565217391304348,39.69565217391305,6,0,6
A108GOZ37A7B75,Dillon Welch,20101118,26,4.8076923076923075,133.1153846153846,13,3,10
A108XABRHAA9E7,YSC,20030115,39,3.769230769230769,631.7692307692307,3261,151,3110
A108Z49RERJK4O,imvho,20041022,21,4.523809523809524,296.3809523809524,136,7,129
A10938QNO7IYIB,"Ulises Bocchio ""Ulises Bocchio""",20081226,24,4.458333333333333,43.875,5,0,5
A109XLG7SJQAIA,"Doc Goodbyte ""Doc""",20041206,29,4.137931034482759,95.75862068965517,66,49,17
A10A6YT9AD02PD,E. Ho,20091003,23,4.391304347826087,128.56521739130434,16,2,14
A10AFVU66A79Y1,"Renita ""Flo""",20070915,63,4.174603174603175,337.6984126984127,267,57,210
A10B6G6W3DW1EY,Luopo,20100617,37,3.864864864864865,47.729729729729726,63,193,-130
A10C5CJK1YKGV0,Steffan Piper,20080203,37,4.054054054054054,270.4054054054054,229,68,161
A10CRW7XRJBJ2G,jjme9,20110311,36,3.8055555555555554,55.416666666666664,15,14,1
A10D3ZJ7KSJV42,WM,20040107,23,4.086956521739131,212.82608695652175,57,6,51
A10DFH2Y5LWEU0,S. Gonchar,20111004,25,4.16,129.68,19,3,16
A10EC2MMQKHKBY,"Steven R. Roth ""AKA GeneralEclectic""",20090909,25,4.16,447.48,506,39,467
A10FUCF4N44ZT1,C farl,20110804,26,3.8076923076923075,132.8846153846154,36,13,23
A10G4BPT5MGBHY,Julie Neal,20080221,40,4.575,205.825,2207,163,2044
A10H24TDLK2VDP,William Jens Jensen,20070109,52,4.365384615384615,192.96153846153845,73,28,45
A10ISTV0QD8FAC,"Turner. ""Captain Stubing""",20110119,22,3.909090909090909,89.31818181818181,38,3,35
A10JPZAYDGFHEV,Damian Marynski,20110113,35,4.714285714285714,115.51428571428572,12,5,7
A10JVQAKUOK2A7,Omar,20110406,22,4.045454545454546,70.22727272727273,12,8,4
A10JXY2MAO7MNC,L. S. Brodsky,20060713,21,4.0476190476190474,62.857142857142854,39,6,33
A10K7QBLLN6VLE,MomNMore,20090510,22,4.0,129.5909090909091,16,1,15
A10KGRO01ZOXK5,D. K. Mckenzie,20121116,23,4.913043478260869,96.04347826086956,2,1,1
A10LWFKVC21F82,David G,20110319,29,3.8620689655172415,105.37931034482759,55,22,33
A10M0GF5ZFODYU,Frank,20110109,32,4.46875,124.15625,20,2,18
A10NMELR4KX0J6,Aj,20070104,82,4.195121951219512,141.26829268292684,131,29,102
A10NQKIG7NXUR7,Fusion,20120425,27,4.518518518518518,119.07407407407408,72,6,66
A10O7THJ2O20AG,jnaki,20110927,72,5.0,143.29166666666666,16,6,10
A10PEXB6XAQ5XF,Michael Gallagher,20100723,105,4.0285714285714285,219.55238095238096,5313,359,4954
A10R1SL31CJII8,Michael,20090222,25,3.96,78.6,22,9,13
A10SNKRHVEEE9P,"David Golombowski ""dgolombowski""",20071204,24,3.875,102.5,50,18,32
A10SX0QRXY0C2Y,J. Jennings,20100216,28,4.25,170.21428571428572,52,8,44
A10TJRENZ71JY0,"Mel46 ""RetiredGeek""",20130118,30,5.0,72.2,3,1,2
A10U8DJAPJJI8I,"William Van Hefner ""William Van Hefner""",20020704,24,3.9583333333333335,426.8333333333333,257,14,243
A10UHQH1YL5Q6B,MONTYHADES,20121125,38,4.894736842105263,63.60526315789474,5,4,1
A10VVWWZIFLPV9,Connor,20111227,25,4.72,50.44,14,4,10
A10VXW5LHANT2D,M. Bartlett,20100826,32,3.9375,51.625,19,15,4
A10VYNMVS32Z2F,"Maurice Naragon ""Maurice Naragon""",20070512,39,4.666666666666667,40.64102564102564,30,6,24
A10X33VL24RGDK,"Francois Morel ""FMo the Whizz""",20090819,21,4.523809523809524,62.095238095238095,8,4,4
A10X7TP9E3OB1A,MaxP,20120214,30,4.4,189.03333333333333,45,10,35
A10X9ME6R66JDX,Hugo M. M. Rabson,20090822,62,4.709677419354839,42.29032258064516,60,10,50
A10Y058K7B96C6,midnight821,20070419,113,4.477876106194691,222.57522123893804,372,47,325
A10Z51XLV63OA6,Brian Rose,20120522,21,4.571428571428571,82.66666666666667,8,3,5
A10ZBR6O8S8OCY,Dat Hong,20071010,77,4.64935064935065,220.11688311688312,186,38,148
A10ZFE6YE0UHW8,C. MacPhail,20030622,120,3.825,224.375,938,69,869
A110PC8C5Y7MQD,Grigori,20101102,52,3.923076923076923,49.21153846153846,38,13,25
A110VKXAVLAYKY,maverick75,20110913,34,4.294117647058823,96.23529411764706,41,7,34
A111WCUF5KA2I6,DM,20130823,31,5.0,59.03225806451613,6,7,-1
A112E6NE5MGEFM,amazone,20090314,22,4.863636363636363,32.59090909090909,6,12,-6
A112XLN4J4TYLR,Mor and Tookie,20080725,21,4.380952380952381,81.9047619047619,26,6,20
A113PB4KMWXB3S,B Richards,20100204,27,4.037037037037037,124.62962962962963,20,8,12
A1143YEAZYMYHJ,Jamie Ratliff,20011227,73,4.383561643835616,154.84931506849315,597,64,533
A114TMHW9GRMPB,PM_SuperFreak,20040913,22,4.363636363636363,169.13636363636363,79,4,75
A114WE1URT580Y,Arturo Fukuda Ll,20050118,21,4.571428571428571,109.23809523809524,202,28,174
A11548ZOIDAELN,S P,20110216,23,4.304347826086956,136.7826086956522,56,85,-29
A1158GPHFBJ70U,Christopher Hutton,20131003,22,4.0,33.45454545454545,5,4,1
A1162YPK0AI4CN,Pat,20110717,26,4.153846153846154,85.76923076923077,20,16,4
A116J8AUC3JSN2,"Harkius ""harkius""",20100604,25,3.32,307.12,64,28,36
A116K49GU3QGW9,"A Guy ""Otis""",20101204,31,3.838709677419355,116.90322580645162,13,3,10
A117LA3RXR4IIC,"Gregory A. ""Greg""",20121219,25,3.96,44.32,4,1,3
A117XUS2KI1M04,"Mike Reingold ""Zombie Prepper""",20120905,25,4.56,79.36,212,38,174
A1186VP35L3PE1,T. Roberts,20100720,21,4.619047619047619,38.95238095238095,1,1,0
A118A49ORGNEUM,D. Barber,20071031,31,4.193548387096774,361.3225806451613,157,31,126
A118V341FMA1EL,MeMoNeer,20121013,21,3.5238095238095237,43.714285714285715,8,22,-14
A11A85Z916SLHK,Robert S. Burazin,20070115,23,4.304347826086956,45.391304347826086,16,3,13
A11D1KHM7DVOQK,"Person ""qazwsx34651""",20041115,56,3.3035714285714284,385.39285714285717,596,107,489
A11ED8O95W2103,"lighten_up_already2 ""lighten_up_already2""",20051218,56,3.9642857142857144,210.25,597,142,455
A11EGM5KO12IQ2,"Harold Melton ""KV5R""",20120508,24,4.208333333333333,222.95833333333334,62,7,55
A11ENPLSWWU4RA,Thomas J. Carter,20080725,21,4.761904761904762,32.142857142857146,13,5,8
A11ERLOY4HCPA4,Big Ron,20060628,27,3.962962962962963,182.44444444444446,66,21,45
A11EXFO14WEJM1,Sudarshan Karkada,20040707,69,4.478260869565218,224.97101449275362,558,111,447
A11EYMH9UV9XG7,greenmantis,20070130,61,4.442622950819672,113.32786885245902,130,26,104
A11F60W72FUBH8,"Henry Halladay ""Slide show creator""",20081018,32,4.75,52.59375,23,6,17
A11F8B8GQURI84,"Michael R. Serovey ""chess nut""",20130802,23,4.391304347826087,68.78260869565217,1,3,-2
A11FTACZ2S9IOS,Crank,20050323,22,4.2727272727272725,76.27272727272727,53,42,11
A11FX8HL2ANK6T,Peter Suslock,20120127,60,4.65,411.8333333333333,588,19,569
A11HD68D6QXXQ6,Tebowned,20121015,31,4.451612903225806,69.0,5,2,3
A11I1I9QLMAM1A,S. Power,20051109,185,4.481081081081081,183.21621621621622,740,171,569
A11IHV8N5A8IC7,Derek D. Bergey,20081019,23,4.695652173913044,191.43478260869566,43,31,12
A11INIL2YFJ137,Chris,20090109,28,4.75,68.53571428571429,4,1,3
A11INR8WEB20VM,Gaffer,20100730,22,4.2727272727272725,99.77272727272727,7,2,5
A11IXJ8M1JO296,"MK Reagan ""Mary Kay""",20030208,53,4.226415094339623,85.66037735849056,51,14,37
A11JI4CX8C84OT,JOHN,20130812,25,3.68,136.0,19,6,13
A11K70GWSB7A5Z,Nicole Del Sesto,20091119,25,3.8,150.36,47,18,29
A11KQADBYE0UZL,GLIverson,20100828,49,4.653061224489796,229.9387755102041,35,15,20
A11KZ906QD08C5,"Bill McLean ""Trust But Verify""",20050429,184,4.440217391304348,156.42391304347825,580,181,399
A11LIFTP3X8SVP,VLAD DIDENKO,20100101,21,3.4761904761904763,69.0,33,4,29
A11LNPG39A2ZV4,Kristi Swede,20060916,47,4.276595744680851,151.40425531914894,110,18,92
A11N9M2212IPJ,Lawrence Blankenship,20130403,28,4.857142857142857,34.607142857142854,5,23,-18
A11NR4AJK9TNQM,"jaldeborgh ""jaldeborgh""",20080623,37,4.405405405405405,130.8108108108108,74,22,52
A11NX5C797F7XV,Hector Martin Yanez Banos,20050921,28,4.5,176.35714285714286,81,14,67
A11O09HFDUW1IJ,"Joseph Bejm ""JB""",20090224,25,4.2,128.2,23,26,-3
A11OH777695MM7,smaw51,20120615,26,4.5,70.23076923076923,34,20,14
A11OO9FDOGHXC5,vodkachicken,20110212,22,3.9545454545454546,104.68181818181819,40,12,28
A11OQUV1ZI2MT2,Soccer Mom,20100904,23,4.6521739130434785,204.0,28,17,11
A11OTLEDSW8ZXD,CGScammell,20070216,85,4.247058823529412,166.54117647058823,184,58,126
A11P105WVK5240,"Bocaboy ""BocaBoy""",20020225,51,4.607843137254902,332.1764705882353,721,59,662
A11QD9H9KTEK45,"John D. Biggs ""tech guru""",20091113,33,4.303030303030303,110.36363636363636,114,14,100
A11R5VW7IM6ISQ,Sonoma's Davey,20060606,46,4.3478260869565215,182.7173913043478,127,11,116
A11S4NOJZGS28Q,Maury Swoveland,20081130,25,4.64,105.8,44,7,37
A11SPSEM08VIXX,"Carbonadam ""Ladies and gentleman, I hope that...",20060823,45,4.155555555555556,223.06666666666666,320,73,247
A11SWG9T60IQH8,Turtles all the Way Down,20081017,28,4.5,196.17857142857142,121,30,91
A11T3KV9PJQ5NI,"Lowrider ""lowrider""",20080507,23,3.9130434782608696,144.2608695652174,13,7,6
A11T7CEFCSAM9W,"PC ""Sleepless in LA""",20020724,35,4.228571428571429,89.62857142857143,162,30,132
A11T807LX2EF00,Michael,20050615,89,4.561797752808989,206.57303370786516,1634,115,1519
A11ULAZ4B5ZXC8,Wayne,20120128,51,4.921568627450981,47.09803921568628,13,5,8
A11V0UD681NIWR,Howard,20120723,22,4.590909090909091,63.13636363636363,6,2,4
A11V3GPODBXN7C,,20120404,22,4.681818181818182,39.04545454545455,6,5,1
A11V9E4044WFNK,"LesB ""Les Borean""",20110816,22,4.2272727272727275,106.0,20,7,13
A11VI2ORDN0AHS,Ponch,20120910,25,4.64,36.0,4,3,1
A11XAIFA10G7TS,"Holly ""Book addict""",20060123,21,4.238095238095238,240.85714285714286,134,3,131
A11XDU6CI6OT4I,"J. Saenz ""JMS""",20070622,27,3.5925925925925926,203.62962962962962,57,12,45
A11Y478PJDW2QV,"R. Walker ""rw266""",20060124,28,3.25,83.25,29,26,3
A11YIHB6IW352W,Theodore J. Jackson Sr.,20040827,51,4.607843137254902,88.70588235294117,22,12,10
A11YOTONCPRQ9S,P.L.,20071211,61,3.3278688524590163,146.78688524590163,412,135,277
A11YUCEJ399PHL,Boomer,20100331,25,4.68,178.84,29,10,19
A120BPRX233DLL,"Greg ""smitz0327""",20080406,35,4.4,148.4,67,10,57
A120KBT5UAQEZP,"Wayne Paterson ""allpar2""",20050721,26,3.576923076923077,103.38461538461539,89,23,66
A121QRWXZIO6UP,Jarrett Venturini,20120530,22,4.590909090909091,179.0,12,1,11
A122SFGLAHQLSJ,Menthol Rum,20070921,31,4.419354838709677,215.96774193548387,22,11,11
A123E03CA53CHJ,Ben,20140708,22,5.0,5.7272727272727275,2,0,2
A1247LFDYISISU,Voyager,20050707,25,3.72,147.6,205,18,187
A124WZCUIH2T7W,G. Mortillaro,20080421,44,4.454545454545454,129.04545454545453,158,24,134
A125Y2G5B1CXSX,"J. Chinn ""Movie Guy""",20061204,23,4.478260869565218,115.0,181,21,160
A1274QVFP1YDOS,RichCastillo,20110421,27,4.185185185185185,175.14814814814815,78,10,68
A127GZ51PD786F,B. Snelgrove,20120102,26,4.115384615384615,71.88461538461539,5,2,3
A127P8A5QQ05KN,Austin David,20040128,29,4.620689655172414,77.65517241379311,49,11,38
A128K4SSWJGSKL,kids_bus_driver,20070801,27,4.481481481481482,65.48148148148148,42,7,35
A1291T1FHJ0CQP,Grenik,20120326,34,4.352941176470588,103.61764705882354,16,1,15
A1298BZY33NTYV,Seetz,20100902,21,4.285714285714286,55.57142857142857,6,4,2
A12ANFNOSMW5VD,"Penfist ""Dulce bellum inexpertis""",20060628,47,3.9574468085106385,153.95744680851064,248,47,201
A12B7ZMXFI6IXY,"Hyoun Kim ""Faluzure""",20110325,46,4.891304347826087,463.1304347826087,2767,113,2654
A12C7XYE27B7KK,Newbie,20120703,22,4.590909090909091,42.77272727272727,2,0,2
A12DHI42CBTWFS,"LegalEagle ""JS""",20090315,29,4.241379310344827,141.13793103448276,20,7,13
A12DLJESJKM1OQ,Roy Chan,20030223,42,4.5,270.8809523809524,1281,114,1167
A12DQZKRKTNF5E,Andrea Polk,20060716,216,4.25462962962963,505.52314814814815,3732,288,3444
A12E0Y0J6584RT,Seanna,20080830,40,4.9,245.4,110,25,85
A12E0Y64P3KT1K,Amazon Customer,20110109,35,4.514285714285714,215.22857142857143,63,11,52
A12ENBT314RFXR,Patricia Gray,20100219,34,4.352941176470588,215.14705882352942,312,54,258
A12EVK82QUTSA6,Allen C. Huffman,20061103,68,4.426470588235294,334.5,237,18,219
A12G8WFVFU2RGO,J. Dubberly,20110412,41,4.7073170731707314,91.2439024390244,36,21,15
A12GIOKE26ZFKJ,Cutie,20131223,31,4.838709677419355,29.225806451612904,2,1,1
A12GKGLR2L4MZY,Cody,20131202,38,4.657894736842105,145.05263157894737,103,14,89
A12GUH9ZJ59KII,Rock Star,20120809,26,4.846153846153846,57.84615384615385,22,1,21
A12HAL61YXO21B,David Ludwig,20120625,27,4.703703703703703,86.37037037037037,57,6,51
A12HDYS3EUBZ9O,"Meg ""Meg's Bazaar""",20060407,21,4.761904761904762,219.66666666666666,6,3,3
A12HGA7UPD8PFO,"Belinda J. J. Enkins ""BJJ""",20080930,27,4.62962962962963,35.148148148148145,9,5,4
A12HP7HJIZHQUG,"SigmaSpace ""SigmaSpace""",20081011,26,4.5,95.92307692307692,48,7,41
A12HSKDDMR61WR,WarWagon,20040323,22,4.318181818181818,97.04545454545455,74,11,63
A12HYI8Q6T54SA,David,20110321,29,4.620689655172414,58.37931034482759,6,1,5
A12I1E0HR3BKY7,Performance Emulation,20071211,28,4.5,60.964285714285715,8,2,6
A12JSZZF5BFKX2,L. Moskowitz,20071018,30,3.8666666666666667,169.93333333333334,61,10,51
A12JYLOG4UMP77,NDS,20060325,22,3.5454545454545454,93.27272727272727,36,15,21
A12KD20K7PS9NI,Waylone,20080919,22,4.681818181818182,73.4090909090909,14,5,9
A12LH2100CKQO,God is a refuge for us (Psalms 62:8),20080502,42,4.761904761904762,241.45238095238096,182,13,169
A12LTYDEZDUEIV,Neutralist,20120110,27,4.2592592592592595,218.22222222222223,76,15,61
A12MFMZAN6GN9W,"Insite4U ""insight4u""",20100127,21,4.809523809523809,75.9047619047619,27,5,22
A12N91QD1JLZPP,Eric Herrera,20130702,21,4.714285714285714,237.76190476190476,48,2,46
A12NOROCXAPTU5,"Paul Bonaddio(Castropa531) ""PrB""",20110824,25,4.48,176.32,43,14,29
A12NQ4LG22NC7V,Rafael B,20111020,28,4.142857142857143,133.32142857142858,19,5,14
A12O5SEIF162P8,"William A. Nolan ""freeholder""",20051226,48,4.645833333333333,178.97916666666666,538,24,514
A12OGABSUH6XVH,proactivens,20111011,24,4.0,42.416666666666664,7,4,3
A12R3YGEHW7D8G,Faxanadu,20120309,71,4.352112676056338,103.95774647887323,205,20,185
A12S8UQEIPZJKE,Kay S.,20100916,26,4.3076923076923075,210.46153846153845,35,10,25
A12SSZIN555FTL,A. M. Steiner,20060218,31,4.838709677419355,114.48387096774194,150,19,131
A12THZQ2TV33KZ,"James Mccarty ""expose""",20120124,26,4.5,174.19230769230768,129,13,116
A12UIM7OU6PFQ5,psuarmy,20121009,23,4.3478260869565215,70.1304347826087,8,1,7
A12WV3TL2PXS5Q,chris,20120731,21,4.761904761904762,28.523809523809526,4,0,4
A12WY0ZDGVOZQS,Philip Johnson,20120712,24,3.5833333333333335,145.33333333333334,73,48,25
A12XHV9C0P6W6K,J. Silvia,20100121,21,4.380952380952381,79.9047619047619,43,8,35
A130VGG4P4PW5J,"SirTaz ""Geniebugged""",20091214,21,4.571428571428571,79.14285714285714,21,60,-39
A131E28H6DRH61,Jimmy M.,20120202,29,4.724137931034483,65.51724137931035,32,5,27
A131EK7QBO1PBE,Traveller,20060101,25,3.8,88.8,152,42,110
A1328E7Y9FJNGP,M. Dowdie,20070705,26,3.576923076923077,246.42307692307693,128,28,100
A132CBT7KF85K9,"Yogi Moore ""YogiM""",20071229,41,3.341463414634146,173.09756097560975,167,63,104
A132ETQPMHQ585,"DonnaSays ""Amazon makes my Life easy!""",20090203,36,4.222222222222222,30.166666666666668,28,15,13
A132L0QWXE6B1,Greg,20120803,24,4.666666666666667,42.458333333333336,2,2,0
A134HFABW6BMZL,Pericombobulation53,20091019,23,4.043478260869565,432.39130434782606,57,8,49
A134KTZ5BGOOXA,Mal-2,20070627,27,3.888888888888889,288.5925925925926,309,33,276
A134ZZ342PLBDG,"D. Casey ""dmek69""",20020617,23,4.3478260869565215,70.04347826086956,14,3,11
A135NKWPQW8SAM,Harry Joseph,20110225,21,4.333333333333333,369.95238095238096,93,5,88
A13700AF4X40YG,Loves Books in MD,20081217,41,4.536585365853658,257.6341463414634,90,18,72
A137T44OPXY2I2,Ron,20070419,41,4.390243902439025,58.80487804878049,26,7,19
A137YN42MHHIVX,Rob S.,20030731,25,3.88,233.8,477,66,411
A13A943ZWQVT0Z,"A. Gordon ""A. Gord.""",20070806,22,3.4545454545454546,150.4090909090909,38,13,25
A13A9XV81EQF30,MJH-64,20140322,21,4.714285714285714,84.47619047619048,1,0,1
A13BX9O5UDBILC,Jong Lee,20050125,68,4.088235294117647,66.44117647058823,238,58,180
A13D4AOJLCKNSY,"Yakov Gorodnitsky ""YG""",20120613,21,3.5238095238095237,132.0,72,14,58
A13DOL9CW84I1C,Daniel Nguyen,20071231,28,4.25,98.89285714285714,87,61,26
A13DV467DOBP5Z,"Daniel Haworth ""Flechmen Foxwood""",20110127,22,3.8636363636363638,208.5909090909091,20,3,17
A13EQE9EY2ET93,Jaime Moreno,20061221,55,3.981818181818182,239.3272727272727,100,31,69
A13H2ZRENPV9E,Prof. Crayzee,20071204,46,3.5869565217391304,199.58695652173913,349,53,296
A13H5US9Z7L9M7,K.Wagner,20080209,24,4.166666666666667,201.20833333333334,97,22,75
A13HUE4D2KGH8O,sn315on,20070614,32,5.0,105.53125,49,5,44
A13I8I03W1SYPD,"Hammy Technoid ""5.1 junky""",20071224,26,4.461538461538462,123.96153846153847,22,4,18
A13IGL87IS7LHI,"Leonardo Reyes Perez ""LeRe""",20090522,29,4.344827586206897,55.37931034482759,21,22,-1
A13IKQCJKFAP5S,applegd07,20121219,24,4.416666666666667,53.625,4,2,2
A13INHN7UX7JY5,BostonAaron,20040606,22,4.0,249.36363636363637,198,23,175
A13JB1PC2F89MY,George Mitchell,20081129,24,4.666666666666667,51.125,20,4,16
A13KG9WCWFDKOK,"xgalaxy ""xgalaxy""",20090102,21,3.8095238095238093,161.52380952380952,62,47,15
A13KUKTVB3HOCT,JK,20110307,22,4.590909090909091,91.18181818181819,60,2,58
A13KWW61P2MNL1,Jess Newcomb,20111221,22,4.863636363636363,32.09090909090909,8,8,0
A13L45CSY7TEQZ,ndrwum,20130805,22,4.045454545454546,21.363636363636363,1,2,-1
A13L6AIY06ZE7B,Jim,20120830,21,4.380952380952381,67.33333333333333,6,5,1
A13LA6WF3JLEZR,Zulfiqar Ali Naushad,20070218,23,4.826086956521739,72.08695652173913,56,4,52
A13LA82RVQ4OBM,Boris,20110827,24,4.583333333333333,24.875,43,6,37
A13MKSASQ6YWL7,B. Willis,20080202,44,3.727272727272727,328.90909090909093,1399,97,1302
A13O50D40K6XX1,Phoj,20110525,26,4.5,184.03846153846155,61,12,49
A13OUS97G7238Q,"L Richard Heward ""Published Author""",20100521,21,4.714285714285714,62.95238095238095,12,3,9
A13PD0PF0KAAUO,"S. Lee ""S L""",20070326,26,3.923076923076923,311.53846153846155,92,15,77
A13PJOSPMW65CW,"nokia6230 ""nokia6230""",20030101,21,3.6666666666666665,256.6190476190476,284,33,251
A13PPLJUE2L3UU,"D. King ""wizird""",20091101,26,4.153846153846154,116.96153846153847,11,6,5
A13PT03EWR07XM,En P. Junction,20100720,25,3.96,263.76,294,21,273
A13QGI4AZOB64K,"Amazon Customer ""Animaleyez""",20080828,24,4.75,142.70833333333334,21,5,16
A13QOK3SKIT9QL,"J. L. Sanchez ""Arnold C.""",20060308,38,3.8421052631578947,49.3421052631579,43,19,24
A13SAVYJLEH4D1,J. R. Murphy,20110920,23,4.782608695652174,38.95652173913044,5,0,5
A13SV7V95KQBXQ,"mz&#335;ni&#257;n ""Being an Earthling, Livi...",20070108,27,4.2592592592592595,148.74074074074073,77,45,32
A13T0V3LHOTHDL,"E. Treants ""tree""",20070626,39,4.333333333333333,127.94871794871794,135,8,127
A13T2XWEGL7DU7,"Stuart Sweetow ""sweetow""",20070618,32,3.53125,69.15625,46,13,33
A13T4T3QOSII3I,Playgolfandtennis,20101217,24,4.541666666666667,49.25,10,2,8
A13TRW12RTM5GR,G. Barber,20080527,30,4.6,47.333333333333336,4,1,3
A13U975DFXBU44,Knits in Tardis,20110824,28,4.071428571428571,432.0357142857143,98,18,80
A13UDAIB4TYB0C,Dean Robinson,20020702,36,3.4444444444444446,128.58333333333334,129,46,83
A13UX3ONE34JJK,Blaise170,20120519,31,3.967741935483871,96.25806451612904,19,5,14
A13VY0ZQM7QBAJ,"H. Chen ""Black Rice - Born To Dye""",20090115,38,4.0,194.73684210526315,92,10,82
A13WBUX01Q4D35,adammb,20090324,23,4.6521739130434785,69.0,52,26,26
A13WOT3RSXKRD5,LD,20110512,74,4.648648648648648,236.52702702702703,355,34,321
A13WREJ05GMRA6,Cosmic Jester,20120104,54,3.7222222222222223,45.092592592592595,10,4,6
A13X3KB8XPS0ZX,azezal,20061102,27,1.5925925925925926,90.44444444444444,102,172,-70
A13X7XBBT1DN8U,KB,20060206,30,4.2,122.26666666666667,115,25,90
A13XP8Y6A33IVB,Bronco628,20110827,26,4.730769230769231,45.38461538461539,15,7,8
A13XQPWNCS2CHP,"S. E. Weatherby ""weterb""",20060317,22,4.636363636363637,46.86363636363637,21,7,14
A13Y53J8CAJL6A,"Todd ""Todd""",20080227,24,4.416666666666667,354.0416666666667,780,27,753
A13YHP6GYXZAEX,Canon54,20100918,32,4.78125,52.71875,14,4,10
A13Z96HR8EEF24,Terry L,20100324,40,3.825,103.375,314,59,255
A13ZQEG6DSUW3H,newlinux,20130102,38,4.157894736842105,62.44736842105263,10,0,10
A140X1CP9DZMWF,M. Swift,20080803,24,4.25,125.95833333333333,49,11,38
A1413HQ9UF22C5,Phantom Server,20121212,26,4.576923076923077,89.5,21,8,13
A1414YWW0VUQCJ,"Matthew Morse ""Matthew""",20100428,26,4.153846153846154,268.2307692307692,120,16,104
A141OPVE376YFI,Paul Gifford,20040408,63,4.587301587301587,284.8095238095238,856,67,789
A141R97FHSSUQ0,skrishna,20080906,53,4.39622641509434,188.8490566037736,518,48,470
A141W8WHW9AC3H,"Nelly ""Vision Teacher""",20060120,37,3.4324324324324325,218.1891891891892,170,25,145
A1430AS4J7BMTY,"Kevin Dorff ""kdorff""",20050726,23,4.3478260869565215,147.7391304347826,267,6,261
A1435P5AMCPB3X,"Concerned One ""Thrashfan""",20060614,54,4.444444444444445,210.14814814814815,252,14,238
A1437CAM9CNC1E,"Kate August ""Bookdweller""",20100723,46,3.9347826086956523,98.26086956521739,23,18,5
A143KG9R30OIX7,Miss D,20100209,21,4.0,152.9047619047619,30,10,20
A143LJ4G2OPP7T,"Ken C ""kenjunior""",20120629,26,4.384615384615385,54.73076923076923,5,2,3
A144FHU3VKL4P9,Thomas Centofanti,20081228,24,4.791666666666667,34.583333333333336,2,5,-3
A145B8OHVNNFAJ,Steward Willons,20070118,66,4.287878787878788,478.45454545454544,788,112,676
A145K6RGUUMAEO,Uz,20111126,45,4.333333333333333,39.15555555555556,8,5,3
A145LBW8ZHF0TW,"Tough Customer ""Tough Customer""",20081017,46,4.1521739130434785,118.21739130434783,123,26,97
A146CA37V0450V,ken,20120212,42,4.285714285714286,185.5,23,7,16
A146H6A41B26QT,"J. Marren ""jtm497""",20050120,23,4.391304347826087,131.91304347826087,110,22,88
A14738H3YYX7ZC,John Popp,20100608,30,4.566666666666666,103.63333333333334,25,9,16
A148F4ZOSD82OW,SirPasta117,20130312,28,3.857142857142857,120.78571428571429,12,2,10
A1497ZP3YIUJRL,Jose M. Garcia,20110621,23,3.4347826086956523,66.21739130434783,10,12,-2
A149RNR5RH19YY,matt.mingkee,20030719,114,4.008771929824562,157.42105263157896,677,182,495
A14AA0VMT21EB2,oldseagull,20070506,24,4.791666666666667,80.33333333333333,132,10,122
A14AGGUYZMJX3S,matt1234,20110925,23,4.6521739130434785,167.2173913043478,39,3,36
A14ANXXFV8JUWY,"BuyItOnce ""Just_Slightly_Geeky""",20130731,40,4.125,225.2,135,13,122
A14DNCG5WHM86Z,Jennifer,20061106,43,3.441860465116279,232.72093023255815,421,45,376
A14E2XP0PR1V8D,Kenyon Ralph,20060315,24,4.458333333333333,70.375,50,14,36
A14EF1PPKMSEPU,"E. Brown ""EB""",20090516,27,4.111111111111111,218.55555555555554,370,35,335
A14EK7CK43XIIE,"YS Sheu ""ss""",20100902,21,4.190476190476191,283.76190476190476,116,16,100
A14EMRRT2MNES5,"D_Sone ""Sone""",20080509,25,4.36,215.96,75,3,72
A14ENWEKTHCBXR,"R. L. Miles ""Miles""",20011226,22,4.818181818181818,142.5,43,26,17
A14FQS9Z5USX0,Cheap-n-Easy,20060502,28,3.8214285714285716,267.7142857142857,598,66,532
A14GOIC2XB5CAD,"Anthony Chiappette ""chippe01""",20070206,21,4.428571428571429,340.0952380952381,221,9,212
A14GS1XORCUL9C,Robert,20110429,23,4.782608695652174,45.608695652173914,31,5,26
A14GSTIN77TLSR,C. Kissner,20040707,22,3.4545454545454546,123.77272727272727,80,10,70
A14HHTHKS8R5YO,Stan,20120717,24,4.291666666666667,78.25,14,4,10
A14HLXYXSDAON9,Fairyfemm,20121228,29,4.517241379310345,47.172413793103445,6,3,3
A14I1F2H7NOYDC,S. Dancer,20110218,61,4.344262295081967,112.81967213114754,78,16,62
A14JBDSWKPKTZA,"Bob Feeser ""MillCrafters.com""",20011122,94,4.712765957446808,683.7340425531914,1534,208,1326
A14K68HYCFCTRJ,Amazon Customer,20041207,25,4.4,89.84,206,28,178
A14KC988NE3WSH,Art,20070628,22,4.681818181818182,273.8636363636364,143,39,104
A14KINAPCA7XTL,dmbTank,20130120,31,4.451612903225806,191.09677419354838,34,8,26
A14L115LBOB0A5,MotoRider42HC,20130210,29,3.7586206896551726,50.758620689655174,14,4,10
A14LG64GIVZIGS,"S. J. Northrip ""SamN""",20070206,30,4.966666666666667,92.06666666666666,34,4,30
A14LQ0GV9JXT6F,Beth s,20120316,30,4.466666666666667,76.16666666666667,6,4,2
A14MCAGSOXXVTE,A. Martin,20090806,25,3.84,69.56,32,16,16
A14MSNGTYJ0UNS,Jeremy Duncan,20110308,28,4.25,65.25,15,5,10
A14MZJTZAQS6CV,"L. Williams ""Paddle foot""",20110706,63,4.158730158730159,74.25396825396825,15,32,-17
A14NA0W8ESGDSI,Timothy Lovett,20080410,53,4.245283018867925,196.28301886792454,262,62,200
A14NAW3I5WL497,Joseph E. Dilts,20111017,29,4.896551724137931,50.44827586206897,5,0,5
A14NBQZIAV7MTS,S.L,20100208,23,3.8260869565217392,349.3478260869565,144,62,82
A14OQ67LM79KW3,"Candace Mike N Elmo ""candacemikenelmo""",20080522,49,4.285714285714286,212.59183673469389,87,22,65
A14P39XLDXIPS2,Flyingscot,20080123,27,4.851851851851852,51.77777777777778,10,4,6
A14P9DORHBH4Y5,Wolfgang Rumpf,20121106,21,4.619047619047619,74.0,44,3,41
A14PCKE3X7FQCR,Mr. Bruce,20090319,45,4.711111111111111,80.97777777777777,40,13,27
A14Q1WGNF9DM3A,JP,20130304,25,4.52,42.56,1,3,-2
A14RFF9JUIM34U,Jason Barnes,20110127,33,4.181818181818182,49.27272727272727,5,1,4
A14RPY0DV96EG4,Bob,20130423,32,4.71875,417.375,70,11,59
A14SNJ7UV0U434,"Leon Wechsler ""LW""",20120110,23,4.173913043478261,29.08695652173913,3,6,-3
A14VQ5JVNYYZ1O,L. Lilly,20061028,27,4.37037037037037,92.03703703703704,85,15,70
A14VYQTAS5U4MO,Genesis,20120329,31,4.451612903225806,51.25806451612903,12,2,10
A14WN6LD12UZKD,tim,20120715,26,5.0,28.53846153846154,14,21,-7
A14X244VGHWPSX,J. Hansen,20080530,59,4.305084745762712,236.67796610169492,72,31,41
A14XUCN5OC998O,"Dusty White ""Advanced Tarot Secrets author an...",20080914,29,4.620689655172414,383.58620689655174,88,14,74
A14Z6D3IRJ23F7,"Chris F ""root""",20110409,47,4.957446808510638,187.87234042553192,62,2,60
A14ZM0AX0LZNT9,"RJP ""RJP""",20131225,25,4.48,23.32,3,2,1
A14ZUOWHJL8FI9,KEVIN,20091201,28,4.357142857142857,85.21428571428571,14,96,-82
A1501C38OCSEMA,"Literary Wonders! ""Literary Wonders!""",20111214,21,3.5238095238095237,215.38095238095238,23,26,-3
A1509YCCYCYQQ3,cait,20080529,40,4.15,131.4,72,15,57
A150QS4IZB3XJ,"April Vawter ""Wilderness Photographer""",20051113,37,4.324324324324325,203.83783783783784,105,45,60
A151TTKJVOHFZN,Philip C. Casper,20111128,32,4.1875,76.53125,22,10,12
A1522TN5FVJL0Y,"R. Geissman ""Lodi Shopper""",20020719,40,4.55,99.75,208,20,188
A152KDPYT6YX32,Jonathan L,20121219,24,4.041666666666667,57.416666666666664,16,10,6
A153F3QOGIUSRD,"R. Jones ""Coffee Hound""",20070921,32,4.46875,146.6875,244,33,211
A15447PSN3C8ZP,ijcast,20031002,23,4.173913043478261,480.95652173913044,235,19,216
A154R0EH8V8J23,"Davey B. ""Gadget Geek""",20121030,39,4.6923076923076925,371.64102564102564,128,7,121
A155GENGJ7837S,Amazon Customer,20060524,30,3.6666666666666665,316.06666666666666,134,39,95
A155RN4ZE2KSDO,"Dexter ""Dexypoo""",20100311,23,4.739130434782608,99.8695652173913,37,8,29
A156BOR3CC0X1B,Kevin,20110705,23,4.304347826086956,166.7391304347826,15,3,12
A156P4FPL8OGXB,"Tim Drake ""Author and Journalist""",20100524,30,4.533333333333333,128.76666666666668,8,17,-9
A1576HHQLZE2OT,Scott,20101124,30,4.066666666666666,169.96666666666667,379,70,309
A157LE85O31FY4,Maurice,20091209,33,4.0,89.06060606060606,54,13,41
A1591PJYM84XQT,"Dalesky ""Dalesky""",20090202,34,4.794117647058823,126.8529411764706,27,3,24
A15ADZE1K9839O,"Roberto K. Cho ""chorobe""",20020903,31,4.161290322580645,200.61290322580646,143,16,127
A15CL28ALB7MTZ,R2,20080401,61,4.344262295081967,207.45901639344262,218,34,184
A15D2X8MICR2VQ,Ephany,20090510,35,3.6857142857142855,220.02857142857144,112,29,83
A15DZOS6KVANQH,D. Johnson,20050802,21,2.380952380952381,114.47619047619048,39,7,32
A15EQ9J0E2B95M,R. Jones,20091001,23,4.086956521739131,119.47826086956522,42,18,24
A15G6CALF7DDUC,GeezingInVA,20071212,21,3.7142857142857144,159.38095238095238,377,58,319
A15G70V9OBTOVO,Coronet Blue,20070121,56,3.7857142857142856,301.5,986,197,789
A15GGP3M0EXZ4R,PS Jordan,20110928,24,4.083333333333333,232.29166666666666,125,21,104
A15H3X6YH5LFPN,"Dan O'Connell ""American""",20120712,23,5.0,149.1304347826087,32,20,12
A15HDXJ066H6DZ,Matt,20110722,24,4.708333333333333,81.125,41,3,38
A15HFIL37EBL9V,B. Lee,20050219,24,4.416666666666667,245.66666666666666,363,92,271
A15IYGI4KQYNC9,O. Awad,20040702,21,4.523809523809524,202.1904761904762,292,42,250
A15J71JLC29KPW,Mary Jo DiBella,20020303,65,4.1692307692307695,159.03076923076924,318,54,264
A15J9K7O10A3M6,Andrew B,20120509,56,4.303571428571429,73.98214285714286,29,7,22
A15JC246UXZV5Y,Boris,20121027,36,4.805555555555555,60.833333333333336,14,7,7
A15JEHADFOYKPS,"James Peterson ""YMMV""",20080402,34,4.5,59.94117647058823,159,21,138
A15JPYV0L19RF,"R. J. Gutt ""Tigercat""",20111218,24,4.708333333333333,77.125,21,0,21
A15K0HKZ4MK4XY,"Doc1 ""doc""",20101130,31,4.161290322580645,121.80645161290323,32,3,29
A15LJUF2LEKMSS,Jeffrey G. Boldt,20110501,23,4.434782608695652,97.17391304347827,11,9,2
A15ML85W54A2AH,Do42,20100831,32,4.40625,359.65625,354,15,339
A15OTC24HGY4L3,David,20130302,21,4.619047619047619,54.285714285714285,6,1,5
A15OVHJICQP3M6,Douglas,20110208,30,4.833333333333333,40.333333333333336,11,1,10
A15PAFDSAKFKZE,"Arthur Niederfringer ""Arthur Niederfringer""",20091010,34,4.411764705882353,126.6470588235294,107,2,105
A15PUBCS4N4G60,buckeyede06,20101107,28,4.642857142857143,51.535714285714285,12,4,8
A15Q2L6DYRTFIU,"Gregory A. Brown ""d800-user""",20060308,40,4.725,26.075,20,8,12
A15QYHQH80W30L,"Edgar H. Tan, MD ""The Healer""",20061226,122,4.385245901639344,80.5327868852459,439,301,138
A15RLA0IS0DLE,IT Guy from Hawaii,20080718,22,4.181818181818182,102.13636363636364,116,8,108
A15S26550AJ3WC,Ed,20111103,21,5.0,55.714285714285715,8,2,6
A15SFMILCCEIF8,"E. Sieben ""movie & music guy""",20050810,31,4.709677419354839,52.67741935483871,20,3,17
A15T2DJ9UIDL72,Craig Dickson,20080307,21,4.190476190476191,260.04761904761904,332,33,299
A15T9G38F589KM,"knitting ninja ""knitting ninja""",20050707,95,4.389473684210526,248.5157894736842,1001,112,889
A15TABNGK6L4N3,Jason Rittenhouse,20100406,50,4.82,71.18,24,5,19
A15U38AWJ3JDN5,,20000505,31,4.516129032258065,219.80645161290323,1204,56,1148
A15U64VGUV6RBF,S. Carlson,20110818,61,4.885245901639344,88.34426229508196,141,22,119
A15VBTNMNSLADZ,Farshad,20060626,24,3.3333333333333335,172.0,124,42,82
A15VC3WTO38FDI,"R. Harr ""SurplusGadgets""",20120503,24,4.75,70.70833333333333,6,1,5
A15VFMU0WO8ED2,"Paul M. Frasca ""PMF""",20111109,27,4.925925925925926,45.7037037037037,8,1,7
A15X7GYAD68U4Z,Leonardo,20110221,21,4.666666666666667,67.76190476190476,5,5,0
A15XI2BEGGFEOW,"James ""James S.""",20060214,50,4.34,121.24,199,45,154
A15ZFIUS5H3IKF,Joe in Los Angeles,20101002,26,4.461538461538462,163.42307692307693,65,6,59
A16038R1YE18UB,Professor Jack,20100403,23,4.130434782608695,107.34782608695652,24,5,19
A162AA1DSK4OGW,Jeremy S,20120102,39,4.743589743589744,128.6153846153846,197,10,187
A162UM5Z7B81HP,Tom,20090325,26,4.538461538461538,71.23076923076923,7,3,4
A165OWIWJVVYRR,Ken,20041222,27,4.703703703703703,104.37037037037037,309,52,257
A1660JZPHFX90N,David,20080306,39,4.666666666666667,98.61538461538461,26,4,22
A166PLPFD2A42H,"DJ ""IEM Fiend""",20101229,25,4.4,300.6,180,32,148
A1684AUMDYVLFU,Y. Erez,20091027,21,2.380952380952381,111.04761904761905,64,34,30
A168WJELCMRKXL,mdmiataman,20120817,22,4.409090909090909,129.77272727272728,35,13,22
A16A8QEZQXASBP,OldPhotoGuy,20101227,26,3.923076923076923,301.2692307692308,69,27,42
A16ALXKQ02SKYG,"Inna Tysoe ""Inna Tysoe""",20100816,36,4.388888888888889,424.77777777777777,161,41,120
A16AO7UCAMIK1C,J. Singh,20080107,21,3.9523809523809526,111.57142857142857,57,8,49
A16AXQ11SZA8SQ,"MamaBear007 ""MamaBear007""",20100116,26,4.230769230769231,174.84615384615384,14,4,10
A16AZDBUMOGZVW,"D. Orders ""Otterwan""",20050112,21,4.190476190476191,153.85714285714286,180,17,163
A16C19G0I2DE8S,"D. Dube ""Just Like Computers""",20100214,54,4.907407407407407,61.0,22,14,8
A16CVJUQOB6GIB,Travis Piper,20120128,23,4.043478260869565,74.3913043478261,10,4,6
A16EEJL5KR8D41,VirtualDrummer,20111006,22,4.7727272727272725,153.0909090909091,44,13,31
A16FDY0JXDG6E4,Tadashi,20040904,31,4.387096774193548,164.6451612903226,51,6,45
A16FVJH9GLEDN2,"Jose L. Herrera ""LG""",20121214,30,4.266666666666667,26.766666666666666,2,6,-4
A16GBXDS51J019,A. Neilll,20001031,38,3.710526315789474,211.94736842105263,73,19,54
A16GL6CSCC2TAJ,Daddio Dave,20090107,22,4.909090909090909,138.36363636363637,18,5,13
A16GOVMQSHGUG3,Dan Robbins,20130210,36,4.75,66.66666666666667,11,3,8
A16HXVNPU5TCGE,"Donald James ""donjames150""",20071010,51,4.803921568627451,42.568627450980394,10,3,7
A16I8SQQIA2B8C,b. Weiss,20111001,26,3.9615384615384617,608.6538461538462,306,43,263
A16IM9MYTHCKYQ,Penumbra,20070924,33,4.363636363636363,309.72727272727275,851,46,805
A16ISYMCYGT0NB,"Skullywag ""Skully""",20100604,23,4.173913043478261,195.95652173913044,409,64,345
A16J281SJ9QXIQ,Papagigo,20100302,51,4.784313725490196,36.13725490196079,13,10,3
A16JKS53PQNLJH,mitney,20110327,21,4.571428571428571,85.80952380952381,2,9,-7
A16JT7E5121OAB,"Justin R. Germino ""-Justin Germino""",20090106,28,4.107142857142857,212.71428571428572,71,6,65
A16LVESBX9TOGT,joshuaRobot,20110426,30,4.6,119.83333333333333,7,0,7
A16MILIILH2L0J,Entertainment Aficionado,20101218,21,4.761904761904762,85.85714285714286,3,1,2
A16NCTV6UQOXP2,A. Thompson,20081119,33,4.363636363636363,84.33333333333333,72,28,44
A16OE2DQAS4LBE,"GH ""GH""",20111006,22,4.454545454545454,66.45454545454545,9,3,6
A16P052K67T1GR,J. Hui,20110124,38,3.973684210526316,269.3421052631579,189,38,151
A16PBJIFF00ENN,zentriton,20121012,31,4.258064516129032,35.903225806451616,1,1,0
A16PUD6V3KAZ0Q,"B. Caruso ""The Happy Aspie""",20090625,42,3.9761904761904763,392.6666666666667,58,20,38
A16QODENBJVUI1,Robert Moore,20060307,99,4.484848484848484,264.030303030303,427,70,357
A16QY8VBHHP9MT,"Robert ""Books are more than door stops.""",20050622,26,4.115384615384615,159.15384615384616,36,5,31
A16RI68PS6T5CA,Gadget Geek,20050119,63,3.9047619047619047,335.8253968253968,610,55,555
A16RL0RMRF974O,"Albert C. Marth ""Albert c. Marth""",20080715,46,4.565217391304348,53.58695652173913,49,45,4
A16RLVQKEEFWUU,"tech guy ""tech guy""",20080323,37,3.675675675675676,107.62162162162163,31,10,21
A16RSAY1DXB6PI,Ninjawithagun,20070129,22,4.136363636363637,418.1818181818182,555,85,470
A16SPGA83A4J8H,A. Thomas,20061213,26,4.269230769230769,143.53846153846155,134,12,122
A16SRDVPBXN69C,M. ANNE,20050515,54,4.703703703703703,110.0925925925926,293,24,269
A16T2C41GZYAJZ,Parka,20080927,27,4.703703703703703,472.18518518518516,1730,107,1623
A16THWKAAX8L0X,"jfhnhh ""jfhnhh""",20090915,24,4.541666666666667,57.458333333333336,7,11,-4
A16UISL4S22SUL,rick,20110603,23,4.565217391304348,146.56521739130434,22,3,19
A16VJ1B9TGRI83,INDYSTEVE,20121104,34,4.588235294117647,29.61764705882353,5,1,4
A16WKPOSEGQC3Y,"Nanohead ""nanohead""",20051205,33,3.757575757575758,396.42424242424244,146,52,94
A16WND1BVJCQJV,"Matt Eye ""Matthew""",20090510,26,3.923076923076923,641.9615384615385,331,74,257
A16WP8NTPYB0ZM,Norm Smith,20110408,38,3.263157894736842,124.21052631578948,97,20,77
A16YEI0N7YQUNQ,Dezzie,20110924,22,4.818181818181818,355.1818181818182,107,7,100
A16YMCFWGSFGS9,Alla S.,20110320,39,4.256410256410256,138.51282051282053,58,16,42
A16YNIF5N3ZFRI,Tamika,20090908,21,4.523809523809524,80.95238095238095,14,1,13
A16YU3GRGCD95S,"Theresa M. Studer ""Terra57""",20090713,44,4.7272727272727275,205.5909090909091,57,19,38
A16Z2OECAUX8Z4,Ashley Mott,20120619,31,4.419354838709677,255.51612903225808,58,19,39
A16Z3HTUIYPDH8,Reviewer,20100804,26,4.461538461538462,64.5,11,22,-11
A1727MM7Z05H9M,Christopher J Morin,20121205,25,4.92,75.64,11,2,9
A1743ABTREFO0Y,"D. Tuttle ""dtuttle""",20081108,31,4.67741935483871,80.74193548387096,24,3,21
A174X7S1J75AZ3,Jamie Hamel-Smith,20061109,24,4.666666666666667,111.20833333333333,18,3,15
A175XXVMLQA98A,J Rickman,20090130,24,4.833333333333333,35.0,10,2,8
A17771LTRWSKQ5,Helen S. Lam,20061129,35,4.314285714285714,116.74285714285715,63,7,56
A177EE11AYO4XW,Tim,20100417,21,4.809523809523809,83.38095238095238,26,4,22
A178IK50SI5GO0,Bob,20100206,29,3.8620689655172415,105.86206896551724,80,25,55
A178M2AHNWQZB0,"Lawrence Jacobsen ""LJguitar""",20100803,52,4.923076923076923,128.92307692307693,276,33,243
A17A0Q9LF7K4N2,Y. Wang,20091219,28,4.107142857142857,226.07142857142858,117,17,100
A17A1KTVI3DG6U,Nathan A. Edwards,20081121,28,4.357142857142857,307.35714285714283,188,55,133
A17AK1Z8KN613L,"G. Simms ""Ireadlots""",20070910,22,3.772727272727273,138.4090909090909,27,9,18
A17BUUBOU0598B,"Mark ""Technology, Music and Movies""",20040601,228,3.4517543859649122,544.9254385964912,13930,674,13256
A17C6W19J4MSVA,"Carlos B. Mangrobang ""Capricorn Foto""",20070121,38,4.815789473684211,81.34210526315789,37,7,30
A17CQORLF0JIFL,Donna,20110428,32,4.0625,375.28125,228,38,190
A17DIKUTVOU7ZM,"Book Reader ""Book Reader""",20091206,32,4.71875,98.75,44,5,39
A17E3NBADNTI3X,W. Miller,20060807,28,4.178571428571429,101.78571428571429,323,30,293
A17EFGL6NCKPKI,T. F,20100517,25,2.84,196.24,201,309,-108
A17EY74PC3DFH8,Brock,20110425,31,3.7419354838709675,88.09677419354838,24,5,19
A17FQOCNVFSE9Q,Garry_James,20110207,37,3.6486486486486487,43.270270270270274,70,115,-45
A17FW6FREPW9N3,ChrisF,20100517,28,4.464285714285714,243.14285714285714,82,6,76
A17G8GQM941JTC,A.Miller,20071010,29,4.620689655172414,65.20689655172414,1,0,1
A17HMM1M7T9PJ1,Timothy B. Riley,20060809,131,4.267175572519084,232.63358778625954,798,49,749
A17HTUFTF66S2G,E. Lacey,20090318,31,4.258064516129032,377.38709677419354,459,33,426
A17INQNCZ1HMHL,TheSnowman,20120205,29,4.724137931034483,131.17241379310346,10,1,9
A17J23XGHDUBIK,"Amazon Customer ""Mark""",20071018,22,4.636363636363637,101.5909090909091,59,5,54
A17JGUY7OCFJ57,L. Cioccio,20070410,31,4.838709677419355,82.64516129032258,59,3,56
A17KHJK5E1GMQ4,Jaron Davis,20111225,25,4.36,80.92,11,5,6
A17KNKWCU3VQCC,Ed in Raleigh,20110418,29,3.896551724137931,222.41379310344828,31,15,16
A17KYU38U9WRVW,"Mr. Vijay Venkataraman ""vvume""",20000505,32,4.4375,261.875,478,29,449
A17LB0HBCXIWJI,"Harv ""Bryan""",20080329,25,4.68,105.16,32,9,23
A17LGOGVLECFJM,"DesertIce ""DesertIce""",20101212,26,3.5384615384615383,71.46153846153847,22,27,-5
A17LSEN4UY4XZQ,M. Daneker,20060612,21,3.857142857142857,217.66666666666666,213,121,92
A17MRB2O4NTF3,Chun Li,20030915,23,4.043478260869565,164.47826086956522,237,30,207
A17NVM7IAPF2NS,Maek,20030213,64,4.34375,327.796875,475,66,409
A17O9AHKHK66AI,L. Gildart,20060527,83,3.927710843373494,183.74698795180723,1035,31,1004
A17O9TA4ED310G,"TinkerToyTech ""TinkerToyTech""",20121027,21,4.619047619047619,63.61904761904762,17,14,3
A17OXGC7BFQMYD,jjeff,20100318,38,4.315789473684211,173.94736842105263,195,22,173
A17R16KVZNQ5GZ,"Bill A ""Angus""",20090406,23,4.391304347826087,257.7391304347826,135,27,108
A17RFKCYS69M3Y,Tall Paul,20040717,34,2.235294117647059,89.26470588235294,141,43,98
A17RNV8G9Y9Z3W,Matthew DiMasi,20130317,35,4.171428571428572,46.77142857142857,18,69,-51
A17SJC2BPIF6RA,raarset,20111101,28,5.0,45.464285714285715,8,2,6
A17TPXJ2U4MJAB,MeTaLhEaD,20110829,21,4.714285714285714,82.0,17,11,6
A17TXJ5ZVYS42Q,NMSUAggies,20120706,24,4.875,129.16666666666666,12,1,11
A17U12E2LNDSYL,Steve,20110107,25,4.4,192.2,32,3,29
A17UNMURMLX0ZE,C. Weaver,20090508,78,4.012820512820513,294.6666666666667,255,55,200
A17UXLU67F0CCM,"Test Drive Nut ""Craka""",20090813,38,4.921052631578948,108.73684210526316,21,7,14
A17V2N0N8CXSA9,"H. Curran ""English Bay""",20110509,25,4.28,155.12,36,14,22
A17V9XL4CWTQ6G,Chandler,20090819,95,4.747368421052632,377.7894736842105,6255,133,6122
A17W0GMB0YY83M,Huskerhawk,20080331,61,4.704918032786885,172.59016393442624,83,14,69
A17WER66R17JEF,Larry Finley,20090916,23,4.869565217391305,42.65217391304348,8,2,6
A17WKG6ZXE7Y3O,Lamont Underwood,20131229,30,4.266666666666667,48.46666666666667,11,3,8
A17WMUPWHYJPVR,RodTech,20120906,22,4.7272727272727275,39.86363636363637,4,4,0
A17Y00UME9QN76,John A. Byrne,20080819,22,4.045454545454546,128.04545454545453,22,5,17
A17Y465UXZOJE3,Stickman,20080101,33,3.515151515151515,156.24242424242425,68,28,40
A17Z0LVY96TO53,E. Hung,20090114,47,4.574468085106383,208.82978723404256,193,19,174
A17ZE38DNMLJ82,Fruitielicious,20130408,29,4.310344827586207,241.27586206896552,55,10,45
A180Y3G9OVEW60,Rubab Khan,20090219,22,4.318181818181818,97.45454545454545,57,35,22
A181WFD83AI8RF,Ken S. Sato,20090103,24,3.75,83.625,21,19,2
A182BL642WB691,Big.Hoss,20120907,22,3.9545454545454546,35.09090909090909,1,1,0
A183V4P6U4CFBF,pnc,20080417,23,4.565217391304348,140.82608695652175,18,9,9
A185KIXEY9QZRQ,Caminante583,20120429,21,4.9523809523809526,22.047619047619047,2,5,-3
A185O1MX1RP964,Master Woo,20120326,39,4.641025641025641,56.76923076923077,7,2,5
A186697K4XKXQL,Matt Hausig,20050302,82,3.8536585365853657,133.6829268292683,239,88,151
A187HY1IE2PL1,Glenn,20120919,23,4.869565217391305,44.34782608695652,19,4,15
A187OD0Z9ZQ69H,"SE ""Steve""",20120313,22,4.318181818181818,104.45454545454545,26,8,18
A188S2HH77HKAN,"AdamDZ ""AdamDZ""",20060103,25,3.48,131.04,44,13,31
A1899PHB3D4QJ7,"JN ""Hi""",20090418,28,4.071428571428571,106.60714285714286,44,33,11
A18A1MUFQPDD7G,Jack Carter,20090207,24,4.416666666666667,63.0,11,6,5
A18A5VSD0IPN14,Paul Moore,20090826,54,4.5,132.16666666666666,56,11,45
A18APJULAWONNE,"Sean Li ""Sean""",20060324,29,4.0344827586206895,193.55172413793105,49,47,2
A18BQXGJ3RO1BC,Jack,20080221,26,4.384615384615385,266.38461538461536,331,24,307
A18CQ9BXLP557B,"Bill Oakes ""bill_o""",20061218,27,3.888888888888889,133.44444444444446,44,22,22
A18DOLQHA49I5Z,Randym,20070812,23,3.8260869565217392,263.5652173913044,178,29,149
A18E5NYCE8TSHJ,J. Miller,20130105,25,5.0,28.68,2,2,0
A18EA7MNLXP9H5,C. Peterson,20090421,71,4.197183098591549,78.49295774647888,56,20,36
A18ECVX2RJ7HUE,"willie ""roadie""",20070428,35,4.285714285714286,166.11428571428573,273,75,198
A18EJ44LWWUO11,SpinDoctor Reviews,20140129,40,4.95,367.55,175,7,168
A18EUQFB1I3CGA,"Jiunjr Feng ""Robert""",20020902,25,3.64,205.12,500,121,379
A18FLOC8YQY0P8,E. Tam,20110204,109,4.348623853211009,136.74311926605503,2348,83,2265
A18FUHNBP90IB4,cb,20060102,23,4.695652173913044,51.869565217391305,22,8,14
A18GJ9MYYO6GCQ,"Just ask me! ""bronxgal""",20050214,52,4.5576923076923075,149.90384615384616,104,20,84
A18HE80910BTZI,"rbhatta ""A Dinosaur you can trust!""",20010110,163,3.791411042944785,441.4049079754601,2360,214,2146
A18IVQWQKEG3PT,NoMoneyG,20101215,36,4.722222222222222,82.72222222222223,13,6,7
A18K1ODH1I2MVB,0mie,20131025,28,4.321428571428571,69.64285714285714,35,3,32
A18KLWANZOBG0J,Robert E. Glasscock,20080818,28,4.5,183.39285714285714,147,15,132
A18KO925KQXPY6,"Robert Swindell ""digital man""",20101001,26,3.3846153846153846,208.53846153846155,75,10,65
A18KXVYPK6X2T2,Bobby,20110412,27,4.814814814814815,59.666666666666664,13,0,13
A18L7A43I409HU,M. Alexander,20111224,26,3.423076923076923,104.5,10,17,-7
A18L9A64XNGVGU,Amazon Customer,20101130,42,3.6666666666666665,82.16666666666667,25,17,8
A18LBGL7L9FEZV,Larry,20080303,23,4.826086956521739,130.17391304347825,13,7,6
A18LZ6VHS4DK69,Wesley Newell,20080921,39,4.615384615384615,72.56410256410257,9,3,6
A18M104D8EJ3KZ,Tech-Knowledge-E Reviewer,20110221,23,4.739130434782608,34.130434782608695,5,3,2
A18MBO1U4DPY20,Harkanwar Anand,20050212,46,3.8260869565217392,391.32608695652175,103,39,64
A18NDN2CIG2TKR,japerkinsjr,20110609,40,4.725,47.5,23,4,19
A18NLG35HLRE41,CLPhoto,20110126,28,4.107142857142857,125.64285714285714,48,14,34
A18OTCHQ6MXD6X,Kam G.,20061103,57,4.473684210526316,109.71929824561404,145,26,119
A18P98QS2M3K6Z,Jim Besso,20110821,22,4.2727272727272725,309.3636363636364,50,4,46
A18Q0YU1FMO7TE,"just being Frank ""amazon junkie""",20090827,25,4.2,169.76,41,15,26
A18QOASFGSQEPF,Amazon Customer,20030614,26,4.269230769230769,154.80769230769232,52,36,16
A18QOK7A5XLV1Q,EK406,20110512,22,4.7727272727272725,80.36363636363636,14,12,2
A18R50B4PS1Z5X,"KJ Kumar ""KJ Kumar""",20090614,34,4.705882352941177,65.52941176470588,32,5,27
A18RCK7EU24EHI,X_HOBBES,20070204,25,3.24,366.08,246,24,222
A18RQT2T3WT3N4,"Amazon Customer ""VA""",20090704,24,3.7083333333333335,256.375,72,4,68
A18RZLFVFN6697,BigO,20101227,29,4.827586206896552,144.0344827586207,5,4,1
A18S2VGUH9SCV5,Margaux Paschke,20041207,142,4.042253521126761,260.07042253521126,409,82,327
A18SGFP8689G2W,"Johnnie F. Pearson Jr. ""Old School""",20090321,24,4.208333333333333,107.95833333333333,13,2,11
A18SK0IT354975,Tip DS,20110105,23,4.304347826086956,93.30434782608695,11,4,7
A18SQLPP5SPS7A,Amazon Customer,20080703,22,4.454545454545454,308.59090909090907,51,7,44
A18T1BKNDSBWGN,"ITBeast ""ITBeast""",20060921,35,4.6,421.54285714285714,101,5,96
A18U05IGMK1FVV,Alvin English,20020605,29,3.6206896551724137,189.75862068965517,202,42,160
A18U49406IPPIJ,Deon,20131130,82,4.963414634146342,209.3170731707317,385,26,359
A18U9BQQQ0U8F5,Grieger,20080215,37,4.054054054054054,657.6486486486486,105,25,80
A18VF30YX62V1N,Low Blood Sugar,20111014,29,4.586206896551724,114.17241379310344,80,5,75
A18VT083FG5FLJ,"Fred ""mrdata22""",20021111,37,4.8108108108108105,130.40540540540542,262,13,249
A18X0BKCUBO1MC,James D.,20110220,21,4.571428571428571,45.76190476190476,7,1,6
A18YMFFJW974QS,CKE,20050123,73,4.287671232876712,281.4109589041096,342,95,247
A18YPL8YARWVSN,captainstormy,20130115,31,4.903225806451613,38.516129032258064,0,0,0
A18Z4PYBB9L9RY,"rdkmco ""rdkmco""",20090613,33,3.909090909090909,163.12121212121212,22,19,3
A18ZC4NAZ5L5UR,fisherKing,20060510,30,4.333333333333333,110.23333333333333,457,42,415
A18ZKZXXA3WHSJ,Edward,20130124,21,4.666666666666667,82.42857142857143,4,3,1
A18ZXVF5AQFK35,"meep ""meep""",20090929,26,4.0,141.57692307692307,57,3,54
A1901NTE8LFJF6,"Thomas M. Taylor ""runman""",20071110,65,4.0,234.84615384615384,475,50,425
A1906A0LU2NT43,Timothy O'mara,20090524,23,4.043478260869565,64.0,8,3,5
A190N2UMF2QB2D,Xmetalfanx,20130412,21,4.476190476190476,618.0,4,0,4
A190ORK9N6THHJ,Jackson,20140528,24,4.208333333333333,42.875,1,5,-4
A1912PQLG8WJQX,"Richard P. Muraski ""Murric1""",20070109,38,4.7894736842105265,128.05263157894737,162,21,141
A192TR06IXSTBL,Kindle Customer,20071112,21,4.238095238095238,104.76190476190476,44,9,35
A193H33IJ4N3TN,"Psoup ""Psoup""",20100208,22,4.454545454545454,105.77272727272727,32,6,26
A1940JTPNO7ZEI,V. Crofoot,20120812,33,4.151515151515151,85.3030303030303,53,30,23
A194Y47BF3CUTJ,Hamza,20110802,42,4.833333333333333,47.04761904761905,9,13,-4
A195EZSQDW3E21,"Rick Bennette ""Rick Bennette""",20090128,86,4.046511627906977,262.01162790697674,730,82,648
A195NQ6TM56Y5T,"Indygreg ""IndyGreg""",20110731,26,4.269230769230769,94.6923076923077,34,4,30
A196JN53PG0C7R,"Movieskinny ""WayneG""",20090827,49,4.816326530612245,198.3265306122449,35,14,21
A196WSM71WSMTZ,Patrick L,20060825,24,3.8333333333333335,126.04166666666667,113,82,31
A197BQFMF77D24,"Agent Excel ""agentexcel""",20030328,25,3.76,122.52,207,42,165
A197T2N6RU7K56,Suz,20040821,90,4.622222222222222,267.0777777777778,682,29,653
A1987V5OCO6QHS,Long Island Dad,20070903,53,3.0754716981132075,74.67924528301887,314,90,224
A198CCH4NNLI2E,Jonathan Birge,20030530,54,2.8333333333333335,248.64814814814815,683,128,555
A198M9M2PUJE2Z,Mathew T Gagnon,20110831,36,4.805555555555555,65.83333333333333,22,3,19
A19A42UKTU2WWP,Onepoorguy,20070902,24,4.291666666666667,107.70833333333333,36,1,35
A19AL8BAS9CMZ,Bukkene Bruse,20100521,21,4.0476190476190474,93.52380952380952,14,10,4
A19B52R13WC1AE,"Bob GlickSmith ""Bob GlickSmith""",20100208,25,4.76,63.2,23,3,20
A19C3O8ZS65QIP,Synical,20110613,22,4.590909090909091,76.72727272727273,5,2,3
A19CF76CZNDIIV,"Clay Cope ""ClayCope""",20050404,23,4.6521739130434785,149.91304347826087,98,6,92
A19D3N662QS9WD,Amazon Customer,20100909,22,4.0,177.5,56,11,45
A19DAT24BXP5XA,Michael Gasperi,20110616,26,4.384615384615385,52.61538461538461,43,3,40
A19E3ZCQH6TJBD,"Chris ""ndyardsheep""",20021121,21,4.666666666666667,98.42857142857143,14,1,13
A19EKT8H85AKO5,BigStory,20080312,52,4.4423076923076925,118.1923076923077,94,3,91
A19ETYGUVX1B8,jfb,20070105,32,4.71875,114.96875,53,4,49
A19EX8NKV7JV1X,The Doctor,20120830,27,4.851851851851852,75.07407407407408,45,3,42
A19FRW264WZTGP,Bunson Honeydew,20030805,59,4.491525423728813,99.79661016949153,122,42,80
A19GSC3QMK694Q,"Colorado Hermit ""ColoradoHermit""",20070715,46,3.8043478260869565,388.45652173913044,105,29,76
A19HKRB4LU5YR,"D Jones ""DP Jones""",20060928,67,3.985074626865672,205.1044776119403,224,33,191
A19HT7YC1UW3D6,"Amazon Customer ""retrogamer""",20100516,79,4.506329113924051,64.89873417721519,37,12,25
A19HX7W7B7COQB,Paul,20100928,28,4.357142857142857,220.14285714285714,84,17,67
A19IBIIW0G4EPC,"Justin Photog, Dog Trainer, Moto Rider",20130821,22,4.045454545454546,30.727272727272727,2,13,-11
A19IH70IIDS31C,Tom C,20110329,36,4.722222222222222,114.69444444444444,40,146,-106
A19J4IR55H1NZI,Frank LaRue,20081008,25,4.8,134.68,18,5,13
A19JDXB5R33C7R,WryGuy2,20091011,26,4.153846153846154,409.88461538461536,213,6,207
A19JGPUJAX048H,"Mayfayre ""mayfayre""",20070505,22,4.136363636363637,454.09090909090907,306,24,282
A19M7Q82O3DLZG,NonStopEMD,20111112,27,4.148148148148148,70.81481481481481,30,5,25
A19M8E3BNDBTCB,"Shaun A. Lynch ""Digital Vizionz""",20111003,35,4.514285714285714,37.42857142857143,7,1,6
A19MJFMEE3035J,C. Ervin,20101203,28,4.035714285714286,95.71428571428571,3,2,1
A19N3S7CBSU6O7,"OregonBay "" OregonBay - 1999 to 2014""",20070530,46,4.739130434782608,391.7391304347826,434,54,380
A19NLU301K2AWX,"G. Matot ""GMS""",20091110,25,3.28,311.8,170,20,150
A19NP8YYADOOSF,N. Krumpe,20031105,72,4.013888888888889,374.31944444444446,570,103,467
A19PU25XXOA33T,Tony,20110206,25,4.2,22.92,12,5,7
A19PXWQ918LAVG,"E. Peck ""JR Peck""",20070228,25,4.12,281.2,107,18,89
A19QKBWRI072AC,J. Glass,20101230,32,4.09375,100.375,30,2,28
A19RGDJPNZ7NZ,MW,20030718,81,4.172839506172839,375.6296296296296,696,74,622
A19RW25Q6206I3,"A. Mandeville ""Somanytools""",20060211,51,4.137254901960785,149.15686274509804,308,38,270
A19SKDQ82W6XAJ,Cyberlinxz,20120609,22,3.8636363636363638,42.18181818181818,10,3,7
A19UTUEBWKIZFT,AKN,20110805,97,4.690721649484536,323.7525773195876,226,17,209
A19V2TRL68EOHV,John Jorgensen,20110904,22,3.4545454545454546,283.3181818181818,118,21,97
A19W02MFB1J17N,Sam MT,20111103,27,5.0,45.22222222222222,8,0,8
A19W47CXJJP1MI,Amazonian Consumer,20081024,186,4.478494623655914,249.3494623655914,3183,285,2898
A19X4BF861LQST,D. Adams,20040103,87,3.7586206896551726,256.367816091954,417,88,329
A19XBW5WUDH1Z,David Nox,20080201,22,4.454545454545454,95.27272727272727,38,12,26
A19XMHRB3G4DIR,javajunki,20080622,95,4.494736842105263,260.33684210526314,919,69,850
A19XPAWSWDRI3B,Erik Posadas,20121227,56,4.5,35.857142857142854,9,3,6
A19XXLMZXR764J,S. Garfinkle,20021223,32,3.8125,116.6875,402,75,327
A19YOYY7FLQMA6,"Tante Maren ""Maren""",20080816,23,4.260869565217392,489.7826086956522,1262,71,1191
A19ZKE206QP9VQ,"Amazon Customer ""Scottie28""",20111227,34,4.735294117647059,73.23529411764706,18,8,10
A19ZM9NAFLVW3B,matthew,20111205,26,3.8461538461538463,55.34615384615385,6,11,-5
A1A027UELK4JZC,"Jami Garrison ""JamiRae""",20021109,26,4.5,282.6923076923077,193,33,160
A1A14CF173OQJ4,Stephen Cirelli,20090209,23,3.8260869565217392,72.1304347826087,19,9,10
A1A19CGIZ8IUFI,Ernest Mayer,20110614,21,4.333333333333333,69.71428571428571,7,0,7
A1A1SNLOULIJET,Public Name,20130722,29,5.0,53.10344827586207,8,1,7
A1A2F1ZOWOPNJB,Al,20040713,29,3.4482758620689653,147.3793103448276,74,23,51
A1A2JY585I84ED,J. Lucas,20061008,24,3.9583333333333335,161.83333333333334,69,12,57
A1A306IAZ3TM1,QK Shopper,20050924,37,2.7837837837837838,248.32432432432432,896,139,757
A1A535TCGNMVPI,Weatherman,20041126,73,4.5479452054794525,280.05479452054794,609,78,531
A1A5KUIIIHFF4U,"Anonymous ""Anonymous""",20111117,45,4.0,278.31111111111113,177,95,82
A1A5RLS9T0TIWB,K1SS,20120709,24,4.208333333333333,21.416666666666668,0,9,-9
A1A629D04LRFUD,Spore,20101004,28,4.571428571428571,135.0,24,19,5
A1A6C5KIOBMQ2P,Ben,20041114,48,4.4375,122.64583333333333,203,36,167
A1A6UYFNC1L304,Chris,20121225,36,4.583333333333333,149.13888888888889,43,21,22
A1A7O8VOGY1TFW,E. Delaney,20110704,23,4.913043478260869,44.869565217391305,6,1,5
A1A81QZOKSEY5P,Kellie,20121024,26,4.5,102.65384615384616,10,7,3
A1A89LQ8C1AYV1,Christopher Deweese,20070102,38,4.684210526315789,153.6578947368421,270,20,250
A1A8Q2573OC7DA,Demiko Dracket,20090508,25,4.76,33.36,21,9,12
A1A9H230IUTY1F,Eric in CT,20110830,25,4.56,50.72,17,7,10
A1A9WJHKBSTI4C,William,20081003,34,4.088235294117647,54.029411764705884,46,30,16
A1AA56T6AO1206,Stephen G. Bernard,20081206,23,4.086956521739131,145.7391304347826,52,41,11
A1AA9QXU2SAQDT,ShadySprings,20060725,25,4.48,80.48,12,12,0
A1AARD3V8DIVBS,,20100805,27,4.407407407407407,124.85185185185185,17,6,11
A1AAWWGOC8ZREP,San Diego Malcolm,20040828,23,4.3478260869565215,113.65217391304348,38,36,2
A1AC2TO3BYHYJY,"Paul O ""hermit""",20070610,24,3.2916666666666665,121.79166666666667,90,24,66
A1ACM1CBGORBN1,Sherry Berry,20040212,30,3.7,258.1666666666667,48,35,13
A1AEIRD99KEFZJ,VJ,20091111,24,4.166666666666667,65.0,22,10,12
A1AEPMPA12GUJ7,"Glenda Boozer ""Live, live, live! Life is a ba...",20071109,26,4.3076923076923075,117.34615384615384,30,6,24
A1AFS9M75F17IZ,Zetau,20090120,34,4.029411764705882,175.02941176470588,723,74,649
A1AGEGR4OTRQYC,JED,20130901,28,4.428571428571429,113.25,7,1,6
A1AGUO5PPZQL6S,James  North,20120517,25,4.84,81.08,18,7,11
A1AH8033GWKBY7,Tommy J,20070315,50,4.38,198.14,233,17,216
A1AHII2R0R6FAE,"BeccaM ""Technowitch""",20100520,39,4.435897435897436,362.53846153846155,368,28,340
A1AI98IW5RK9JL,"angeposs ""angeposs""",20100619,25,4.6,58.52,11,3,8
A1AK8ADQJRXA39,Edward Weston,20121014,29,3.6551724137931036,67.17241379310344,47,13,34
A1AKU188I6NRF0,"StevenJM ""stevenjm""",20091014,24,4.333333333333333,149.5,18,3,15
A1AKW788238PWQ,Truth Be Told,20110608,43,4.186046511627907,96.65116279069767,88,11,77
A1AL9LLOLHN0P8,D. Ng,20091217,24,3.0833333333333335,105.625,42,32,10
A1AM1WN5M3GD2T,Amazon Customer,20101103,29,3.8620689655172415,143.6206896551724,132,32,100
A1AN5YW8890YHN,"Life-Long Entrepreneur ""Kenneth Ervin Young""",20081225,41,4.439024390243903,62.390243902439025,34,35,-1
A1AN7HLQB27TWK,Hisashi T. Fujinaka,20130101,29,4.068965517241379,59.827586206896555,5,2,3
A1ANL7IMZYLJH3,S. Moore,20111128,23,3.652173913043478,143.69565217391303,172,34,138
A1AO304VECPFEO,Bart Willems,20030425,24,4.208333333333333,176.41666666666666,106,11,95
A1AOD8N6LJYHBU,realsteel,20121025,21,5.0,62.904761904761905,5,2,3
A1AOIRFI48Z2DZ,1970 Mach 1,20050708,26,4.3076923076923075,101.0,72,38,34
A1AP8CQJDBSK4H,"Lux Occultus ""Lux""",20131025,22,3.772727272727273,96.22727272727273,6,6,0
A1AQ8JT2A3UWMY,"R. Lee ""Gadget lover""",20100212,57,3.9473684210526314,98.08771929824562,97,107,-10
A1AR57EZAZO446,Peachbulb,20040303,21,4.142857142857143,415.42857142857144,161,23,138
A1ARPF45BT81PW,Sean Edmonds,20060514,22,4.954545454545454,97.81818181818181,12,4,8
A1ASWDAEDTTY5I,N. L.,20090306,55,4.218181818181818,78.30909090909091,48,15,33
A1ATVMMJZP3Q4X,"Coug Moog ""s_gil""",20070826,58,4.706896551724138,459.86206896551727,1300,122,1178
A1AU6XU1K1QVHN,Chaya,20061210,24,3.3333333333333335,228.16666666666666,200,31,169
A1AVDAS4VK9FCL,Joe H.,20110405,42,4.904761904761905,79.45238095238095,85,12,73
A1AWL9JASMG904,C. Gafton,20030914,66,3.590909090909091,155.03030303030303,262,39,223
A1AXZ8766COHR6,Greg W,20070111,22,4.409090909090909,76.5909090909091,21,4,17
A1AZI730ZGAX73,J. Bevan,20070509,23,4.260869565217392,217.7826086956522,90,23,67
A1AZIP21HF6KXR,Amazon Customer,20070831,29,4.137931034482759,74.10344827586206,20,6,14
A1AZQCVCDBQP6,"W. Johnson ""Bill""",20060806,41,4.439024390243903,97.70731707317073,81,10,71
A1AZUEFZNTUWVJ,Joseph L. Kashi,20020314,31,4.354838709677419,132.7741935483871,150,23,127
A1B05INWIDZ74O,M. A. Ramos,20060115,38,4.7105263157894735,242.76315789473685,129,27,102
A1B0NL8UWAELI7,Photoleif,20051019,59,4.610169491525424,303.3220338983051,474,32,442
A1B0YO04O40C3M,MD Bookworm,20130519,36,4.833333333333333,66.25,20,1,19
A1B2RI0MTRIW7O,Bigfish,20120512,26,4.730769230769231,60.19230769230769,7,11,-4
A1B3GNO9C8YX0N,"E. Pope ""EP""",20010519,29,3.5517241379310347,126.93103448275862,275,272,3
A1B4A3SUPMPOTH,Chris,20120214,21,4.0,59.57142857142857,15,3,12
A1B4MIXYVIKMU2,"D. Truong ""El Duke""",20050804,103,4.330097087378641,443.81553398058253,1769,119,1650
A1B4Z1SL8YJU9L,"Sam Lewis ""hgpot""",20120101,40,4.5,47.55,5,6,-1
A1B52CX9YT7PZM,"asiriusbee ""Dana~""",20090806,30,4.633333333333334,150.06666666666666,117,23,94
A1B5U8XX52YYOO,"J. Rodriguez ""RJ""",20070618,23,3.8260869565217392,220.04347826086956,118,7,111
A1B6O7SAIYG2N0,"Jacx ""J.C.""",20060216,70,4.185714285714286,185.9,87,27,60
A1B6SIX2I161O9,ringo,20110103,27,3.814814814814815,377.6296296296296,303,41,262
A1B80MVU7ZODF9,"A ""A""",20060816,42,3.1904761904761907,203.54761904761904,745,214,531
A1B8EJQU73YGL9,Nick Wilson,20041015,48,4.479166666666667,125.70833333333333,59,10,49
A1B9D3DFZ9PTHV,John NYC,20101017,25,4.68,33.2,7,5,2
A1BB6P6IKXY1I8,"L. Stemm ""larry_ohio""",20040629,24,3.625,41.0,60,156,-96
A1BBLQ702QKLY1,Woodshop Man,20070227,24,3.1666666666666665,108.875,45,25,20
A1BBTNE0NGNTJW,"J. Negron ""J. Negron""",20090304,21,4.333333333333333,145.9047619047619,84,7,77
A1BBU3QXVEQFL7,,20070923,21,4.380952380952381,172.71428571428572,39,6,33
A1BBXWFSMY2QZH,bobbyg53,20091005,22,5.0,97.27272727272727,42,5,37
A1BBYSMT9YCODI,korova,20070307,72,3.8472222222222223,309.44444444444446,556,57,499
A1BC62X6HZJGZR,"Dee N ""tonipaw""",20120102,51,4.196078431372549,148.09803921568627,44,5,39
A1BE1OKY80FUBH,Pink Panther,20070215,21,4.761904761904762,98.0,88,14,74
A1BEKAQQGP8CMF,Big Red,20100411,27,4.0,137.33333333333334,37,19,18
A1BFNBD9CPHHSW,MiannaJo,20100409,31,4.483870967741935,72.80645161290323,290,10,280
A1BFOIA1SI8TP5,"Mike ""Mike""",20130711,21,4.476190476190476,39.76190476190476,5,3,2
A1BHSP8TPTH8Y5,"CCGal ""MyReviews""",20090520,40,4.15,214.4,95,27,68
A1BHZPN2HD8CXJ,"Discoveror ""Mike""",20080118,22,4.7727272727272725,100.5,31,0,31
A1BIL65NSE1UX6,clarita apple,20060730,21,3.5714285714285716,148.04761904761904,143,33,110
A1BJOHHLG0D965,"M.D. Edwards ""Avid Aesthete""",20080521,69,4.217391304347826,633.8550724637681,433,67,366
A1BJQJZUQI20FC,"JustAFilmGuy ""JustAFilmGuy""",20010625,21,4.619047619047619,92.52380952380952,80,31,49
A1BJUMKKRLK9XX,Jagadeesh K. Venugopal,20070701,24,4.041666666666667,201.66666666666666,257,42,215
A1BK60GZ4QME6I,John W. Graham,20051121,31,3.6451612903225805,276.51612903225805,365,31,334
A1BK6IJ6919BT3,"F. Turner ""sailon""",20100910,21,4.095238095238095,63.476190476190474,3,2,1
A1BKJNAWJT2TG2,"G. Miller ""G. Miller""",20080119,23,4.043478260869565,201.7826086956522,46,16,30
A1BKSBVYX9KDEG,"D-T-D ""Mister Don""",20050113,24,3.7916666666666665,274.625,206,33,173
A1BLDIJ8VJKUZZ,"Wilbur Sachs ""Wilbur""",20090105,33,4.454545454545454,139.24242424242425,70,24,46
A1BLKINCK03YL8,NYCSteeler,20101212,33,4.606060606060606,139.36363636363637,22,5,17
A1BMG34CO5CMZ5,Bay Gibbons,20081201,34,4.264705882352941,115.32352941176471,28,13,15
A1BMUIHUM90GOQ,M. Short,20090622,29,4.275862068965517,43.89655172413793,12,3,9
A1BN6QEHHESGU1,Buddyjay,20070620,26,4.269230769230769,259.8076923076923,92,13,79
A1BNBMRWRCKK49,Frederico DosSantos,20121225,22,4.363636363636363,80.13636363636364,3,9,-6
A1BNQTKK2VRO8G,"Michael Daniec ""stop torture""",20110605,27,4.185185185185185,72.88888888888889,3,8,-5
A1BOSVVNXI2L75,Chris H,20060709,24,4.375,68.0,12,4,8
A1BP3RPXTBUP6,iciconnect,20110313,34,3.9411764705882355,46.73529411764706,3,8,-5
A1BPPZINVQ2CE6,"RW ""RW""",20050423,41,4.439024390243903,334.390243902439,683,67,616
A1BPV2X36SQAP3,CJ Cotter,20041006,21,3.619047619047619,178.66666666666666,75,25,50
A1BPZI5LWM1T7R,R Hogan,20101112,23,4.478260869565218,64.08695652173913,30,18,12
A1BQ0HTG3C53IH,J. Mol,20110920,25,4.84,20.88,0,1,-1
A1BR689D2M5XA3,leoisright,20130320,23,4.086956521739131,110.95652173913044,30,10,20
A1BS8Y076W0PL6,"S. Elliott ""Techie""",20081015,24,3.125,130.41666666666666,59,37,22
A1BSDIJJU020G1,10 year Tech,20120315,21,2.0476190476190474,107.0952380952381,79,54,25
A1BT6TL7UCIC5Y,Quoad Toad,20050706,152,4.342105263157895,214.23026315789474,287,74,213
A1BTG38XSGYLW3,Aderyn,20080208,22,4.181818181818182,186.5909090909091,73,7,66
A1BTI221EBPDZF,LWhite,20100205,22,4.590909090909091,55.86363636363637,2,3,-1
A1BUES4LG08Z51,Inconclusive Panda,20120828,26,3.923076923076923,100.57692307692308,53,8,45
A1BUMO9NIT57OR,Mr. Picky,20100419,24,3.9583333333333335,126.0,44,11,33
A1BV6N0SRWGNYC,"Scott R. Sideleau ""Hardware Guru""",20100212,21,4.9523809523809526,164.66666666666666,154,10,144
A1BVE2ZIBKJ7YI,"roaeja ""Hey you!""",20080130,60,3.6333333333333333,136.85,562,456,106
A1BW4AWT3ME2DZ,Phantom Phreak,20120415,36,4.916666666666667,42.44444444444444,3,8,-5
A1BXVZSQOJE6UE,Ctwink,20100326,45,3.888888888888889,425.44444444444446,200,39,161
A1BY7ZXICCZAI4,"RodneyV ""Rodney V McCormick""",20090521,21,4.809523809523809,68.76190476190476,58,3,55
A1BZIM4WGZ6DZP,Jeffrey Osborn,20090516,45,4.911111111111111,56.93333333333333,22,5,17
A1C00XXCYWEKK1,Tombo,20110301,34,4.0,74.29411764705883,5,3,2
A1C05TSWTI3VZ5,"Mr. Derrick ""Vitamin D""",20080113,27,3.4444444444444446,294.2962962962963,403,27,376
A1C0BY762KS8WF,Outlaw,20080610,26,4.846153846153846,57.34615384615385,24,5,19
A1C0SOX7DPXY65,"M. Jobbagy ""Follow Your Bliss - Joseph Cambell""",20070715,46,3.717391304347826,185.95652173913044,79,26,53
A1C0WNM0G18HJ0,Laszlo L. Lieszkovszky,20110505,31,4.870967741935484,71.03225806451613,17,2,15
A1C1TNVSZAZA4E,L. McDurmon,20120202,35,4.771428571428571,43.6,13,6,7
A1C2IMUU8EJNMD,"Nuclearcharger ""Be cool, Be smart an get thin...",20120913,29,4.586206896551724,64.24137931034483,9,14,-5
A1C3Y8LKKUBVWY,ChicksHateMe,20091027,26,4.6923076923076925,234.3846153846154,24,12,12
A1C47ROOK7BSVL,Harry Samuel,20080712,53,3.150943396226415,238.03773584905662,157,59,98
A1C4XZPPK9CBUM,Cobra,20031206,41,4.7317073170731705,88.8780487804878,147,21,126
A1C4ZSXQXWDJ57,Francis X. Fanucci,20081125,35,4.085714285714285,82.22857142857143,14,13,1
A1C5TCCR2IGKBU,Tom D,20041014,37,4.45945945945946,188.86486486486487,662,30,632
A1C5WS021EL3WO,"CJ ""I'll make it work""",20121209,88,4.625,117.57954545454545,63,9,54
A1C60KQ8VJZBS5,"Marktwain10 ""Marktwain10""",20091116,23,4.608695652173913,309.0,124,8,116
A1C6RZG7XQZBUZ,"C. Beard ""I have not gone where I intended to...",20130701,26,4.461538461538462,33.80769230769231,1,2,-1
A1C6ZJNWKYK485,R. Johnson,20060115,23,4.173913043478261,156.8695652173913,46,4,42
A1C6ZZJN748QIW,J. B.,20121123,23,4.826086956521739,258.9130434782609,50,6,44
A1C760KGFSRI6F,Alexis Coxon,20090905,22,4.0,160.45454545454547,395,22,373
A1C7QQRX3801TM,Dr.P,20130301,45,4.377777777777778,101.4,11,1,10
A1C7Y31S5QXNTR,majormusiclover,20100618,23,4.565217391304348,306.60869565217394,196,12,184
A1C82BC5GNABOA,A.H.,20120119,51,4.470588235294118,228.5686274509804,321,33,288
A1C8ASO4Q2ROPQ,Amazon Customer,20080823,21,4.095238095238095,87.47619047619048,15,6,9
A1C9F9WF2IC8V0,R. Ray,20130102,31,4.129032258064516,94.19354838709677,27,11,16
A1CALHBVRMIC2I,K. Hirsch,20100201,29,4.206896551724138,78.24137931034483,12,7,5
A1CAQ78QKBIOVZ,"Carl E. Feather ""cfeather""",20030917,42,3.119047619047619,140.61904761904762,327,146,181
A1CB8HH9YJ2YZE,TheITMan,20110919,45,4.066666666666666,201.6888888888889,117,69,48
A1CCBLW6NH70ID,"sgeise ""sgeise""",20021230,23,4.521739130434782,172.34782608695653,62,7,55
A1CDR00JQ1IAV,gary,20130329,25,4.92,54.48,2,4,-2
A1CEKBY6E0J4YV,Dave,20130826,28,4.892857142857143,40.535714285714285,6,1,5
A1CENILVYMJGN4,"LN ""LN""",20050121,21,4.142857142857143,193.04761904761904,17,5,12
A1CFD4NNTVUXK2,"Mark Muehlbauer ""-Mark""",20110213,23,4.434782608695652,141.69565217391303,22,6,16
A1CFU5XJXN3PV4,Home Studio,20060114,22,2.6363636363636362,240.9090909090909,104,47,57
A1CG2VHUAE5T6W,"Gordon B. West ""Gw""",20080605,38,4.578947368421052,82.94736842105263,71,17,54
A1CG96V944FMVH,"Sharon ""Reddog""",20051101,21,5.0,50.904761904761905,23,13,10
A1CHKAWX7FAOM4,"L. Kirk ""Crabseye""",20070321,28,4.142857142857143,482.7142857142857,1758,96,1662
A1CJCF4KO2S3H,Jonathan Kennedy,20120122,21,3.8095238095238093,57.857142857142854,16,2,14
A1CJKOIUX2UCN3,"Chad Anderson ""c.m.andy""",20090826,24,4.5,98.16666666666667,46,4,42
A1CJY7C4CVUG6X,Matt,20100707,22,3.909090909090909,127.13636363636364,28,22,6
A1CK234XHYVA5Z,"Frank1 ""Everybody's a snake""",20100515,21,3.380952380952381,38.38095238095238,12,11,1
A1CKRQ1QE8TUBJ,"TomK1 ""tomk1""",20060703,41,4.073170731707317,315.0487804878049,578,41,537
A1CKZRNTCQ7W5X,J. Allas,20051008,23,4.521739130434782,45.69565217391305,10,3,7
A1CM4HI4S5P0WO,"A. Ebel ""gccradioscience""",20090516,50,3.78,272.84,88,41,47
A1CMD08Z49PGKQ,"okiedan ""Pro Bono Publico""",20060601,190,4.8052631578947365,124.0578947368421,812,66,746
A1CMSZGB8VYAY4,Justin,20130218,21,5.0,83.28571428571429,5,0,5
A1CMULB2KTGOEZ,J. Jones,20080817,22,4.636363636363637,145.8181818181818,48,9,39
A1CMWB7AWQUQH4,Spizzle,20110823,62,3.8225806451612905,137.3709677419355,101,46,55
A1CN1P7147QDJC,My Amazon Reviews,20100909,38,4.447368421052632,146.73684210526315,30,1,29
A1CN7L05XSZMRX,"R. Diamond ""Diamondback662""",20100219,32,4.25,341.25,304,22,282
A1CNV2BQHWAAPM,Rodney L. Schulz Jr.,20070109,30,4.133333333333334,63.166666666666664,20,8,12
A1CO79U5URPQGP,"qualityonly ""erosennin""",20110418,24,4.375,74.20833333333333,51,21,30
A1CP6MLIMYM8EJ,D. Oppenheim,20130109,25,3.96,57.96,5,3,2
A1CPRP3VFJRS1R,M. Anderson,20031201,86,3.5697674418604652,287.5,2112,276,1836
A1CQ9TY4AZE8ZW,Vincent P. Bedus,20080321,30,4.3,51.833333333333336,15,11,4
A1CQRJFY5EEMDZ,Charles W. Long,20011120,25,3.68,159.44,605,83,522
A1CSRR7FCKBL9M,yosificus,20120214,69,4.2898550724637685,146.65217391304347,224,27,197
A1CST2WUA32GP0,Cletu,20101202,46,4.0,28.956521739130434,5,7,-2
A1CU1FCTFTG7DT,Devin Mckellar,20110805,22,3.909090909090909,62.86363636363637,20,5,15
A1CU5CONQX6545,"Larry Bates ""Larry Bates""",20091222,32,4.78125,38.5,44,4,40
A1CUNCH9J0NC70,D. Whitley,20120408,23,4.6521739130434785,45.91304347826087,12,1,11
A1CVFUQ1PGSIJL,"T. Adlam ""professional consumer""",20091028,32,3.625,391.1875,179,16,163
A1CW609S9VMJCQ,SquallMX,20110124,24,4.375,78.58333333333333,23,2,21
A1CWCOZ001MQEA,Adam,20100401,23,4.391304347826087,68.30434782608695,12,7,5
A1CWE28BRV6JP0,now what,20101120,32,3.5625,792.8125,380,125,255
A1CWOD9IBU4DNU,,20080516,21,4.571428571428571,78.33333333333333,28,8,20
A1CXHEF9ZH3W0W,"S. Gable ""Nikon Nerd""",20080615,39,5.0,489.8205128205128,424,16,408
A1CYK2VYWWRL5X,"DT ""dt""",20050817,28,3.892857142857143,120.17857142857143,72,16,56
A1CYQ7AQT5DFDT,Gary H,20061201,26,4.153846153846154,395.8076923076923,180,28,152
A1CYTBE7LLUQ8F,"Living in Budapest ""livinginhungary""",20030813,57,4.649122807017544,157.6315789473684,562,56,506
A1D1782JK9GDNE,"the guru ""I live on amazon""",20120221,26,4.5,90.26923076923077,15,8,7
A1D183QHAUOU69,Anikin,20070120,25,2.8,119.8,81,41,40
A1D27BCSYV7VWH,C. James,20101204,44,4.0227272727272725,491.65909090909093,4295,101,4194
A1D2GOXZ3K5W3I,Potty,20120326,26,5.0,17.846153846153847,4,3,1
A1D2I73DA6N5TL,J. Oglesbee,20040812,22,5.0,152.5909090909091,43,3,40
A1D33H7DDMOJM9,Adam Edmondson,20101129,25,4.64,191.24,38,4,34
A1D3DDK2FXO8B,McGroarty,20070103,23,3.5652173913043477,271.82608695652175,316,31,285
A1D57TSKTBBBJN,Camera Shy,20060211,34,3.7941176470588234,182.97058823529412,199,31,168
A1D696068E7EOU,"Rw Scolari ""navy689""",20090621,22,4.090909090909091,45.5,8,6,2
A1D7D7FXQTQQTV,Gladius,20080114,22,3.272727272727273,360.8636363636364,247,106,141
A1D7VWS3DWS7X8,Joseph Siegler,20091016,32,4.25,505.5625,423,83,340
A1D7ZR0NYWI9FU,bblumberg,20081221,38,4.342105263157895,44.3421052631579,16,18,-2
A1D8I8AXZ9NY22,Sacratomato,20061204,39,3.2564102564102564,178.66666666666666,674,123,551
A1D8PJZGNX8LFK,Glows by night,20081021,35,4.057142857142857,124.62857142857143,32,9,23
A1D9U33OHQTO18,Julie L. Friedman,20120729,32,5.0,52.59375,38,15,23
A1D9V11QUHXENQ,"Big Al ""Alan Rivire""",20090428,59,4.372881355932203,245.35593220338984,443,41,402
A1DB2EVH0HGHBP,Jehan Ghouse,20080629,39,4.564102564102564,102.48717948717949,127,30,97
A1DB5QPH7WO488,J. Nelson,20060104,50,3.68,254.98,597,74,523
A1DB8VHLLVX9X1,G. B.,20100904,29,2.6206896551724137,131.06896551724137,22,25,-3
A1DBA5DSNARK9R,M. Morales,20101002,28,4.392857142857143,259.2142857142857,122,14,108
A1DCNMRBNSTN59,"Wally ""Wally""",20071213,25,4.64,147.12,259,20,239
A1DD5LYFQ3ZAOK,Laura I,20080904,33,4.121212121212121,211.03030303030303,2271,60,2211
A1DDKF0720PJ72,"Courtney S. Putnam ""C.S. Putnam""",20041205,24,3.875,228.91666666666666,151,14,137
A1DDZTDK7NKWQX,Kerton,20090118,25,3.76,350.4,2247,101,2146
A1DE59A1A0802B,Cessna89811,20130707,44,4.909090909090909,71.36363636363636,98,7,91
A1DE6YE8JPX2WW,Concerned Citizen,20090825,24,3.75,238.41666666666666,174,12,162
A1DE7W7O9L1UYX,Terry Burton,20100317,23,4.826086956521739,26.304347826086957,0,2,-2
A1DELQS1835067,R. Blessing,20090806,24,4.208333333333333,62.416666666666664,22,5,17
A1DG75OT3Y49EM,"ashertopia ""@gmail .com""",20090129,40,4.1,192.625,43,11,32
A1DH4HO1ETJ3OO,Nathan,20120506,22,4.136363636363637,71.13636363636364,11,3,8
A1DHX7B0X1M55X,IrvinJ,20130107,22,4.409090909090909,39.31818181818182,7,11,-4
A1DJ69GO74XX,wild bill,20110313,28,4.714285714285714,43.107142857142854,6,3,3
A1DJGO2TDMEYS6,Stan Matofu,20061018,25,3.6,166.36,162,48,114
A1DMT0Z4ZS16N3,N EBANKS,20030118,25,3.72,105.04,84,20,64
A1DNT3WWX2YQRV,Don,20110819,23,4.608695652173913,41.69565217391305,10,4,6
A1DO54K1V6GUK3,"Bears Fan Jim ""qm2-703""",20070221,42,4.0,290.14285714285717,576,71,505
A1DO9LRCO23EOM,"D. Houston ""Legal Eagle""",20070704,49,4.489795918367347,199.73469387755102,316,31,285
A1DOKS2D3CGYBI,"J. COLLETTE ""flyguy""",20110826,24,4.541666666666667,44.0,29,36,-7
A1DPLXD3JXXU1V,nanc,20110426,24,3.7916666666666665,91.125,7,6,1
A1DQHS7MOVYYYA,A. Boston,20070409,59,4.186440677966102,290.4237288135593,862,40,822
A1DRP5P7YOYR38,zSprawl,20120627,24,4.0,62.083333333333336,6,10,-4
A1DSQA18WOMMWW,"C Bear ""biker""",20090929,34,4.852941176470588,87.29411764705883,16,1,15
A1DSRM2P0WGQNS,"J. Moore ""Zombie Prep Network""",20031031,49,3.9591836734693877,144.08163265306123,260,65,195
A1DTCJV6KOMJOA,A*,20010705,63,4.031746031746032,183.25396825396825,232,93,139
A1DU99IGL69SZK,PhotoJim,20130304,21,4.619047619047619,65.76190476190476,12,1,11
A1DVFVAYKV2PGU,"John M. O'Connor ""jmoc""",20090806,21,4.809523809523809,115.76190476190476,35,1,34
A1DVKQE6BFL98Q,Adam,20101209,26,4.653846153846154,121.46153846153847,21,0,21
A1DW1FK1H3F2TM,EuReka,20080305,38,4.684210526315789,153.42105263157896,144,29,115
A1DXE6GODEAXS2,jensenca1,20121129,25,4.4,64.48,16,0,16
A1DYPLFFMFDO4B,"S. Krishna ""Sam""",20090502,21,3.5238095238095237,234.76190476190476,22,11,11
A1DZ81RH3JD1SD,"Jim Jamz Jr. ""jimjamz2""",20100403,22,4.136363636363637,53.95454545454545,27,1,26
A1DZDG9AT98298,jinx,20120329,30,3.6666666666666665,51.3,18,8,10
A1DZTBGEHOS6DO,ECorganist,20121231,24,4.541666666666667,118.08333333333333,5,3,2
A1E0PC3BK0JF4Z,"CompletelyComputers ""Completely Computers""",20130531,21,4.571428571428571,53.61904761904762,0,0,0
A1E110L9ZKX6FD,All Powerful Wizard Of Oz,20070531,26,4.5,220.57692307692307,114,19,95
A1E1L1OJZQI3OO,M. Stewart,20021109,28,4.107142857142857,215.10714285714286,163,24,139
A1E1LEVQ9VQNK,J. Chambers,20060319,182,4.8901098901098905,292.74175824175825,1486,59,1427
A1E1WLK5VSAJKX,"JimSaid ""F8 and BeThere""",20100130,24,4.75,80.41666666666667,35,4,31
A1E3OB6QMBKRYZ,MagnumMan,20060205,49,3.7346938775510203,566.9591836734694,808,111,697
A1E3T4V1N3E9H8,"Michael Denney ""The 'PC Doctor'""",20081229,26,3.6923076923076925,234.5,5,9,-4
A1E54CX25DA6D,Thomas Lanna,20121204,21,4.714285714285714,21.571428571428573,5,0,5
A1E55W6ES0FY17,"P. Breakfield IV ""Tom Steele""",20060410,73,3.643835616438356,223.82191780821918,378,129,249
A1E5WXNTI7EO2A,S. Brooks,20110504,34,4.147058823529412,216.05882352941177,37,12,25
A1E6YJH0YZYFU5,Rubin Pham,20091208,23,3.4347826086956523,85.47826086956522,54,41,13
A1E77E66RJ73ZW,Barry Frank,20111013,24,2.7916666666666665,54.583333333333336,54,20,34
A1E8F0AYFXPCRB,Derrick,20080327,25,4.72,211.88,61,4,57
A1E8INW9XE7HEQ,"G. A. P. ""G.A.P.""",20050109,22,2.772727272727273,150.9090909090909,264,49,215
A1E8XXAKINL0B1,Heather LaRee,20070912,21,4.285714285714286,170.9047619047619,64,19,45
A1E99ZE43479OW,Marcio Jose Bastos Silva,20080105,21,4.428571428571429,145.9047619047619,112,74,38
A1E9IQF7ST7O97,Captain Aus,20060613,21,4.857142857142857,76.52380952380952,126,12,114
A1E9QPX0866W00,ScttBvr,20110626,23,4.521739130434782,39.52173913043478,3,1,2
A1EA8WQ8N4WKFN,F. Cernada,20100117,21,4.666666666666667,126.19047619047619,29,9,20
A1EAAH5UM5P8SB,"oldpink ""Dark Side of the Moon""",20090130,21,4.619047619047619,371.04761904761904,578,10,568
A1EAH433QK3L3E,Albert I. Reiner,20050418,32,4.125,51.90625,64,49,15
A1EAQ69H0Z5I4N,Diane,20130115,21,3.857142857142857,85.47619047619048,4,5,-1
A1EARN5PUVIF1S,Jerry P. Danzig,20000721,31,4.354838709677419,393.3225806451613,819,36,783
A1ECG8L3HX2O3I,"Larry Holter ""Hooperstudios""",20100202,26,4.961538461538462,70.76923076923077,24,2,22
A1ED6GYNJ1MK1L,"Steve Z ""Steve""",20050818,23,3.9565217391304346,174.0,264,34,230
A1EDBC5HQQY98Q,"Lennie ""Lennie""",20100121,28,4.678571428571429,51.67857142857143,9,1,8
A1EDZVG9AZLO4C,nate,20101121,36,3.5,39.19444444444444,7,7,0
A1EE4PMEYPD796,Seth,20111013,26,4.769230769230769,89.46153846153847,11,2,9
A1EFVTUYCEZEK,Picky Consumer,20060206,22,4.636363636363637,369.6818181818182,570,19,551
A1EH2S92FHWZRP,Just a guy,20030509,180,3.9833333333333334,168.12777777777777,1324,132,1192
A1EH7MY1LOTYDZ,Larry Lawler,20120725,28,4.821428571428571,32.607142857142854,7,2,5
A1EHDVLCSOU57Q,redhedhs,20050804,25,3.76,219.24,53,11,42
A1EHO1RWGS9ALN,Ramiran2,20121004,37,4.108108108108108,26.324324324324323,5,6,-1
A1EJ6J6N9I7W35,Billy Hollis,20070921,28,3.642857142857143,275.07142857142856,168,18,150
A1EKHMYHO1M0KV,"mix master i.c.e. ""boracay_breeze""",20040213,21,3.6666666666666665,57.0,40,32,8
A1EKIXRELV3GRU,"Jamey Olsen ""Keishidojo""",20130304,21,4.238095238095238,90.71428571428571,7,1,6
A1EKSETIBS9ETQ,,20031028,124,4.112903225806452,294.10483870967744,554,174,380
A1EMGPCC8OWRKI,RexB,20080603,25,4.68,302.28,76,9,67
A1EMN4T3ROJDOO,"Karen E. Koch ""ditzychick""",20081226,23,4.260869565217392,85.73913043478261,50,28,22
A1EN5P2WZKWER8,"Fiat Lux ""A man with a bass just walked in, a...",20031227,21,3.7142857142857144,219.38095238095238,80,17,63
A1ENBOTX03172S,Michael DiDomenico,20120130,32,4.90625,104.375,184,21,163
A1ENHG9CYI17HW,"J. Osuna ""Video Productions""",20100708,30,4.4,61.8,14,2,12
A1ENTJE6GHR4XX,Georb,20110316,23,4.695652173913044,90.78260869565217,6,5,1
A1EOAR5DG2OZ95,Christopher Lee,20120103,31,3.774193548387097,567.1935483870968,926,61,865
A1EOTB1WHLSW6G,L. Ramirez,20040422,46,4.434782608695652,130.6086956521739,70,21,49
A1EPHD4E18OFWO,Allen,20090522,32,3.875,126.75,41,20,21
A1EPXD0829IE73,Dev Laur,20051101,36,3.5277777777777777,93.94444444444444,141,55,86
A1EQ5D5JRSW23K,Erol Esen,20060504,52,4.615384615384615,144.75,123,35,88
A1EQG7569YZD00,"jbcmass ""jbcmass""",20040425,21,3.9523809523809526,106.0,55,10,45
A1EQN91S6T820I,Amazon Review Dude,20110412,22,4.7727272727272725,97.81818181818181,11,8,3
A1ER2VHD3T72T6,Dan Kim,20081203,21,4.476190476190476,107.66666666666667,178,36,142
A1ER5AYS3FQ9O3,"K. Corn ""reviewer""",20030126,36,4.194444444444445,299.72222222222223,420,97,323
A1ERKDPSOJYK8P,Jared S. James,20100330,22,4.545454545454546,219.22727272727272,128,12,116
A1ERWR5A8OVLDH,M. R. Reynolds,20010618,29,4.068965517241379,208.79310344827587,520,68,452
A1ERZUZVDP6THF,"Tombom ""F#A#Infinity""",20130120,22,4.318181818181818,60.27272727272727,8,2,6
A1ESBB4RNIX0LN,Azhrei,20111229,27,4.296296296296297,240.88888888888889,9,6,3
A1ESVSG3FBJFH7,"T. C. ""Tread""",20090118,23,3.5652173913043477,75.56521739130434,17,9,8
A1ESYDFN2ENWIN,jjnbos,20111116,23,3.5217391304347827,80.6086956521739,33,18,15
A1EUO0BU72JR7T,Bilbo,20081010,37,4.081081081081081,112.4054054054054,57,16,41
A1EVV74UQYVKRY,K. Groh,20090722,182,4.615384615384615,211.95054945054946,465,36,429
A1EW0RSTHOXFZQ,MICHAEL LANCE,20111115,21,3.5238095238095237,160.8095238095238,203,19,184
A1EW2XDJFKUNM3,mike,20110516,25,4.48,36.24,3,1,2
A1EWQ5Y6HHSJGX,"J. Watts ""JLW""",20070109,29,4.827586206896552,66.48275862068965,56,4,52
A1EX7MNFZYL58,"Z. lhaloui ""nikoman""",20111013,32,3.75,34.21875,4,75,-71
A1EXGL6L0QQ0M5,"Shane O. Laake ""camera nerd""",20041227,183,4.311475409836065,226.86338797814207,1018,167,851
A1EXY1GZSJXJSR,"David Blankenburg ""Dave B""",20100908,36,4.694444444444445,73.80555555555556,28,3,25
A1EZ1W74IIJFA4,Linden,20090216,24,4.833333333333333,145.75,16,3,13
A1EZHF7SMLDNE0,K. Shin,20080322,26,3.8846153846153846,598.6153846153846,188,20,168
A1EZMU02XNK3DA,electriccafe,20060512,35,4.457142857142857,121.42857142857143,121,19,102
A1F0ITW7KPUKQI,R. M. Mayhew,20060718,27,3.925925925925926,130.59259259259258,131,10,121
A1F0KPA232MTYC,Patrick Campbell,20120208,80,4.0625,32.15,18,24,-6
A1F1A0QQP2XVH5,Mark B,20050623,170,3.9823529411764707,209.44117647058823,675,156,519
A1F3DFRPGVEUI8,Sam Sattler,20081204,45,4.066666666666666,347.5777777777778,84,30,54
A1F5O1USOUOOXI,John K.,20060611,48,4.5,307.1458333333333,81,21,60
A1F5W8F3ZMW9TU,SBlectric,20121208,23,4.826086956521739,86.73913043478261,14,5,9
A1F7AFVBKHSOT8,Matthew Erwin,20090630,23,3.739130434782609,157.17391304347825,140,38,102
A1F7SX3GNVBNE3,"Joshua G. Feldman ""Technophile""",20060406,21,4.476190476190476,551.0,490,23,467
A1F7YU6O5RU432,Angela Streiff,20071206,149,4.704697986577181,354.7852348993289,643,88,555
A1F88OFCHXMKHJ,BobinmidMO,20110204,25,4.44,152.48,28,5,23
A1F8ABPW3WRF6T,JWH,20010526,31,4.096774193548387,160.03225806451613,112,14,98
A1F8F5LZ9GCHSB,"MD ""MD""",20080929,32,4.59375,102.25,273,24,249
A1F8WB1II85BAM,S. Wilson,20080108,24,4.416666666666667,37.583333333333336,12,2,10
A1F92EK0MUNOVR,Pecos Bill,20040209,39,4.538461538461538,363.20512820512823,182,17,165
A1F958T2GSWCEK,"Raven ""Yolanda Vargas""",20091005,21,5.0,112.0952380952381,8,7,1
A1F9Z42CFF9IAY,T. Tom,20010724,192,3.5208333333333335,174.56770833333334,5484,738,4746
A1FA5KKGCI9ONM,sheilanga,20110207,31,3.870967741935484,42.774193548387096,13,18,-5
A1FAETFXIWAELQ,"Michael R. Curry ""Tenacious--M""",20130916,34,4.882352941176471,47.35294117647059,5,0,5
A1FAEUGGY2BCT4,"C. Dinh ""Suffering exists because of our desi...",20100216,22,4.636363636363637,155.3181818181818,25,12,13
A1FB1MTYJ3GVDE,A. Anderson,20120427,33,4.757575757575758,56.06060606060606,8,2,6
A1FCQI065T3HYH,CRP Ag,20070313,33,4.575757575757576,120.21212121212122,89,18,71
A1FD0J0KPUKMVF,SithTracy,20120107,41,3.8048780487804876,146.85365853658536,63,14,49
A1FD8C6K2WD20,J. Bush,20080908,21,4.190476190476191,144.0952380952381,110,7,103
A1FDSZISWIXH1A,"Terry ""tcinsatx@yahoodotcom""",20070629,63,4.523809523809524,419.2857142857143,261,43,218
A1FDV3WPOHREY9,"C. Scanlon ""least helpful reviewer""",20070321,50,4.46,331.4,756,88,668
A1FEE54PAZVEKV,rob,20100714,36,4.944444444444445,21.47222222222222,3,3,0
A1FEE8VBDQEBRM,"frankland ""frankland""",20070411,34,3.5294117647058822,182.44117647058823,94,24,70
A1FEI4HDXTA454,"Michael ""Tell us about yourself!""",20100214,27,3.1481481481481484,251.5185185185185,65,21,44
A1FF2PLA84KNAE,The Frugal Gearhead,20090218,42,4.809523809523809,138.9047619047619,25,8,17
A1FFIVHVEZ5JW4,"Paul W. Norman ""Magic Paul""",20100227,31,3.967741935483871,403.38709677419354,89,18,71
A1FHUYGO3OWWRF,A photographer,20051126,34,4.382352941176471,333.11764705882354,706,57,649
A1FI4UL6C50NZJ,"C.C. ""Chris""",20110804,24,3.6666666666666665,50.625,14,5,9
A1FI7JYOXSWCCA,Matthew M. Finnesgard,20100612,25,4.76,101.8,20,3,17
A1FK14ZCV3B1RA,Bladen's Mommy,20070123,36,4.444444444444445,239.08333333333334,212,28,184
A1FK6IQ111SJDR,Chris,20060701,36,4.027777777777778,104.41666666666667,62,19,43
A1FK81HNJI5F5W,chickenmonkey,20121128,25,4.36,106.0,9,1,8
A1FKSG1O3UVA4E,"Massoud Vaziri ""mvaziri""",20081110,26,4.0,102.03846153846153,66,33,33
A1FKSRD4UEA241,itsjustme,20111130,28,4.928571428571429,49.642857142857146,12,4,8
A1FLIYURKY1V7Q,Samantha Brookes,20130111,23,4.478260869565218,28.82608695652174,1,3,-2
A1FLJCHN5CG5M5,Da Lowrider,20110403,52,4.211538461538462,61.44230769230769,24,16,8
A1FLK39UE4Q0UW,"Mumtaz A. Shamsee ""Tazer""",20120420,39,3.6923076923076925,134.7948717948718,35,32,3
A1FMU4CJLIDHR9,"Jaffrey W. Ali ""Relentless Pursuit of Technology""",20080715,38,4.2631578947368425,228.97368421052633,238,26,212
A1FN0L4YDJZW6V,,20130422,26,4.8076923076923075,41.88461538461539,12,1,11
A1FNIBTI1D91KM,"C. Wilson ""tired momma""",20090615,22,4.863636363636363,128.1818181818182,16,4,12
A1FNKB7Q8KG6YS,D. Stoddard,20070707,45,4.2,131.0888888888889,143,36,107
A1FOSIV4TWZFR7,Justin Morabito,20100106,46,4.326086956521739,93.8695652173913,55,14,41
A1FP2LA6M2OJX0,"R. Holman ""the_holmboy""",20020429,31,4.709677419354839,136.19354838709677,90,16,74
A1FPQ54AIB26L0,Mike Wallace,20110503,29,4.862068965517241,296.1034482758621,151,44,107
A1FPYSERXPYD63,Johnny Wu,20080810,28,4.321428571428571,98.67857142857143,27,15,12
A1FQXSWVR6G3N3,Juan UY,20131023,36,4.305555555555555,59.111111111111114,13,5,8
A1FR68QH6Z4YZM,"kkrome25 ""kkrome25""",20040111,79,4.594936708860759,129.63291139240508,933,150,783
A1FRADBDXQPJJC,"R. SHARIFF ""rayhans1282""",20080120,27,4.518518518518518,54.2962962962963,26,26,0
A1FT58ZATJEQTZ,Jimmy,20120407,24,4.041666666666667,57.333333333333336,19,13,6
A1FTF7K2ZH21PB,"A.Right ""Nothing is what I seems. So check tw...",20110817,21,3.9523809523809526,132.23809523809524,9,8,1
A1FU5KU7AG1XMW,Rod,20111129,28,4.75,50.857142857142854,15,6,9
A1FUBPW8U2RYUY,"Subir Singh ""Gadget Geek""",20040506,34,3.823529411764706,432.52941176470586,357,25,332
A1FUVINZY4TCCX,Kevin B. Leigh,20090922,24,4.041666666666667,36.25,5,15,-10
A1FV6SJ6Z27O1E,"C. White ""Chazzz""",20070131,36,4.0,203.66666666666666,225,28,197
A1FV7W4SZD9BVO,Ultimate Jordan,20121227,22,4.181818181818182,52.90909090909091,11,7,4
A1FVN80HHHR3RA,P. Killion,20090529,32,4.5,470.28125,191,11,180
A1FVW47U1G96QV,book man,20071002,25,4.64,72.76,42,9,33
A1FWFCJU2G7TRA,KDMask,20040415,29,4.758620689655173,117.51724137931035,70,16,54
A1FWWYKXMLHEO2,"Lynne Wilson ""I will never know enough""",20100120,24,4.75,83.45833333333333,17,2,15
A1FXPPBA81AHNI,Philip Kohler,20080627,26,3.923076923076923,110.3076923076923,68,16,52
A1FXT4VNDA25LY,Doc Montana,20090531,47,4.659574468085107,91.06382978723404,102,12,90
A1FYCVW2NH6S63,"Jim Gerdy ""jjg""",20100217,24,4.625,312.0833333333333,150,17,133
A1FYX3RHM6B6EX,"Alexander Kogan ""alexjr@pipeline.com""",20070805,28,3.7857142857142856,90.07142857142857,74,14,60
A1FYZVQ6CU1406,Rob D'Aquin,20080205,24,4.666666666666667,137.20833333333334,62,40,22
A1FZAZE34727U5,"C. Cox ""Damien Purigen""",20091124,22,4.136363636363637,48.18181818181818,12,7,5
A1G0E1SQB3SGSZ,edwin f ortiz,20120321,23,3.9130434782608696,51.869565217391305,5,8,-3
A1G16IP3PH7RUA,"Amazon Customer ""'Respeto al derecho ajeno es...",20070909,21,3.9047619047619047,145.47619047619048,23,21,2
A1G24ZYOU6FVST,Marcus Wickes,20101202,29,4.655172413793103,146.9655172413793,79,10,69
A1G29MRK4U08F1,Ramkumar Balaraman,20091021,41,4.121951219512195,473.1219512195122,238,24,214
A1G2PJDZG31P79,Michael Desimone,20081129,23,4.826086956521739,66.82608695652173,13,1,12
A1G3A2YQPLRODG,Rose Anonymous,20061101,22,3.727272727272727,145.63636363636363,56,22,34
A1G3DKT38DNZJP,"Leonard Foster ""AV Freak""",20090910,45,4.2444444444444445,77.4,5,6,-1
A1G4TGVB0TVQ29,S. Hovey,20090402,30,4.566666666666666,52.13333333333333,10,3,7
A1G5FHPI3IBMOU,D. Brown,20060224,44,4.681818181818182,132.61363636363637,47,6,41
A1G5MI2KREPEIB,Smilin Sam,20090415,47,4.25531914893617,319.4255319148936,132,24,108
A1G5RO0P612L4C,"MissingBj ""Karen""",20091210,25,4.48,40.96,10,3,7
A1G5UT9USR9JIL,Nick M.,20091120,21,3.238095238095238,92.47619047619048,198,107,91
A1G650TTTHEAL5,"Charles Spanky ""Zumina Reviews""",20130828,89,4.865168539325842,824.4494382022472,300,34,266
A1G6LD5VL0LE23,Cam,20080706,22,4.636363636363637,177.63636363636363,110,10,100
A1G6M86XS35YS3,"Paige Turner ""Paige""",20090310,35,4.257142857142857,230.0,299,21,278
A1G76T4T41F5X3,"Brunzie ""Brian""",20070506,27,4.333333333333333,44.666666666666664,24,15,9
A1G7YNZXPBWA4Y,RON,20110924,37,4.45945945945946,53.891891891891895,7,5,2
A1G84JVGCWCUEJ,ammarselophotography,20120116,21,4.333333333333333,167.14285714285714,46,8,38
A1G8USRY17IR1X,Michael D. Adams,20080709,23,4.565217391304348,541.6521739130435,189,26,163
A1G8X4YKXFW94X,Programming Kat,20100403,33,4.545454545454546,90.63636363636364,6,12,-6
A1GA14N6IVZBYE,DLU,20120802,21,4.904761904761905,47.285714285714285,6,1,5
A1GA6VKP9EHZCE,"B. Nerney ""BTN""",20100117,36,4.722222222222222,37.47222222222222,21,6,15
A1GALZCXD8FHOR,Daniel L Edelen,20021123,22,4.045454545454546,264.0,266,22,244
A1GBT4UN2RW7XY,"For Real ""HAND""",20051227,85,4.0588235294117645,222.41176470588235,361,132,229
A1GBU479WXR7UG,"Lloyd W. Hayes ""Lloyd""",20100825,48,4.0625,241.47916666666666,164,24,140
A1GCFTFXELCHRP,Big Texas,20110411,27,4.074074074074074,61.592592592592595,26,9,17
A1GDPB4W1YUCUP,R. S. Rehmel,20071224,22,4.7727272727272725,52.31818181818182,19,4,15
A1GF4BH6WPBZ4Y,Roman Pennington,20060807,28,2.4642857142857144,108.03571428571429,183,106,77
A1GLWEE3XX4GD7,william,20110712,23,4.478260869565218,54.43478260869565,273,71,202
A1GN8UJIZLCA59,P Magnum,20100329,36,3.861111111111111,84.22222222222223,29,26,3
A1GNSLNCXXG2HE,R. A Gibson,20020210,25,3.68,182.36,738,81,657
A1GNYV0RA0EQSS,"Sl Judge ""gatormomz""",20010117,50,3.98,131.42,158,40,118
A1GOKUUDRB63FQ,"Stratman ""Don""",20030305,25,3.96,224.2,235,52,183
A1GPGBHBI6T2HJ,"Jeff Edwards ""RadioJeff""",20020124,35,4.285714285714286,568.3142857142857,787,73,714
A1GPS8D0AWIEG8,CT0123,20100917,44,4.75,61.43181818181818,11,6,5
A1GPVV2XWNGSDX,C. J. G.,20070113,31,5.0,78.93548387096774,29,3,26
A1GQEQEB55INKP,"Keon B. Billings ""Digital Rastaman""",20090513,28,4.535714285714286,88.07142857142857,16,4,12
A1GQPGYMU1RSGK,SuperCourier,20071109,32,3.71875,198.78125,121,19,102
A1GQRGB8FGSLIZ,M.L.,20031211,74,3.864864864864865,252.67567567567568,365,51,314
A1GR9G76RYNL1K,"D. Oberholtzer ""IT Guru""",20101204,23,4.434782608695652,142.7826086956522,88,6,82
A1GVV4ZICQK8XB,Frank Jones,20100114,36,4.361111111111111,202.5,66,19,47
A1GW7V6S6XSXX3,Christopher Mayo,20080309,65,4.0,289.66153846153844,1164,62,1102
A1GWG5CWLKJ7ET,,20081016,73,4.287671232876712,225.46575342465752,275,76,199
A1GXWPT3SKUWCL,"Nik ""G. T.""",20090402,23,4.3478260869565215,48.73913043478261,16,1,15
A1GXYTQDJ0JNH,videobruce,20070405,29,3.0689655172413794,337.2413793103448,692,64,628
A1GYDZWZ0EBJ7E,Insectophile,20060318,28,3.642857142857143,87.39285714285714,27,8,19
A1GYEGLX3P2Y7P,Shala Kerrigan,20091221,71,4.253521126760563,217.59154929577466,155,23,132
A1H0CWFQY2HFGG,"Bud Bundy ""B movie lover""",20041225,24,4.208333333333333,253.25,52,6,46
A1H0D7635GEEJ1,Jeremy,20090122,45,4.333333333333333,494.1333333333333,1800,79,1721
A1H0XVUP5YV2OG,R. Pena,20110310,21,4.619047619047619,48.095238095238095,4,2,2
A1H1BPKUMGVIA8,"P. Bergbauer ""Reading Raven""",20081205,23,4.478260869565218,224.2608695652174,97,21,76
A1H2FM8MV7NRLY,V. O. Ritter,20110113,22,4.454545454545454,159.22727272727272,17,2,15
A1H2O4ES4WPIQA,Sanjay Shankar,20070928,22,4.454545454545454,95.68181818181819,13,4,9
A1H2ZJB0SS9NKP,C. Shultz,20121123,27,4.111111111111111,69.37037037037037,13,12,1
A1H4IVXNXWWBLV,"Chilehead Photography ""Captured Moments are t...",20070109,70,4.328571428571428,187.97142857142856,237,25,212
A1H4WLPFV59XMA,"Jim Krupnik ""jkrupnik""",20030302,28,5.0,521.2857142857143,5629,147,5482
A1H4Z4OSMNDCFC,HawaiianEye,20081014,48,4.6875,124.60416666666667,130,9,121
A1H55L0BLPCWYF,"Amazon Customer ""j allen""",20060125,48,4.833333333333333,156.52083333333334,105,13,92
A1H5ULX1FXNCWM,"Yogesh N. Badiani ""yb""",20101029,21,4.0476190476190474,46.80952380952381,65,16,49
A1H62U2FJKAQP8,Aerofool625,20121103,21,4.428571428571429,104.28571428571429,4,0,4
A1H6JP5UC5WVT7,Edward Durney,20070220,43,4.046511627906977,167.5581395348837,74,12,62
A1H6SBO7R007I8,A. Reader,20090224,71,3.915492957746479,241.88732394366198,373,87,286
A1H7Y5XKPGT0OS,"Rama Rao ""Rama""",20100623,54,4.092592592592593,147.1851851851852,34,12,22
A1H8I2PH00UQ2K,,20120704,27,4.777777777777778,94.33333333333333,57,11,46
A1H8PY3QHMQQA0,"Dave M. Shaw ""mack dave""",20100830,22,4.409090909090909,96.77272727272727,33,7,26
A1H8UMB0BB6SGC,Nick Panaccio,20120912,39,4.512820512820513,67.38461538461539,5,2,3
A1H98YV5K5BUX0,rjgsphinx,20080420,70,4.514285714285714,95.44285714285714,194,21,173
A1HBEQWSMVQEWJ,Joosby C.,20110426,56,3.9285714285714284,185.76785714285714,517,110,407
A1HBI9BBQIG1NH,Ward J. Lamb,20060822,55,4.109090909090909,119.10909090909091,83,64,19
A1HBKF83GCKS1K,"Singlespeed ""single speed""",20090907,22,4.7727272727272725,59.63636363636363,6,7,-1
A1HBLNE8QYSG3Z,"Guy M. Kitashiro ""gkitash""",20050202,23,4.086956521739131,175.30434782608697,119,11,108
A1HCBWWNKUYDOY,Robert S.,20100803,23,4.434782608695652,88.95652173913044,30,3,27
A1HDQMD058B644,"James Q. Smith ""JQS""",20021228,40,4.525,360.45,346,22,324
A1HERKH287L0V7,"Jake J. ""Jake J.""",20120724,26,5.0,73.76923076923077,9,2,7
A1HF7HD4IO7ZJI,jadegal,20090428,22,4.409090909090909,45.04545454545455,10,11,-1
A1HFT68GJ42LTM,AverageGuyShopper,20051030,57,4.2105263157894735,232.82456140350877,156,25,131
A1HFV5MPMB6EL3,THE ULTIMATE PIZZA MANUAL Fan,20100518,24,2.3333333333333335,158.41666666666666,69,114,-45
A1HGGPFOID71JZ,Chris Keegan,20120708,26,4.8076923076923075,33.88461538461539,12,16,-4
A1HGOTMS9H27PB,"Travis Manley ""Travis Manley""",20070926,23,4.0,87.47826086956522,47,11,36
A1HGXLP6WATS4B,,20030318,26,4.384615384615385,354.61538461538464,236,21,215
A1HJIDNAY31M20,,20110110,32,4.1875,78.0625,42,13,29
A1HJISB0NCF2V0,Ted,20130118,25,4.92,54.8,10,4,6
A1HKG0O3ET1F2R,"peace warrior ""uss constitution""",20080128,25,4.24,94.76,33,5,28
A1HL0V61O8Q0JK,Steve K,20120630,23,4.826086956521739,73.52173913043478,26,4,22
A1HLCYF3QEGT6V,"R. White ""Old Bob""",20090705,21,4.142857142857143,20.80952380952381,5,3,2
A1HLJJ6MKZLR3Z,Rebekah,20110219,22,4.136363636363637,257.3636363636364,40,7,33
A1HLWWD2GTPB28,"Gavin Farrington ""Gavin Farrington, Photographer""",20111023,39,4.256410256410256,190.12820512820514,315,25,290
A1HNCA3GR4J7ZP,Kurt,20110525,22,4.5,47.45454545454545,13,7,6
A1HNLKHX0RXJKB,Joseph E. Repasky,20080831,22,4.636363636363637,145.36363636363637,17,7,10
A1HOJZ7CVUV1FT,Justin Zane Chudgar,20110312,27,4.0,62.55555555555556,15,3,12
A1HOLE9R6WPT85,Mad Max,20090527,23,3.608695652173913,311.0,493,34,459
A1HOLJW15Q5S5V,"James John Hollandsworth, M.D.",20081202,34,4.4411764705882355,120.5,124,19,105
A1HOS1D36R1YAJ,Mark Hunsaker,20070118,48,4.395833333333333,146.5625,230,33,197
A1HPYU44KORTSR,coach george,20110111,38,4.421052631578948,121.0,41,12,29
A1HRDIMSH5FHKB,"Hollyecho Montgomery ""Hollyecho Montgomery""",20071018,32,4.71875,54.75,13,2,11
A1HRECPV2Q79BG,718tech,20040706,23,3.130434782608696,192.0,298,68,230
A1HRYC60VTMYC0,Ace,20081218,24,4.5,204.375,39,4,35
A1HSM98KUGTHNY,shawn,20080830,46,4.065217391304348,111.91304347826087,175,47,128
A1HSSN4VBILHIB,Christopher,20130428,23,4.434782608695652,69.65217391304348,14,1,13
A1HT4X1GUTVDX7,W. Costley,20080119,21,4.428571428571429,423.4761904761905,494,11,483
A1HT81V0Z717H7,TrippMe,20100228,27,4.481481481481482,44.370370370370374,10,1,9
A1HTB488P5GRCP,Roy,20010228,21,4.333333333333333,219.33333333333334,661,132,529
A1HTWL26WM2NVU,Ronald L. Esarey,20081215,27,4.666666666666667,84.96296296296296,47,18,29
A1HTXSEDVJBXEM,Amazon Customer,20100210,28,3.25,159.42857142857142,102,26,76
A1HV53CKY1CN24,Claw,20120909,24,4.208333333333333,116.0,9,8,1
A1HW4M029I31C8,"Ancient Mariner ""Proud Republican""",20050727,21,3.9523809523809526,141.28571428571428,182,28,154
A1HXESZHP7SXKI,"Tram Truong ""cuegeee""",20100122,39,4.461538461538462,57.666666666666664,73,8,65
A1HYDE16Z8XNK3,Surrealone,20111030,29,4.448275862068965,87.65517241379311,33,11,22
A1HYH206E18XVC,Bass Cadet,20080214,46,4.065217391304348,232.82608695652175,170,22,148
A1HZ6T8V9IFBRV,soradore,20120604,29,3.689655172413793,89.51724137931035,8,7,1
A1HZCY03RQTOTI,"fiddler ""imbuzz""",20071228,22,3.727272727272727,69.5,56,28,28
A1HZRZTGXO5RUW,tall2010,20110503,41,4.341463414634147,76.07317073170732,107,147,-40
A1I07CXVEAGDE8,Johnathan M. Burger,20071013,33,3.6666666666666665,69.51515151515152,117,16,101
A1I0QSOQ3FNZL6,"J. Park ""Normal Sensory Perception""",20091013,21,4.333333333333333,161.28571428571428,39,17,22
A1I1ZGZUDM326L,Magnus,20070616,24,3.8333333333333335,188.70833333333334,135,21,114
A1I2GZRMGVCMIY,Techchris22,20130306,29,4.241379310344827,38.0,2,2,0
A1I30AQPN08TJL,"RM ""RMDC""",20100316,37,3.27027027027027,111.5945945945946,67,23,44
A1I48WAP3Z0VKX,stephen7777,20100825,26,4.653846153846154,65.6923076923077,9,5,4
A1I4NHYX40MFD,C. Keeney,20060308,37,3.7837837837837838,163.56756756756758,57,33,24
A1I6U5AQAT3ZG9,"E. B. MULLIGAN ""Bronwyn""",20120524,21,4.666666666666667,241.14285714285714,37,18,19
A1I7FQ1M9VRL4Q,Carefree Dude,20121215,32,4.6875,34.71875,1,0,1
A1I7QGUDP043DG,"Chrissy K. McVay ""Writer""",20100606,25,4.56,150.52,16,20,-4
A1I8BJY2M3A4CO,Amazon Customer,20120113,23,4.739130434782608,47.82608695652174,6,2,4
A1I8ZYUJ21YXJ,Carol Burns,20130927,26,4.538461538461538,96.5,36,4,32
A1I96OYAUJ3HQE,"Barbbe ""Barbara Stewart""",20091111,39,4.82051282051282,46.61538461538461,6,2,4
A1I970110U4B0V,"M. S. Edwards ""cristobal""",20120214,29,3.5517241379310347,70.06896551724138,21,40,-19
A1I9UKDCLPH4PR,wael elsedeki,20130221,33,3.909090909090909,31.757575757575758,6,9,-3
A1I9Z7BQW5ZD0S,postman,20090702,26,4.961538461538462,141.0,54,13,41
A1IANEBSMVGHS9,"Manny Hernandez ""@askmanny""",20010616,29,4.0344827586206895,197.6551724137931,241,46,195
A1IBKN1GXYJ3K4,Dave,20010526,45,4.6,356.6,1696,75,1621
A1ICWJAM8Z14BD,gadgetjunkie,20080714,32,4.65625,201.71875,381,33,348
A1IDAKX7OM3QIE,"An Engineer ""Happy Shopping!""",20070517,39,3.5128205128205128,165.28205128205127,230,57,173
A1IDWUYX4QXTUE,Leslie,20100106,28,4.142857142857143,212.42857142857142,35,8,27
A1IEUP4GAK09EK,"alan hjertstedt ""jert""",20130815,25,4.88,26.88,5,1,4
A1IFLXKH7VFT7Q,F. Topping,20121004,22,4.7727272727272725,12.590909090909092,4,0,4
A1IG1I6MR3HAWA,nagappa,20010617,49,4.755102040816326,391.61224489795916,769,35,734
A1IGO319TZ0AUF,Julia,20081126,22,3.6363636363636362,272.95454545454544,306,24,282
A1IH42TUIZ2XJL,Gab,20060109,40,4.225,110.45,84,31,53
A1IILFFC2EUXFC,Dallas Electronics Fan,20040922,40,3.825,287.775,400,77,323
A1IIQO2453V234,,20140503,22,4.136363636363637,43.09090909090909,3,5,-2
A1IJOBQD8CY8K1,kwmar,20090428,25,4.64,92.6,22,5,17
A1ILH2P1AQPNKA,Russell,20101020,26,4.769230769230769,58.30769230769231,3,0,3
A1ILRPVVS0R7ED,Joel Cleare,20110514,43,4.558139534883721,71.88372093023256,52,31,21
A1ILWPH1GHUXE2,JB,20041222,91,3.879120879120879,323.64835164835165,759,114,645
A1ILXP537CK3SW,steve o,20100520,33,4.03030303030303,97.0909090909091,22,30,-8
A1IM4D3R61A2K0,DR. B,20070106,33,3.878787878787879,185.93939393939394,242,41,201
A1IMK99FD7RPOL,"Ohio dude ""Big guy""",20020402,38,3.6052631578947367,173.10526315789474,62,30,32
A1IN6UFBCST73K,"Richard G. Durham ""Survival Advisor""",20070815,34,4.205882352941177,86.1470588235294,33,9,24
A1INE33UQ1B4Q3,booktalk29,20070704,44,4.431818181818182,98.9090909090909,69,20,49
A1INUATAQG85TJ,Gregg B. Macey,20120314,22,4.2272727272727275,65.63636363636364,18,15,3
A1IP3G76WMYEKD,Al Bud,20110719,22,4.909090909090909,104.63636363636364,17,3,14
A1IPFGQ9EH8BGL,MadCarpenter,20090109,40,4.55,229.65,39,8,31
A1ITJWI9QCHL0X,Randall D. Lind,20090106,27,4.407407407407407,122.0,22,14,8
A1ITRGMT80D5TK,"ThisThatNEverything ""thisthatneverything""",20081113,55,4.072727272727272,304.74545454545455,182,23,159
A1IU45A3FMMY0Q,Wally,20030904,23,3.9565217391304346,300.0869565217391,372,20,352
A1IU4JZFDZA9HJ,"FaCS teacher ""Middle School teacher""",20080626,24,4.541666666666667,136.875,27,6,21
A1IU4UAV9QIJAI,Tyson,20110818,33,3.9393939393939394,27.96969696969697,8,9,-1
A1IU7S4HCK1XK0,Joanna Daneman,20010407,122,4.442622950819672,312.4918032786885,1309,39,1270
A1IUANSOUF93LY,"MasterTech4523 ""CambridgeTech""",20041018,40,2.425,82.35,156,143,13
A1IUJLN94QVB76,Pir,20020916,35,3.8285714285714287,111.97142857142858,51,23,28
A1IUNUV8YDSMHU,J. Ward,20110203,43,4.6976744186046515,58.18604651162791,8,8,0
A1IUTYIY6PW8DU,L. F. Smith,20061104,28,4.714285714285714,175.60714285714286,330,10,320
A1IUXWSIQJYA3Q,C. Nelson,20110123,22,4.7272727272727275,119.5,9,0,9
A1IV194W97KZ8Z,Robert C. Boyer,20060712,27,4.703703703703703,51.44444444444444,45,4,41
A1IW95OQV7A16I,joe picchietti,20130112,34,4.647058823529412,48.794117647058826,6,4,2
A1IWMPKH1ELQQP,J. Chin,20080922,28,4.357142857142857,91.64285714285714,40,11,29
A1IX0NC997O0NS,J. Austin,20071217,23,4.695652173913044,286.60869565217394,1866,268,1598
A1IYD7KDN99QY6,B-Rad,20120926,21,4.619047619047619,100.85714285714286,38,5,33
A1IZ6UH9V32GLG,Brian N,20110114,25,4.6,108.0,4,0,4
A1IZJVLNMFACS6,"Tanzanite Gal ""Denise""",20100113,21,4.714285714285714,171.95238095238096,42,6,36
A1IZWXZC9OZRCG,"M. Cheshire ""you bet yer ace""",20100608,21,4.333333333333333,73.19047619047619,62,16,46
A1J0OS2XYUKEIE,"John Hoving ""John Hoving""",20080331,26,3.230769230769231,232.26923076923077,171,79,92
A1J1A0SKA65LR,Steven Klimasewski,20091222,34,4.382352941176471,271.97058823529414,167,18,149
A1J2EGMZ62RR4V,"Moss Parker ""moss_parker""",20090401,35,4.4,157.42857142857142,44,28,16
A1J3RDO34RPC91,Roy Wiegmann,20100521,37,2.6216216216216215,99.27027027027027,80,68,12
A1J4D61PYYGA3,Foofienugget,20131007,26,4.346153846153846,32.0,2,2,0
A1J4J7CN93BH3W,S. W. Cantrell,20081125,21,4.190476190476191,98.95238095238095,150,24,126
A1J4OZEQIKM2E,Ryan Leonard,20070716,28,4.571428571428571,152.5,86,4,82
A1J58SNEH7I0E0,"Mike42 ""Mike""",20100724,23,4.913043478260869,66.26086956521739,9,1,8
A1J5BGM658BIUS,"Mike. R ""Value Consumer""",20090415,23,3.5217391304347827,192.56521739130434,624,44,580
A1J5HIF41ENSMZ,Adam Wood,20061209,61,3.9344262295081966,497.4590163934426,655,73,582
A1J6B00Z1D6PS4,"Livin' La Vida Low-Carb Man ""Jimmy Moore""",20071201,40,3.7,136.175,24,29,-5
A1J75JJ0Q2OEJN,Raven A. Wind,20041118,199,3.9648241206030153,481.4170854271357,2992,324,2668
A1J7LKMZG3ZVLU,E. Turner,20071017,24,4.375,157.45833333333334,137,15,122
A1J87SYB3JPQWH,"Warren Harris ""Nocturnal Wanderer""",20081221,39,4.769230769230769,55.92307692307692,46,18,28
A1J8NSP8WD75YN,Danny Grizzle,20080702,21,3.857142857142857,309.4761904761905,202,12,190
A1J95TTG4AYBU8,BAH,20060606,39,4.6923076923076925,301.8974358974359,238,15,223
A1J97T5QWF5QUJ,"David ""Dave""",20090106,36,3.8333333333333335,174.88888888888889,112,66,46
A1J9LVA298D5OF,inkster,20130422,34,4.411764705882353,85.76470588235294,12,3,9
A1JA1P53VHJ023,"Larry W. Barrett ""happygolucky""",20111019,26,4.923076923076923,24.96153846153846,5,4,1
A1JB9VPSLLFLNZ,Richard H Schurman,20140101,22,4.136363636363637,72.68181818181819,5,16,-11
A1JBEKU5TYIWE7,MinnieWinnie,20090319,44,4.545454545454546,103.9090909090909,54,13,41
A1JBMZRN6M3NKC,roman310,20120216,41,4.390243902439025,167.2439024390244,21,9,12
A1JDCXLSJ1LU0H,alt,20070605,23,3.652173913043478,163.3913043478261,25,5,20
A1JE04PMENX23K,"Randy Wakeman ""Randy Wakeman""",20111118,35,4.2,904.6285714285714,1448,152,1296
A1JEJEDR7NDZ7C,Zach B,20110715,29,4.551724137931035,47.96551724137931,74,8,66
A1JEJP6FCBJDCR,Z. Riggle,20110111,21,4.333333333333333,55.42857142857143,14,3,11
A1JG0WY9LWE3BN,Miguel,20110621,23,4.478260869565218,170.82608695652175,38,25,13
A1JHGHQW6YCOZ0,Sarah Carter,20110707,26,4.384615384615385,53.5,5,6,-1
A1JHYXRIWK30O6,Eric,20121009,21,4.380952380952381,89.76190476190476,9,1,8
A1JIWMPQS6TPJK,Photo Bug,20101121,30,4.966666666666667,54.4,5,4,1
A1JJHDHCF6FOTO,Eric in Vegas,20080515,39,4.102564102564102,100.02564102564102,83,4,79
A1JJM6COMQOO4Y,Jeff N,20110116,23,4.086956521739131,376.04347826086956,49,15,34
A1JJOV69MAU2J2,Steven Dennis,20010815,31,4.032258064516129,360.0,2095,120,1975
A1JK7KFBZ4J3JJ,"RJK ""rjk""",20130520,22,4.818181818181818,117.68181818181819,16,10,6
A1JLNAP9O841WK,G. Ko,20090118,37,4.297297297297297,98.24324324324324,122,7,115
A1JOD6023BCP4F,Jeffrey R. Barry,20100117,24,4.083333333333333,95.95833333333333,4,7,-3
A1JQ7K37IVD50C,RglrJoe,20110902,21,4.714285714285714,57.57142857142857,4,1,3
A1JRVC0DYLFM8D,Marti R,20131224,37,4.135135135135135,99.94594594594595,16,3,13
A1JT7SG36391B8,"Smiley ""Larry""",20090522,37,4.54054054054054,44.945945945945944,4,13,-9
A1JTTI1KH3DOCY,"Doggymcnuggets ""doggymcnuggets""",20071122,23,4.434782608695652,262.3478260869565,41,4,37
A1JUBRIZMO0RJV,"Steve H ""books911""",20050123,97,4.381443298969073,577.7422680412371,9153,805,8348
A1JUJM2FDDREHY,Duha,20120808,27,4.888888888888889,29.14814814814815,2,1,1
A1JUKS0DSO2XZG,Sid Nuncius,20120630,33,4.7272727272727275,330.06060606060606,73,6,67
A1JUO2ZP2EFOHX,Bogus Exception,20070630,22,4.318181818181818,196.95454545454547,372,60,312
A1JVEATNF4GP94,Barry J. Gervais,20100122,29,4.689655172413793,246.41379310344828,76,35,41
A1JVK6EX9KV7P,W. Cornett,20050929,26,4.730769230769231,91.6923076923077,21,2,19
A1JVOQPEGPL7FB,Julian Trejos Zelaya,20080309,24,4.625,68.66666666666667,42,8,34
A1JVOV54H4ZVFC,"riggarob ""riggarob""",20081220,36,4.5,63.166666666666664,26,21,5
A1JW5U7Q0TRIZ6,Bobby1st,20061022,23,4.3478260869565215,180.43478260869566,52,13,39
A1JWO6YVALFXBZ,rideabiketoday,20100702,25,4.72,41.44,4,2,2
A1JWSDDIH5Z7DV,D. R. Schryer,20020724,43,4.976744186046512,178.2325581395349,857,126,731
A1JXWKSVPTLYDL,Cron,20101225,22,4.545454545454546,51.13636363636363,2,0,2
A1JZFGZEZVWQPY,"Carter H ""1amazonreviewer@gmail . com""",20030515,94,3.925531914893617,218.17021276595744,579,33,546
A1K1F9WCJ403CU,Cholly,20110625,24,4.666666666666667,87.66666666666667,16,4,12
A1K1HNG1TLL7AR,VIPbeachBum,20111211,29,4.655172413793103,52.793103448275865,15,5,10
A1K1OT9VARZRG3,Ahmed Ramahi,20080506,31,4.580645161290323,217.6451612903226,74,12,62
A1K1QD4M8CQSLB,Hawk-eye,20080523,28,4.392857142857143,105.10714285714286,85,13,72
A1K3STPP7QSU8Z,"D. Pappas ""DenVette""",20090526,41,4.926829268292683,39.609756097560975,7,3,4
A1K45HFFFDNP1A,P. Bradley,20101224,24,4.416666666666667,101.83333333333333,25,4,21
A1K4G5YJDJQI6Q,Steve C,20081109,58,2.793103448275862,256.58620689655174,226,97,129
A1K5HT39YKZAHH,Chuck Nasty,20130430,22,4.363636363636363,94.81818181818181,12,9,3
A1K5KHJRKINCP,Paul Cassel,20110630,24,4.083333333333333,434.7916666666667,109,19,90
A1K635LBS8Z29C,Alex,20080107,23,2.782608695652174,181.95652173913044,125,46,79
A1K6QY7SX2UGQ8,mjovanovic,20120926,29,4.0344827586206895,163.20689655172413,28,4,24
A1K73H16UK8XU4,"John C ""John""",20100427,31,4.258064516129032,48.61290322580645,22,6,16
A1K7UR1PGQX8CH,"Ben ""Ben""",20060418,21,4.095238095238095,73.23809523809524,24,32,-8
A1K9LHOWOCYVBZ,dvelosky,20111129,38,4.605263157894737,109.02631578947368,25,4,21
A1KAE1LOY4TBSV,"R. Gardner ""RPG""",20091014,31,4.709677419354839,81.64516129032258,59,3,56
A1KAERT0MPBZOO,Arnim Zola,20050327,32,3.75,340.65625,672,53,619
A1KAO39AX6J5CN,"Chris ""Rum & Jokes""",20130127,22,4.409090909090909,50.81818181818182,6,2,4
A1KBIM0GO3H2W4,Jared,20121226,21,4.714285714285714,28.476190476190474,1,1,0
A1KC3BVQ70CAMW,C. Messer,20120831,29,4.482758620689655,176.27586206896552,116,31,85
A1KC46Z3OSFHD4,F. Ong,20100130,36,4.722222222222222,92.88888888888889,52,2,50
A1KCEFHPULW0OU,Jason,20110530,40,4.675,72.125,22,10,12
A1KD8NJPZ01R37,doppelganger,20010813,57,3.4035087719298245,165.03508771929825,318,323,-5
A1KDM0N4UCEPHA,"lil ""lil""",20091118,32,3.6875,172.0625,28,15,13
A1KDQXZHQIG5QG,M. Gerrish,20050202,23,4.173913043478261,252.1304347826087,443,56,387
A1KDUQ2HU0WD68,M. Fulkerson,20090808,83,4.313253012048193,283.12048192771084,232,58,174
A1KGKPWWG61U42,"John S. Ruzicka ""John R""",20001229,22,3.909090909090909,138.0,150,49,101
A1KGNGL5KT3CJU,D. Krepak,20100601,21,3.142857142857143,315.0952380952381,29,34,-5
A1KHK2DZOF99ON,oshirenshi,20110522,26,4.769230769230769,34.80769230769231,4,2,2
A1KI7YHQEOS1RB,"RBrandon ""Grimm147""",20120605,57,4.578947368421052,120.56140350877193,127,15,112
A1KJG4QIFO389U,Directed Energy,20040425,30,3.2333333333333334,538.7333333333333,634,88,546
A1KJRNFAO7K5S5,J.,20120215,31,4.67741935483871,61.16129032258065,7,6,1
A1KKE6VX8VPWZK,"Geekdomo ""GeekDomo""",20080105,90,4.644444444444445,221.88888888888889,1026,135,891
A1KKELD6HY6UMP,Vato,20110308,22,4.7727272727272725,71.5909090909091,41,9,32
A1KL17ER98VUHC,Amazon Customer,20091210,21,4.523809523809524,282.76190476190476,1507,70,1437
A1KL1YVYYMQE2E,W. Moncure,20120315,24,3.75,408.8333333333333,121,13,108
A1KLPS6P7UR631,Karl Bielefeldt,20070303,29,4.275862068965517,208.06896551724137,130,21,109
A1KLZY9NL0AKMV,kandiamo,20120801,21,4.714285714285714,498.3809523809524,258,11,247
A1KM3IPZ9H0JKZ,J. A. Quayle,20111212,28,4.357142857142857,71.32142857142857,9,3,6
A1KMB1WVG8QM8H,pfeitosa,20100823,33,3.9393939393939394,142.27272727272728,49,6,43
A1KMHJNBCNJ7E6,Leo Martnez,20110112,21,4.142857142857143,204.47619047619048,22,19,3
A1KMITAI5ETLHB,T. Goodman,20110422,24,4.5,62.125,7,6,1
A1KMSYUCPIE0NS,"ziponein ""DDR1918""",20110831,39,4.897435897435898,168.74358974358975,14,3,11
A1KOOC0V1UWJJQ,pc doc,20110604,36,4.083333333333333,54.388888888888886,11,5,6
A1KOS72KKSP80X,NUSA,20121130,34,4.411764705882353,63.0,14,11,3
A1KOX2MG6BNDJT,"ldj ""Don Jessup""",20110516,21,3.761904761904762,111.66666666666667,40,26,14
A1KOY9EHK46SG4,EmiEmc,20091023,21,2.6666666666666665,101.38095238095238,34,21,13
A1KSNK256G46GX,"Dr. Carl ""Dr. Carl""",20071009,41,4.536585365853658,52.97560975609756,30,11,19
A1KSO56UWS2R7I,"Adam L. Safianow ""Kiddo""",20040920,27,4.222222222222222,299.0740740740741,1330,148,1182
A1KT19TDP9VE63,Honest Consumer,20071224,33,3.8484848484848486,129.27272727272728,24,15,9
A1KT1GWCW8F80,K. Gittins,20050125,27,4.148148148148148,322.5925925925926,443,26,417
A1KTKRVGQGWNBF,"Ted K ""duraflex""",20061006,22,3.772727272727273,183.22727272727272,256,30,226
A1KUKFI8NWFT57,Samwize the brave,20090912,23,4.565217391304348,108.52173913043478,46,12,34
A1KV4THCI8ME86,scooby,20110610,28,4.928571428571429,66.92857142857143,53,0,53
A1KWLSHD6O5V9J,"PJD ""smart shopper 30144""",20100615,30,3.466666666666667,179.2,57,25,32
A1KWPIORLG2QV,S. Daily,20090130,49,4.8979591836734695,72.44897959183673,42,9,33
A1KXJCXS6HFRQZ,Amazon Customer,20070210,84,4.142857142857143,351.07142857142856,484,98,386
A1KY25HG3D9NWB,"PghDrake ""PghDrake""",20090415,31,4.451612903225806,173.3548387096774,16,1,15
A1KY5G5FP31F2F,Richard L. Steiner,20030908,63,4.603174603174603,312.85714285714283,1814,100,1714
A1KYJA5YM1479G,"K. April Holgate ""Take a look it's in a book....",20130205,26,4.153846153846154,67.3076923076923,9,2,7
A1KZMSXC9JOI7Q,"RJMacReady ""RJMacReady""",20070607,25,3.88,155.4,145,31,114
A1L0P1ZP5FD6EC,Video guy,20120904,35,4.371428571428571,59.628571428571426,23,7,16
A1L0SUHFS9LHPA,"Jessica Weissman ""poet and computer programmer""",20080524,29,4.620689655172414,209.86206896551724,66,24,42
A1L14TJ4LSADUP,K. Matthews,20070821,23,4.608695652173913,146.0,32,6,26
A1L1N3J6XNABO2,Daniel Mosquera,20110812,42,4.833333333333333,42.73809523809524,8,4,4
A1L1S42BOGPF96,John Flora,20040709,30,4.266666666666667,180.06666666666666,224,24,200
A1L2S18BTJE1BZ,SLV,20110616,21,4.523809523809524,45.61904761904762,8,5,3
A1L2STZ2U6Q607,John B,20130226,24,5.0,50.416666666666664,4,2,2
A1L3I2Y8KLYM5V,akshatp,20100825,28,4.857142857142857,52.892857142857146,6,1,5
A1L4SL2FTPES5E,"Nathan Bedford ""Thanny""",20111013,23,4.913043478260869,40.47826086956522,19,5,14
A1L5PM0IE9TIPH,"Mark A. Biernbaum ""Researcher and Psychologist""",20130707,22,4.136363636363637,86.0,9,4,5
A1L5TA5UQF7EWE,J. C. Danko,20080726,57,3.43859649122807,174.08771929824562,167,42,125
A1L64KDYO5BOJA,"Floyd Goodrich ""Jim G.""",20061025,100,4.54,153.5,774,64,710
A1L6GSPJMCNZQW,BrianS,20070103,23,3.5217391304347827,192.91304347826087,123,52,71
A1L6JIEDXTTTDQ,"DLH ""D""",20100717,21,4.571428571428571,133.0952380952381,21,5,16
A1L7H5MPBT4J3X,Speed Freak,20100528,24,4.75,50.166666666666664,73,15,58
A1L7M2JXN4EZCR,David G,20130819,31,4.451612903225806,78.80645161290323,22,3,19
A1L7MZ4BTI00MF,Mark Diehl,20110816,22,5.0,86.63636363636364,8,3,5
A1L8HRCM60W0W7,Shashank Tripathi,20030411,22,4.090909090909091,287.6363636363636,462,44,418
A1L8THDQHPG9B2,Mike R,20070315,22,4.954545454545454,93.0,48,4,44
A1L9CRJ8WNSUU7,Mo,20050924,30,4.133333333333334,347.1666666666667,390,142,248
A1LA4K5JF78BER,"M Masaki ""MM""",20070129,44,4.318181818181818,267.8181818181818,197,27,170
A1LAGS8H4A2DR7,Bill Nicholas,20070330,60,3.95,345.51666666666665,194,36,158
A1LCD2PXSSLSL6,"M. Maney ""Marty913""",20070102,36,4.305555555555555,266.47222222222223,195,22,173
A1LD3TWO6S695J,crow11ad,20070817,22,4.454545454545454,147.5909090909091,58,22,36
A1LD5SE8IZ1H70,Meng Qi,20091111,75,4.333333333333333,144.30666666666667,680,200,480
A1LE0GS647MSMQ,M. Ketteman,20100520,25,3.44,124.44,39,7,32
A1LEMDY6BDO34U,A. Shrestha,20090512,31,3.903225806451613,286.83870967741933,652,63,589
A1LESMGKXUXMX5,Michael J. Burton,20121225,21,4.904761904761905,38.23809523809524,2,0,2
A1LFN5TXQ0B1HB,Constantin,20080219,29,4.413793103448276,182.3793103448276,53,22,31
A1LG1DKUZXGJ6J,"N. Beitler ""Avid Reader""",20110321,30,3.933333333333333,289.4,188,50,138
A1LGB9RZX3SR0P,"maxmasa31 ""maxmasa31""",20031103,26,4.115384615384615,601.0384615384615,547,25,522
A1LH6RF4UN9VI6,"E. D. Garcia ""Biggie-E""",20031227,42,3.9047619047619047,227.33333333333334,247,42,205
A1LHAXBM5GBJS2,Scooter McGavin,20071118,30,3.8,180.03333333333333,191,28,163
A1LHMSY3Q46PJS,"Bob ""Bob in Big Bear Ca""",20051218,47,4.319148936170213,327.8936170212766,210,25,185
A1LHZ500F6LWBJ,Amazon Customer,20061212,24,4.25,56.291666666666664,5,0,5
A1LIRKVD44KUZE,JR-Texas,20041221,33,4.212121212121212,134.66666666666666,65,4,61
A1LJ1L00Z8DBF3,JNH,20120109,36,4.694444444444445,67.83333333333333,15,4,11
A1LJ3BCAVCYXV2,"Sean C ""tech entrepreneur""",20070620,35,4.628571428571429,83.48571428571428,17,1,16
A1LK2X9A3A5BM4,C. Pak,20090808,30,4.4,189.0,640,56,584
A1LKOIZXPQ9VG0,Elisa 20,20060101,38,4.368421052631579,278.13157894736844,230,21,209
A1LKZTTXTWD4M7,mydogplaysthetrumpet,20050813,24,2.625,62.583333333333336,118,77,41
A1LLTZ2I28D3MV,"Dcool7 ""Dcool7""",20070828,27,4.037037037037037,95.48148148148148,19,9,10
A1LNAYGURDK668,efficacy,20120423,38,4.421052631578948,207.05263157894737,147,46,101
A1LNJB04KQT1HB,Kian O'Connell,20100914,21,4.809523809523809,160.9047619047619,293,14,279
A1LPNH9XWZWLNX,"Raymond W. Leung ""rwleung98""",20121129,24,4.666666666666667,38.083333333333336,10,10,0
A1LQ4V9JGG3GA5,Joel E,20101222,21,4.761904761904762,97.14285714285714,7,13,-6
A1LR4PEKZUW1M3,"Andrew Kim ""Multix""",20111028,22,3.409090909090909,140.86363636363637,42,2,40
A1LSUY0BJ47G1S,"Michael Lindsey ""mickeyrv""",20110331,22,4.318181818181818,30.59090909090909,0,0,0
A1LTCG19G04SWV,"MZypher ""MZypher""",20091101,44,4.4772727272727275,84.31818181818181,28,9,19
A1LU5QIPA9RLP4,"Randy M. Harris ""Astronomy Newbie""",20060225,21,4.619047619047619,68.57142857142857,33,4,29
A1LUZV4GV5VGRJ,R. Nielsen,20110921,31,4.806451612903226,119.38709677419355,41,0,41
A1LVCWRU2GVB3Q,Dill,20120702,26,4.538461538461538,71.61538461538461,11,12,-1
A1LW93HGONNQUU,Dr. Philip J. Kinsler,20060228,21,3.238095238095238,175.71428571428572,88,38,50
A1LX9GX70O2WFQ,"R. Berkman ""Ron""",20090924,22,4.590909090909091,79.22727272727273,8,7,1
A1LXESUUNI846B,J. W.,20060914,25,3.92,274.2,432,47,385
A1LXFDHH2V42BC,"C. R. Smith ""RDiddy""",20091212,21,3.9523809523809526,63.0,15,4,11
A1LY79U7ULWCNN,Wayne,20120924,22,3.8636363636363638,74.68181818181819,5,0,5
A1LY7Z60TNV629,John Coleman,20060218,25,4.88,34.12,51,14,37
A1LYDMJ55BBQJB,"Hatchling001 ""Hatchling""",20071207,26,4.730769230769231,53.80769230769231,8,2,6
A1LYMYNURB9EWW,"digitalman ""digitalman""",20080915,50,3.78,308.64,1205,61,1144
A1LYZLVEHF1GF,Donald M. Pollack,20090617,23,4.782608695652174,160.8695652173913,19,3,16
A1LZC0L3YA72HU,Drumemo,20140319,23,4.695652173913044,76.04347826086956,4,1,3
A1LZG65FZYIAOF,"R. Greene ""meggabitz""",20040407,22,4.363636363636363,138.1818181818182,45,12,33
A1M1Y5UGONAW06,Jody,20090116,34,4.4411764705882355,212.6764705882353,128,17,111
A1M2JTFHREYECK,anniez,20110618,30,4.766666666666667,47.56666666666667,20,18,2
A1M3GEH8UY8ZBV,Vance,20070825,26,3.230769230769231,304.34615384615387,185,20,165
A1M3NVR8A3O627,Stephen,20120118,30,4.566666666666666,68.5,11,9,2
A1M4QC5BZDMBIZ,"John Doe ""media man""",20081130,23,3.782608695652174,150.91304347826087,49,35,14
A1M5LJSCJ19S6F,"J ""tech head dc""",20000907,26,3.230769230769231,313.61538461538464,95,22,73
A1M5LRYDZ8R0US,Da 808 State,20090924,27,4.518518518518518,82.92592592592592,15,7,8
A1M5ZT35YX6TIN,Holly K. Lee,20090310,22,4.2272727272727275,117.36363636363636,48,13,35
A1M7HP5CHDXXOU,"Andre Choquette ""BorderBuyer""",20100117,76,4.421052631578948,155.5921052631579,175,49,126
A1M7J4AFRBZN2S,nettskee,20130825,21,4.428571428571429,34.142857142857146,3,4,-1
A1M7U7YWWWLP6N,Gadget Guy,20120418,22,3.9545454545454546,109.68181818181819,67,9,58
A1M7Y63Y5GYJI1,Tracey Carter,20110514,29,4.310344827586207,247.0,52,22,30
A1M83WJ8SMHK2U,c.mac,20110328,32,4.5625,154.78125,38,3,35
A1M841R4VB4AVY,Omar Shahine,20010802,24,4.333333333333333,87.16666666666667,29,16,13
A1M90AWAN9N7MR,james mccants,20140109,23,4.956521739130435,44.78260869565217,1,1,0
A1M9126YPQPS3L,Larry F. Rogers,20010610,36,3.75,297.1388888888889,445,92,353
A1M9BA7J07JEA6,Domenico Bettinelli,20070804,33,3.8484848484848486,204.84848484848484,81,13,68
A1MAQHECJKA2OV,Happy Amazon Customer,20111027,23,4.826086956521739,32.34782608695652,4,1,3
A1MB5HUA3WYEJC,"Mike ""Movie Buff""",20070702,27,4.7407407407407405,522.7407407407408,178,19,159
A1MBXP3NZM2BUO,nguyen tran,20100414,65,4.507692307692308,136.16923076923078,258,71,187
A1MCH5RXDOH87H,"Keith Blodgett ""Hawk""",20040310,50,3.48,312.54,481,102,379
A1MD9AEU9C4WJN,"uniq ""uniq""",20020628,32,3.8125,102.8125,49,26,23
A1MDKZ5IGXEQ1O,"Tyler Atkins ""Kiserai""",20060826,22,4.7727272727272725,281.3181818181818,89,14,75
A1ME4C08J183J9,Michael Walker,20090204,28,4.571428571428571,64.25,12,4,8
A1MEISNED4NP7U,BubbleCat,20110926,60,4.833333333333333,126.38333333333334,71,5,66
A1MEJ80JTZQCQA,"D. Kang ""dk""",20111004,21,4.619047619047619,126.19047619047619,40,4,36
A1MF8WUUFS676Y,lindguini,20031004,24,4.583333333333333,595.4583333333334,959,25,934
A1MFAPVBW9BEGD,SanPa,20080301,84,3.511904761904762,98.60714285714286,196,106,90
A1MFBS0255Y72P,ELSC,20081203,27,4.518518518518518,122.48148148148148,36,3,33
A1MFI9TR61DB0Z,Jim C. Titus,20091102,21,4.571428571428571,51.0,6,2,4
A1MFN7I3V18QDZ,R. A. Majestic,20130223,21,4.380952380952381,60.857142857142854,3,15,-12
A1MFO2DXH2C2B5,-TMcN-,20050602,27,3.6666666666666665,188.5185185185185,143,33,110
A1MFPAM9TTRTXN,W. Price,20070115,57,4.9298245614035086,103.64912280701755,9,3,6
A1MFVAHTT2BHM0,J. Wang,20071220,80,4.0625,230.2875,252,34,218
A1MG9IQUFXMW64,"Gary F. ""Garfy2008""",20090409,22,4.5,83.5909090909091,23,6,17
A1MGID9E7TBWV1,An Average Guy,20110806,25,4.6,58.16,4,0,4
A1MGP4UXFC5S9J,Customer in Detroit,20100317,28,4.285714285714286,44.714285714285715,8,4,4
A1MIWY5P4X6M4,S. J. Koblentz,20100801,25,3.92,213.4,148,33,115
A1MJMYLRTZ76ZX,magellan,20000725,63,4.222222222222222,472.44444444444446,1277,131,1146
A1MJS1YRKNMU04,Grrgoyl,20040330,26,3.8846153846153846,263.38461538461536,55,11,44
A1ML2HY0RQA64E,"Guitar Man ""C""",20091214,23,3.217391304347826,126.95652173913044,36,39,-3
A1MLNJK9HDCQLV,"Robert York ""maintain_composure""",20010103,21,3.761904761904762,193.04761904761904,95,16,79
A1MLTMR44XAHM7,Alison R.,20121118,21,4.904761904761905,44.476190476190474,10,1,9
A1MM30YDKJPG06,"Rowe Rowe ""floydian""",20050609,24,4.416666666666667,370.25,114,8,106
A1MMEARDASNIA0,NJP (Ohio),20000425,22,4.181818181818182,261.77272727272725,928,31,897
A1MMFSW19AM019,B. Wueste,20101008,34,3.9705882352941178,231.8235294117647,896,60,836
A1MNI6WD5RS7YM,"AstroBob ""AstroBob""",20081216,28,4.321428571428571,219.03571428571428,78,15,63
A1MNN0ZMHYPJDU,Daniel Stephens,20040311,48,4.895833333333333,29.125,38,5,33
A1MNX0HKE40X7W,Tech-Guru,20090503,30,3.466666666666667,116.83333333333333,186,99,87
A1MO6NO1GP58EJ,William Kraski,20081128,23,4.391304347826087,226.30434782608697,37,3,34
A1MQI2J8PVD7BM,Bruce E. Harang,20111208,21,4.857142857142857,104.28571428571429,10,4,6
A1MQQEM7W77L62,Robert,20020210,50,4.82,132.32,184,22,162
A1MR1VMK999I6O,"Beth DeRoos ""Beth DeRoos from the California ...",20020819,23,4.869565217391305,131.8695652173913,33,23,10
A1MRPX3RM48T2I,Winter,20031007,110,4.536363636363636,463.7090909090909,1324,140,1184
A1MRRMHGV3PN5W,"Stacie L. Helsing ""stacielc""",20070118,55,4.1454545454545455,108.25454545454545,108,107,1
A1MSEO4MD7ZT33,David Simmonds,20110317,31,4.32258064516129,36.74193548387097,15,9,6
A1MT6DM5N1OFND,"B. Davis ""The Good Guy""",20090219,26,4.230769230769231,123.73076923076923,18,15,3
A1MU2MRUV1541F,Coonass,20101211,21,4.9523809523809526,29.571428571428573,1,0,1
A1MUHTKSOY7WVO,Michael B,20131217,28,4.714285714285714,61.07142857142857,21,0,21
A1MV3EBWBUI0X,"PopPop ""PopPop""",20040722,23,4.478260869565218,78.47826086956522,25,12,13
A1MVH1WLYDHZ49,Captn' Bob,20130101,22,4.7272727272727275,56.72727272727273,7,1,6
A1MWTILB9DZSLZ,R. Gibson,20100109,23,4.391304347826087,205.56521739130434,86,3,83
A1MXJVANURX26J,G. Wells,20070120,29,3.5517241379310347,99.24137931034483,45,15,30
A1MYQRCX4M9NHZ,L8er,20121210,22,4.409090909090909,65.68181818181819,13,6,7
A1MZL91Z44RN06,MussSyke,20100413,116,4.568965517241379,247.00862068965517,1130,93,1037
A1N03A4M6T4BCI,"Dr. Roger L. Mccarthy ""The Fe Duke""",20091114,25,4.28,82.0,61,15,46
A1N03V52IRZ5PR,"N. J. Simicich ""Gadget Geek""",20021116,25,4.24,468.44,104,22,82
A1N2JL8ROQWQNW,Lost Weekend,20101005,27,4.2592592592592595,92.77777777777777,20,8,12
A1N2RUOL8FHPNM,Amazon Customer,20110103,22,4.590909090909091,53.5,19,6,13
A1N3CH42SZWEP,"smtips ""smtips""",20100529,22,2.909090909090909,177.04545454545453,51,132,-81
A1N3EH28S4DI8L,R. Certain,20131104,51,3.9411764705882355,89.2156862745098,58,24,34
A1N50A9TCGTTLZ,"M. D. Zimmerman ""Dr. Zim""",20120804,27,4.666666666666667,89.4074074074074,44,12,32
A1N50YHLR4IWUY,ERK,20120712,24,4.75,47.875,26,7,19
A1N5CYKYE5DTZE,,20110815,33,4.2727272727272725,137.75757575757575,38,16,22
A1N5FL7SNKG1JV,"Arin ""MN Electronics Geek""",20091202,32,4.53125,119.53125,44,6,38
A1N5FSCYN4796F,"Philip R. Heath ""Gadgets, Music, & Books""",20050819,124,3.8225806451612905,482.53225806451616,2250,234,2016
A1N5JM9QQ3JFSS,Paul,20121130,29,4.517241379310345,62.689655172413794,0,0,0
A1N63P1KY594SY,"Stephen Ingraham ""lightshedder""",20081214,24,4.25,157.95833333333334,66,24,42
A1N73M40MPPWSR,Badboatygirl,20121217,21,4.095238095238095,189.0952380952381,58,9,49
A1N7ROYP7TGWI,JohnDoe155,20031114,28,4.0,236.89285714285714,119,29,90
A1N8FRMRYUHHV0,Troy H,20090321,26,4.923076923076923,100.26923076923077,99,17,82
A1NA2JGI3GNDN2,Albert,20050410,35,3.7714285714285714,116.82857142857142,15,6,9
A1NAA1R38JSNHV,Josh Leger,20090814,51,4.588235294117647,70.45098039215686,19,12,7
A1NB0UGAONC2M,Indetrucks,20110816,30,4.3,69.93333333333334,23,4,19
A1NB945QH1SSJ9,GC,20140117,22,3.409090909090909,1625.2727272727273,398,269,129
A1NBBG8BALZ0BP,Peter Henry,20121004,37,3.972972972972973,173.51351351351352,90,19,71
A1NBC9AMD0I1DW,CT,20100824,21,4.476190476190476,76.0952380952381,18,5,13
A1NBEFTWVMIGN2,"Chris Ace ""Chris Ace""",20090701,42,4.023809523809524,130.95238095238096,662,61,601
A1NDKOP4QR8VWR,"W. N. ""Will-N-LA""",20050123,24,2.7916666666666665,207.41666666666666,61,69,-8
A1NEIH01B5X6QL,K. Faasse,20080314,22,4.318181818181818,119.0,34,4,30
A1NF7WJJ5U0TGZ,Ariel Benzakein,20070405,21,4.333333333333333,88.28571428571429,36,11,25
A1NG7NU5NO86M1,StangoDango,20060627,24,4.666666666666667,107.625,33,8,25
A1NGFGBX2VCQS8,Ralph Furlong,20060316,135,3.9555555555555557,392.7851851851852,1994,158,1836
A1NHNWB5MGL1OX,O. M.,20090111,29,4.137931034482759,71.20689655172414,72,25,47
A1NIGUK4M2ST8,mk,20100527,24,4.625,193.79166666666666,25,9,16
A1NIX2WA2ZKLV7,Pushpin,20110725,22,4.590909090909091,284.90909090909093,61,5,56
A1NIXQHXXCW8BJ,Naldox,20110925,24,4.25,35.375,42,77,-35
A1NIZ4UELGSCVV,Derek Bain,20101222,21,4.285714285714286,85.33333333333333,13,3,10
A1NJ6MBO6TURL9,Stas T. Wright,20110314,22,4.5,46.77272727272727,2,1,1
A1NJ78QAK65BUH,Jeffrey A. Higgins,20101209,26,4.153846153846154,47.5,135,36,99
A1NJHKPHD4YWZV,Brian,20080315,56,4.035714285714286,139.33928571428572,154,26,128
A1NJQ0NZS83SFM,J. Parkes,20071202,32,4.25,297.375,232,58,174
A1NM2QNCNU27CW,"Andrew ""Andrew""",20110226,44,4.7272727272727275,66.0909090909091,35,8,27
A1NMM0RDRF6R84,Blaydese,20071224,46,4.369565217391305,65.3913043478261,48,45,3
A1NMR2C1GW3V2W,"Ed Win ""Al Smitheee""",20090507,23,4.391304347826087,42.17391304347826,6,1,5
A1NMSGYZ92BROQ,"Norm Shelton ""Norm""",20070107,36,4.944444444444445,59.111111111111114,17,2,15
A1NNMOD9H36Q8E,"DigitalMan ""DMAN""",20070412,63,3.888888888888889,81.96825396825396,284,111,173
A1NPKJKOQ7KOE6,"Scooter ""Go Giants!""",20010615,43,3.813953488372093,165.13953488372093,228,48,180
A1NQFT941TOTT7,Mandryke,20110201,52,2.9423076923076925,124.3076923076923,229,86,143
A1NQKWS81ENDTV,Hopels,20100702,40,4.6,145.2,72,23,49
A1NRC1QV6O3XR7,"Celestino Cervini ""SteeKnow""",20130714,31,4.870967741935484,26.903225806451612,3,1,2
A1NRCHRSDXYFW5,Luis M. Fuentes,20120827,26,4.615384615384615,341.8076923076923,542,37,505
A1NRMTQ5SZPZA,Kat Yares,20110407,51,4.313725490196078,216.7450980392157,119,32,87
A1NSN3C3DE8YW2,IBCotts,20120203,21,3.9047619047619047,165.8095238095238,1664,146,1518
A1NU8K0Y5J5V3H,Michelle Carey,20050317,27,4.555555555555555,177.77777777777777,140,10,130
A1NVD0TKNS1GT5,"Chad A. Lauterbach ""chadl2""",20001002,23,4.391304347826087,139.2173913043478,582,62,520
A1NVDR4JONZHSJ,Nathine Goldenthal,20130818,23,4.565217391304348,28.08695652173913,4,1,3
A1NW9UW2HBW4B8,Tall n' Geeky,20090327,25,4.44,96.96,57,6,51
A1NZLRAZJGD99W,Kimo,20060113,56,3.7857142857142856,146.33928571428572,83,49,34
A1O09K4R0YVN3,"Ron M. Kolman ""Subtext""",20081109,22,3.9545454545454546,136.5,54,6,48
A1O1119HSSC233,Gregory A Ferdinandsen,20110225,24,4.083333333333333,96.54166666666667,47,11,36
A1O1ZU985GIN5T,dalefty75,20110514,21,4.666666666666667,52.80952380952381,7,1,6
A1O229NVVDJUX2,"Anthony Pantliano ""The Photo Guy""",20050802,86,4.151162790697675,465.69767441860466,2671,116,2555
A1O22UA181NUXO,Peter Nguyen,20100531,23,3.9130434782608696,171.3913043478261,8,1,7
A1O3FDAZQK8FJC,<,20011208,34,2.5588235294117645,87.97058823529412,103,187,-84
A1O4VYJPIK20V,Thomas E. Tweedel,20040709,24,3.9166666666666665,647.3333333333334,861,41,820
A1O53DT8R8JLLD,LongRodVonHugenDoong,20130519,21,3.857142857142857,60.333333333333336,51,6,45
A1O5U7CJ5V4AFA,"TaG ""T.G.""",20100416,27,4.185185185185185,83.03703703703704,6,3,3
A1O6CS7SXLGUWZ,"Mark Coons ""Music Man5""",20070429,32,4.8125,126.1875,118,17,101
A1O7AKVUH4482D,raja,20130729,31,4.0,11.903225806451612,0,0,0
A1O7GMWFQTTAA8,"M. Cyzio ""marektoja""",20020523,22,4.181818181818182,56.95454545454545,28,15,13
A1O816MS7MOXMR,L. McNerney,20091023,41,3.902439024390244,60.926829268292686,4,6,-2
A1O8BS2HKE5Y0O,"K. Benoit ""K B""",20110523,22,4.2272727272727275,74.54545454545455,33,24,9
A1O97WKID9L3IA,"Jeff Wignall ""Photographer, Author and Radio ...",20060328,36,4.666666666666667,337.5,82,7,75
A1O9FVF4MWOHQR,"Retired EE ""Daniel""",20091014,26,4.115384615384615,106.26923076923077,38,9,29
A1OA2ZW406NQXM,Mary S.,20050414,52,4.1923076923076925,215.19230769230768,205,76,129
A1OA7ZKRQH98C8,TitleWriter,20040924,28,4.071428571428571,223.39285714285714,135,14,121
A1OAQC95LBPWIN,Rene Bonvanie,20050910,23,3.608695652173913,217.82608695652175,146,29,117
A1OBBF7BHCKE1,Robert Watkins,20091205,24,4.833333333333333,201.16666666666666,34,4,30
A1OBJYK6JH67AF,Amazon Customer,20070911,22,4.454545454545454,87.81818181818181,20,3,17
A1OCDMMZ8B5BIE,S. Gardner,20120613,29,4.724137931034483,45.06896551724138,11,3,8
A1ODF6VBK5GWVI,"SCI-FI Nut ""Gravy Grabber""",20090123,38,4.447368421052632,37.18421052631579,15,4,11
A1ODOGXEYECQQ8,Nuknuk,20031013,333,4.327327327327327,206.9069069069069,1107,82,1025
A1OELIQU93FZRE,J. Kim,20040830,21,4.380952380952381,184.8095238095238,379,22,357
A1OES7R7FDAT2L,Xpendable,20110417,49,4.408163265306122,86.38775510204081,37,4,33
A1OEV44GI2XCPC,Peter W.,20130610,25,4.6,208.28,8,4,4
A1OEWDSPX827AC,Peter1971,20111018,29,4.724137931034483,153.48275862068965,10,3,7
A1OFZ0WFM50Y95,ACW1120,20100827,44,4.181818181818182,168.36363636363637,115,31,84
A1OGABPYBDGMO3,R. Compton,20100522,24,5.0,80.79166666666667,25,2,23
A1OGCPMSIVK7G4,ocxmichael,20120302,77,4.194805194805195,84.8961038961039,196,36,160
A1OH33MR6K4G5J,Cmodman,20101213,43,4.116279069767442,218.09302325581396,116,17,99
A1OIUU3DSO3DXZ,"Solar Powered USA. ""JustDoIt""",20080720,26,3.3461538461538463,128.80769230769232,31,29,2
A1OJ3D9JH4C8Z6,Flubber,20120306,21,4.619047619047619,29.857142857142858,1,9,-8
A1OKTNPURCNYKX,A.L,20101011,28,4.035714285714286,139.42857142857142,59,15,44
A1OLKLO2K6MZBK,BookWorm,20090715,35,3.9714285714285715,326.62857142857143,413,124,289
A1OLP6GUFNXKG5,G. Ramirez,20100703,31,4.645161290322581,73.87096774193549,27,9,18
A1OMMXGV9U3M1X,Roger N. Bryan,20090119,21,4.095238095238095,162.1904761904762,42,13,29
A1OMNOPD5QSS1F,Dmitriy Zak,20120327,22,4.181818181818182,141.72727272727272,15,1,14
A1OMXVXXP07F05,"D. Couse ""darkman1969""",20030413,86,4.174418604651163,181.1627906976744,679,95,584
A1OO9N1MRNQ7K0,Erik A. Berger,20070105,52,4.826923076923077,125.42307692307692,374,71,303
A1OOIUZZJL668R,C. Farley,20100329,23,4.086956521739131,53.73913043478261,6,0,6
A1OOLS3367Y7M4,Amazon Customer,20121029,31,4.516129032258065,39.935483870967744,26,9,17
A1OON8LXW3G6UE,"Rahul G. Sabnis ""brownboynyc""",20030113,22,4.681818181818182,60.68181818181818,9,4,5
A1OPKNO7IXWV27,R. Southern,20100303,27,4.407407407407407,255.4814814814815,47,4,43
A1OPM139NX6MM9,Donald,20121214,29,4.344827586206897,85.6896551724138,26,3,23
A1OR1W0V7VPTOR,I4Y,20120214,24,2.9583333333333335,121.375,21,20,1
A1OSMDPFCEYAU5,"Amazon Customer ""Virginia Ragtopper""",20091216,25,4.48,154.44,20,7,13
A1OW9KM1CZAF6A,David L Brooks,20110816,31,4.67741935483871,82.51612903225806,9,4,5
A1OWQSNSWPVPE1,"L. Esp.. ""LE IN LV""",20090509,29,4.379310344827586,135.06896551724137,251,90,161
A1OWRLSD7LTSQ9,"CJ. Stanek ""Creative""",20080816,34,4.5,138.5,37,14,23
A1OWROB7ZLPIYQ,"Richard Stromberg ""Photo Buddha""",20070929,23,3.739130434782609,69.95652173913044,318,189,129
A1OX19PDA486CD,"L. hitchings ""cme4brain""",20100818,33,4.878787878787879,129.87878787878788,28,9,19
A1OYKEHNH3E23C,"Robert Freund ""mexican_textiles""",20091101,24,4.0,76.45833333333333,23,4,19
A1OZ7I3DESX9NP,LDenny,20100206,35,4.742857142857143,61.34285714285714,10,0,10
A1OZA52DFY3SHD,Gaz Rendar,20060403,45,4.088888888888889,623.7111111111111,338,31,307
A1OZYQ4V83X8K4,Brad Hutchinson,20030605,27,3.5185185185185186,410.18518518518516,309,69,240
A1P0EP5KFOTBIJ,Curt Story,20050526,30,3.966666666666667,209.96666666666667,78,11,67
A1P0JSFW184ZXJ,"Jen ""Geek Girl""",20080107,116,4.586206896551724,419.2586206896552,416,69,347
A1P0KMRBCKB133,"Three D ""Three D""",20120502,26,4.6923076923076925,43.46153846153846,8,3,5
A1P1YPHUSPID1Q,AlienInvasion,20130101,23,4.521739130434782,159.30434782608697,28,10,18
A1P27BGF8NAI29,Alice in Wonderland,20060911,27,4.037037037037037,157.44444444444446,406,31,375
A1P2OBC87CTSRL,Rick,20111013,47,4.276595744680851,60.46808510638298,222,25,197
A1P38V2ZN0GXK6,meathead1986,20111225,26,4.6923076923076925,148.57692307692307,32,2,30
A1P3DDFL423B3C,Mitch Haile,20060117,56,3.8035714285714284,265.57142857142856,665,52,613
A1P4XD7IORSEFN,"J. R. O. Neal ""Islidur""",20080103,60,3.7333333333333334,123.98333333333333,1028,65,963
A1P5TN3N6L155V,"Keith LeDuc ""leduckut""",20081216,22,3.6363636363636362,653.5454545454545,67,35,32
A1P6EDJ89B9QGO,"jbx2usa ""jbx2us""",20060226,23,4.391304347826087,81.17391304347827,16,4,12
A1P7G2HTLG0ASS,IVB,20021029,28,4.285714285714286,50.464285714285715,15,4,11
A1P8NYDN32LBFH,sazhazman,20090328,24,4.791666666666667,40.208333333333336,65,5,60
A1P8YAWYRM3S7O,Brian R,20110222,22,3.5454545454545454,131.04545454545453,31,14,17
A1PAGHECG401K1,"Chel Micheline ""Chel Micheline""",20010121,48,4.3125,260.8333333333333,282,4,278
A1PB9XZDJNY3YR,fredyt123,20081110,37,4.351351351351352,150.86486486486487,53,22,31
A1PCOISXXOM6T2,,20120128,30,4.466666666666667,205.83333333333334,16,5,11
A1PDG1DRDNPLWU,"InHisHand ""planted-in-the-mid-west""",20120102,29,4.620689655172414,285.3448275862069,161,23,138
A1PEEY3IFLCYOH,Brent Thompson,20030811,21,3.9523809523809526,153.71428571428572,692,24,668
A1PEKEZTSDJAVH,Eric San Juan,20081209,23,4.521739130434782,231.04347826086956,109,15,94
A1PEXTGNF36I1Q,Robert,20111017,55,4.745454545454545,129.52727272727273,70,6,64
A1PF6BKW386KM,Juls of Antelope,20111020,35,4.428571428571429,106.77142857142857,85,3,82
A1PFI1AFJAZVA7,leibnitz,20120305,24,4.333333333333333,37.833333333333336,10,7,3
A1PFNGNFYEU8FN,Rick Hunter,20110915,28,4.035714285714286,35.0,6,3,3
A1PFRCYCXHGP7J,Komrad,20070205,27,3.962962962962963,149.4814814814815,15,6,9
A1PG70NH85K859,G-Man,20120128,34,4.5,57.64705882352941,19,4,15
A1PHP9P1HJG6O7,BobZoom,20100115,22,4.454545454545454,149.86363636363637,98,11,87
A1PI8VBCXXSGC7,Lynn,20090714,72,4.236111111111111,350.40277777777777,323,26,297
A1PIMVPZAD6X4V,Drew R/T,20130103,34,4.705882352941177,37.588235294117645,3,2,1
A1PJVW2GSF73E7,thejmjohnson,20110530,22,4.636363636363637,43.31818181818182,3,1,2
A1PK5EBCM2K3H4,Chris Jones,20130710,24,4.583333333333333,265.5833333333333,7,6,1
A1PKXKC5V9M8Z1,Rama,20130511,25,3.48,235.6,598,47,551
A1PL7QILVQV3IF,"The Taminator ""There's no going back. You've ...",20071219,68,3.9411764705882355,312.9264705882353,274,43,231
A1PL8JA0TEHBVN,Paulo Leite,20060604,24,4.541666666666667,251.95833333333334,265,141,124
A1PM7HH4F77NEH,AudiophileHeadCase,20100314,54,4.092592592592593,211.74074074074073,231,45,186
A1PMLKXHLMW04,BearPup,20120224,23,4.434782608695652,107.95652173913044,9,2,7
A1PN2U0AWXGVML,Mark,20011209,81,4.580246913580247,156.07407407407408,760,133,627
A1PNF6GT0Z0TR0,Kevin Russom,20110124,21,3.2857142857142856,39.19047619047619,2,22,-20
A1PO9F60BWSD11,"Marc Jordan ""Marky Da'  Saint""",20090227,24,4.5,368.75,470,50,420
A1POGSPD4HN8Y1,"Cap'n Stoob ""Stoob""",20050208,28,3.8214285714285716,288.17857142857144,430,69,361
A1POL0R3RNLZ53,SEN,20080306,38,4.184210526315789,160.3684210526316,183,10,173
A1POXXTXRSNEYU,"Bobby Dunn ""The Cyclops""",20061109,22,4.181818181818182,117.36363636363636,81,4,77
A1PP2DISNMZN53,"L.W. ""Say something about yourself!""",20091221,23,4.521739130434782,82.08695652173913,63,32,31
A1PPCXTB49PC9I,Mo DeMarco,20130213,30,4.533333333333333,78.7,21,2,19
A1PPDBGCKM9AM0,"Skipper McFearson ""quickcuda6""",20040504,21,2.9047619047619047,146.9047619047619,62,24,38
A1PPMB99YNFPRH,Tom Dowd,20070610,25,4.04,168.76,43,19,24
A1PPMXCNDMUYFU,John S.,20130704,21,4.761904761904762,50.0,2,0,2
A1PPS91NLI7KEH,suzatm,20071127,53,3.981132075471698,161.8679245283019,395,41,354
A1PQINAR1N3WBU,vince,20120319,23,4.782608695652174,202.82608695652175,26,4,22
A1PS4OYWUB0VX,H.Taylor,20121206,47,4.446808510638298,87.44680851063829,21,10,11
A1PSBR3JRZ9VO0,J. Van Wagenen,20130305,29,4.758620689655173,421.9310344827586,261,85,176
A1PSD8GAPKDZVB,reifnawss,20130131,28,4.464285714285714,65.14285714285714,6,11,-5
A1PSUH0U1FPQ6R,"Tiny D ""Lonely Guy 69""",20100305,27,4.222222222222222,212.7037037037037,103,21,82
A1PSVZBM894R5H,"B. Roy ""RoyTech""",20031114,54,3.425925925925926,331.4259259259259,765,155,610
A1PTBXZG04GT29,NewAgeMama,20120207,30,4.8,170.36666666666667,84,35,49
A1PTDJZ4N7TOPE,"bikertrashice ""Ice""",20091230,23,3.8260869565217392,82.3913043478261,57,14,43
A1PTYXQ0DOO2WI,350ZMO,20091011,26,4.346153846153846,207.8846153846154,39,5,34
A1PUGUYNJYIY29,Amazon Customer,20061023,26,4.615384615384615,82.3076923076923,97,19,78
A1PUV4XTMT14L3,"Aaron Demner ""FungusTrooper""",20130106,32,4.25,43.875,4,1,3
A1PV5T5S4D5NPI,Duane G. Jacobs,20070809,78,4.769230769230769,69.85897435897436,33,9,24
A1PVHCS99XNQIS,"Marcel Suliman ""Marcel & Joanna""",20120224,26,4.615384615384615,44.34615384615385,14,16,-2
A1PVJICI412IN4,Peter Ian Staker,20081025,65,3.953846153846154,109.64615384615385,108,26,82
A1PVX61PRPVX27,Anon,20130404,43,4.837209302325581,42.44186046511628,10,1,9
A1PWWI1Z2JTN5U,Bruno,20070103,25,4.8,449.88,439,40,399
A1PYPVMDIQ2I5O,"AsH ""AsH""",20100324,21,4.190476190476191,82.95238095238095,13,1,12
A1PZBHF3YHQXEI,"Sam ""Eagle 85""",20100526,29,4.517241379310345,288.7931034482759,140,5,135
A1Q1T811N4IY3Z,Wixby Bonnet,20090528,29,4.275862068965517,179.17241379310346,17,12,5
A1Q2ZZ1AP6GYWX,"rthompson ""Rob Thompson""",20110118,21,4.619047619047619,66.0,14,1,13
A1Q33MTP73V4QJ,GeoPat,20110503,24,4.458333333333333,46.833333333333336,35,6,29
A1Q3B4Q6W4FX46,"Richard A Drennan ""R Drennan""",20111030,30,4.266666666666667,83.93333333333334,17,7,10
A1Q3T04ED65WDS,"Robert Caputo ""Bob""",20070606,25,4.04,54.32,10,17,-7
A1Q4DJKNW73AIZ,Xin,20110712,32,4.75,220.4375,52,15,37
A1Q4JJBFCFZURG,Steve Swanson,20080211,21,3.0952380952380953,147.85714285714286,28,12,16
A1Q4MNIUESQTBM,John Schultz,20050919,39,4.076923076923077,189.7948717948718,88,16,72
A1Q5P5ML3176C0,B. Florence,20091027,53,4.113207547169812,121.71698113207547,70,16,54
A1Q62YZI5NZVW,J. Morgan,20090420,21,3.7142857142857144,74.80952380952381,17,5,12
A1Q65KYDKXIX8E,Leeland H.,20121231,23,4.826086956521739,45.30434782608695,4,1,3
A1Q6QSDVNK3L7M,Wolverine,20060821,22,4.363636363636363,108.36363636363636,26,2,24
A1Q6RBBZD8C9R6,RbwNY,20040305,25,4.04,264.2,849,39,810
A1Q6S35FSXG115,Eagle128,20120408,33,3.6666666666666665,106.6969696969697,52,38,14
A1Q70K27GSE8U4,Fishing Dries,20080731,26,4.461538461538462,149.57692307692307,163,10,153
A1Q7A78VSQ5GQ4,"Nice Lady ""a reasonable person""",20090127,28,4.571428571428571,121.07142857142857,41,15,26
A1Q80VFM8KP7Y,Yankee Z,20130109,23,4.434782608695652,32.95652173913044,4,1,3
A1Q8BSRA05DDZ4,M. Random,20070505,21,4.809523809523809,78.95238095238095,26,2,24
A1Q8JF7CJ1IFOF,Matthew Abell,20071011,26,3.269230769230769,162.76923076923077,28,3,25
A1Q8V6VBFTYTN7,Rob Collins,20070529,24,4.666666666666667,47.875,33,5,28
A1Q98ZMHZXOYWI,"Kindle Customer ""bata-bling""",20130128,22,4.818181818181818,36.5,6,1,5
A1Q9NE8OY1XD5J,John,20110402,21,5.0,220.61904761904762,21,2,19
A1QBA7K3TPPEGV,Evan Michael,20130122,31,4.516129032258065,100.2258064516129,12,2,10
A1QBOC76MIOJYP,MyPenName,20090819,30,4.266666666666667,301.5,48,16,32
A1QCUMGX7UHFL5,Adam,20070807,28,3.8214285714285716,479.5357142857143,217,41,176
A1QCZQTJNK3MU,"Bakeman ""no this isnt me...""",20111214,26,3.730769230769231,140.73076923076923,15,19,-4
A1QCZTQ1QBG892,"Richard Hughes ""Pickydick""",20090528,32,4.96875,76.125,55,14,41
A1QD80T2XYR9ZZ,Adrienne Ryans,20130222,21,3.4761904761904763,36.523809523809526,4,36,-32
A1QE1EJ2GDBXCH,"Zzyzx Oh ""Zzyzx Oh""",20100410,31,4.32258064516129,239.0,106,17,89
A1QEG80TQQ72RT,Michael,20100901,23,4.434782608695652,121.08695652173913,25,3,22
A1QEWOSV05RYEO,"Michael Brent Faulkner, Jr. ""Brent Faulkner""",20110919,22,4.0,253.95454545454547,19,14,5
A1QG13XG3EO2CX,Amazon Customer,20070730,21,4.238095238095238,174.0,398,19,379
A1QGV3FB11COJQ,retired toolmaker,20100718,26,3.576923076923077,137.1153846153846,37,98,-61
A1QJ10LEINDRWW,Mark Druziak,20050706,48,4.208333333333333,180.60416666666666,705,68,637
A1QJ8RKPWKXI7O,"domeboy ""domeboy""",20031028,22,4.0,244.13636363636363,379,35,344
A1QJJU33VNC4S7,D@rkFX,20080319,37,3.5675675675675675,116.4054054054054,183,68,115
A1QKJNY7ZMWOI6,Julie Frantz,20100803,25,4.6,44.56,16,11,5
A1QLQCJVGCQPP0,Brock Rumer,20070722,47,3.978723404255319,69.19148936170212,88,14,74
A1QM3DJC5D8NIT,Hambone,20131230,22,4.7727272727272725,227.04545454545453,61,5,56
A1QMHMW7EZBWTZ,Joe K,20080307,23,4.217391304347826,113.69565217391305,24,1,23
A1QMN8SJYRREMT,Dave Cunningham,20070223,31,3.7096774193548385,253.16129032258064,39,22,17
A1QNYLBG73QRNF,"Neurasthenic ""neurasthenic""",20050310,88,4.181818181818182,148.3409090909091,516,69,447
A1QO2POWYK1XWP,"Harrison M. Hughes ""H-diddy""",20081021,23,4.739130434782608,44.78260869565217,6,5,1
A1QOIHVQC5XWCJ,"A. LOCOCO ""TDB, LLC.""",20091213,53,4.6415094339622645,186.43396226415095,126,19,107
A1QOK9LU90ACF7,"William W. Davis ""famousdavis""",20070124,93,4.075268817204301,735.9784946236559,930,78,852
A1QOSELPYNDHZ6,"Patricia H. ""Patty""",20091228,21,4.285714285714286,45.476190476190474,7,3,4
A1QPZCVXMCIJQJ,"campaholic ""dw""",20090212,32,4.65625,71.625,15,4,11
A1QQ4RO4LTJFXM,"mini_hakr ""mini_hakr""",20091008,25,4.36,103.16,22,5,17
A1QQA7Y92L4F9R,Wavey Davey,20070118,75,4.533333333333333,1158.4533333333334,1386,223,1163
A1QQBXWG3SU8WR,"Wiley ""Livin' Large in OryGun!""",20040826,32,4.625,105.53125,109,16,93
A1QQDHM5YMLQ8Z,"Joseph Albanese ""The Joe Show""",20020424,34,4.617647058823529,256.6470588235294,270,64,206
A1QR76SYGTXJN5,"Adam B. Shaeffer ""ashaef""",20090505,33,4.363636363636363,110.81818181818181,17,20,-3
A1QRPS86NWHRZE,Strohmian,20060315,38,4.105263157894737,455.92105263157896,1412,97,1315
A1QRR06UY3LI9G,"Jack V. Carlisle ""Electronics entrepreneur""",20100603,27,4.222222222222222,37.25925925925926,34,5,29
A1QRST0A3IQIEF,"Hon Lee ""ham fisted cook""",20100525,44,4.954545454545454,37.11363636363637,8,3,5
A1QRY1FPUW7DKU,Thomas P. Ulrick,20100611,38,4.842105263157895,42.473684210526315,14,6,8
A1QRZL2Z6UDTUZ,Juan,20120423,25,4.56,39.48,4,1,3
A1QT3N5FUQ4I47,lainibug,20100715,25,4.12,175.76,49,20,29
A1QT5R11TBWJ4K,Red,20100923,25,4.32,76.32,19,7,12
A1QT6PHXDA5XDF,"Amazon Customer ""UbbBlubb""",20070321,27,4.592592592592593,39.81481481481482,22,8,14
A1QTHVA826XEOS,Super Mum,20050715,34,3.676470588235294,400.4117647058824,735,66,669
A1QU7J0U48W09S,Jon,20120929,21,4.523809523809524,143.71428571428572,18,3,15
A1QVFHPY8418HC,monkuboy,20011226,90,4.444444444444445,286.84444444444443,602,65,537
A1QVQ7UJY4VASG,"Margie Read ""magnoliamansions""",20101128,21,4.142857142857143,88.95238095238095,13,8,5
A1QZJJXKXF6CWC,Tommy O,20081021,38,3.789473684210526,105.8157894736842,126,34,92
A1R0KDKU3WMJ0X,"Al ""oldbot""",20060726,21,4.809523809523809,80.42857142857143,68,3,65
A1R0LNM873ALSV,MacInTX,20070108,27,4.555555555555555,61.18518518518518,34,6,28
A1R19YYR5OR26T,Frank Hoeft,20101209,59,4.3559322033898304,102.88135593220339,69,12,57
A1R1BFJCMWX0Y3,Shoe queen,20071127,26,3.3461538461538463,65.38461538461539,29,39,-10
A1R377IPZOKLMM,"Gina B. ""It's a dry heat!""",20011201,91,4.56043956043956,87.20879120879121,196,47,149
A1R3A8F7OSP3ZL,GhostFaceReviewer,20111203,22,4.5,355.72727272727275,133,12,121
A1R3GN9MEJFXM3,"I'm not an internet shopaholic - ""thebanker""",20080201,49,4.938775510204081,87.95918367346938,59,12,47
A1R4FLMBTTOZP2,"Monu Koshy ""Monu Koshy""",20110109,22,4.409090909090909,70.36363636363636,9,2,7
A1R4VHGGF1H23Y,"JSB Morse ""JSB Morse, Author""",20100302,38,4.552631578947368,171.5,21,16,5
A1R5LKUYO7XMZO,dadinmontreal,20090819,41,4.2682926829268295,54.63414634146341,9,8,1
A1R6DKN9YQ2YU1,Mercedes J.,20081129,23,4.521739130434782,238.3913043478261,713,9,704
A1R6QN70Y138G2,Richard D. Wilson,20080322,21,5.0,30.285714285714285,8,7,1
A1R6RKKE44AYA8,"Diane K. Miller ""diinIN""",20100118,28,4.821428571428571,209.85714285714286,125,16,109
A1R76R4E6A8S3B,Akash,20030501,58,3.9655172413793105,196.6206896551724,202,75,127
A1R7GCBUT70CM1,JCJ,20070512,23,4.434782608695652,53.52173913043478,55,17,38
A1R8R7XKJJ3Q3T,night player,20130718,39,4.487179487179487,92.53846153846153,12,3,9
A1R8RXVOGP7Q7C,"Jhon ""Jhon""",20081207,32,4.4375,97.8125,12,8,4
A1RB8GE2E1ZQWN,Rikki Boodram,20121230,30,4.766666666666667,144.8,13,28,-15
A1RBBQPFEY2WCI,"F. Marsh ""Computer Guy""",20070801,33,4.484848484848484,105.24242424242425,133,10,123
A1RCGK44YXNBBB,Brendon Edwards,20070420,26,4.884615384615385,33.19230769230769,58,33,25
A1RCPSZ3KBEQN7,M. Daniel,20130310,25,4.28,112.92,26,8,18
A1RDHBBZE1NPS3,"R. Garth ""rgarth""",20071217,50,3.8,266.98,251,62,189
A1REY92IEZJUSX,"Perry S ""Perry S""",20100211,40,4.725,55.225,11,1,10
A1RF9YK4BK5TRH,"Quality Man ""yway6""",20060603,25,3.52,364.32,80,12,68
A1RFZGWX46N8H7,"FlamingoNut ""Tracey""",20061117,47,3.574468085106383,209.40425531914894,184,47,137
A1RGK6Q5WUZUBA,Robbster,20100506,35,4.828571428571428,571.1428571428571,547,50,497
A1RHE0EI5GQM66,B. Holmes,20081229,32,3.5,229.46875,173,72,101
A1RIA11T4QKQIO,Joel,20130728,21,4.761904761904762,68.71428571428571,1,1,0
A1RIQUDE4B8NGX,Wildness,20070921,38,3.736842105263158,205.05263157894737,143,41,102
A1RISO6O425H7M,C. Purdy,20040212,33,4.787878787878788,89.84848484848484,80,17,63
A1RJKTYC03L0JY,Larry Lee,20100414,58,4.120689655172414,53.3448275862069,58,29,29
A1RJMEVTRP7EB,"C. Dean Waterman ""MacPastor""",20051116,22,4.363636363636363,113.5909090909091,162,18,144
A1RL1OTV8IJMVD,"William Grose ""Tzu Crazy""",20070323,135,4.051851851851852,389.25925925925924,4100,281,3819
A1RLP0R1N8H8C4,Kitten Kisser,20080126,31,3.967741935483871,252.19354838709677,57,19,38
A1RLSO6B5APQH4,GORDON R CARTER,20121226,23,3.739130434782609,26.217391304347824,1,4,-3
A1RMJZO6G0LJYH,"opanto39 ""opanto39""",20070925,23,3.652173913043478,139.0,47,16,31
A1RN468AQRRUTY,"RT &#34;Gadget Guy&#34; ""gadget guy""",20050504,23,4.173913043478261,757.7826086956521,986,44,942
A1ROUMJOGO4QMB,Steve,20090514,42,3.2142857142857144,77.69047619047619,125,65,60
A1ROYYD5M95V0K,Mr. Black,20130108,24,4.375,13.291666666666666,2,2,0
A1RP72UQDPKFK,azasadny,20121124,21,5.0,104.28571428571429,6,2,4
A1RPJHUVVSI98A,Justin Opinion,20061104,59,4.389830508474576,225.98305084745763,523,47,476
A1RPTVW5VEOSI,Michael J. Edelman,20000210,134,4.014925373134329,291.7910447761194,2475,115,2360
A1RQ3DWTAFPIEG,"LA Bill ""Bill""",20111108,31,4.516129032258065,23.774193548387096,24,1,23
A1RQPAAU6Q65XR,mashmash,20120815,22,4.409090909090909,49.86363636363637,9,3,6
A1RQYQO7CLYV54,M and K,20050103,27,4.037037037037037,308.48148148148147,607,46,561
A1RR36YKJB917S,"J. Thompson ""Janet's Treasures, a little of e...",20100911,29,4.413793103448276,83.79310344827586,65,11,54
A1RRMZKOMZ2M7J,Susan Katz,20080922,26,3.5,153.96153846153845,13,4,9
A1RVPR6XNR1H6B,"Duane A. Lueders ""Luedd66""",20080110,24,4.375,63.416666666666664,15,5,10
A1RVPYZXFV333D,"ND Mike ""rabid1""",20090617,22,4.2727272727272725,271.27272727272725,327,27,300
A1RWW5E04UJXQW,Eric Rose,20020722,39,4.410256410256411,318.0769230769231,235,14,221
A1RYL598X3XTX8,Eric Wentz,20130109,21,4.238095238095238,209.23809523809524,7,2,5
A1S0D037M0D71X,Steven,20120129,24,4.75,29.208333333333332,13,0,13
A1S0NVEWPJ6GZQ,W. Ivey,20061007,27,4.518518518518518,251.5185185185185,145,8,137
A1S1ZKDI1KHULX,Cecelia M. Clover,20060626,23,4.478260869565218,20.565217391304348,4,7,-3
A1S27P7KJO9I96,Eric A. Hofstetter,20041225,69,4.246376811594203,124.1159420289855,165,135,30
A1S2D1Y5WQ6646,,20070806,28,4.142857142857143,117.78571428571429,264,46,218
A1S2M6SA4OAUNK,Perry,20080224,26,3.8076923076923075,592.0769230769231,459,75,384
A1S2SSJULEEQD9,David Garcia,20120816,25,4.12,49.96,8,2,6
A1S3FOP19D8W1X,Jose Paez,20070219,34,4.705882352941177,241.73529411764707,176,29,147
A1S3OLD4614O7F,Aero,20040407,25,4.12,98.36,84,26,58
A1S3YVS4QRF1O0,Don Morales,20121219,28,4.678571428571429,65.03571428571429,5,1,4
A1S5251XGPBIVN,"L. A. Coley ""mrchaplaincoley""",20090502,36,4.472222222222222,54.77777777777778,14,1,13
A1S5G0CL6NZHM8,James M,20140411,21,4.809523809523809,28.142857142857142,1,1,0
A1S5SNUWS4P7W9,RT,20120403,21,3.6666666666666665,344.14285714285717,84,7,77
A1S5XHBZIYOGRE,Rachel Romano,20080222,23,4.086956521739131,198.95652173913044,66,12,54
A1S78V0MOUYFUA,L A.,20061228,28,4.392857142857143,143.5,26,12,14
A1S7BFT0HDF3HA,"loce_the_wizard ""loce_the_wizard""",20040318,46,3.391304347826087,196.41304347826087,265,41,224
A1S7YQQGJPPFLG,"Carolyn Lee ""Navy Wife""",20061127,30,4.766666666666667,162.83333333333334,342,34,308
A1S88XU6PWCTUD,Mark Midura,20110608,27,4.037037037037037,1108.6666666666667,179,19,160
A1S8FJT0AQSF60,C. Williamson,20060602,21,2.9523809523809526,189.57142857142858,281,69,212
A1S8M0YCTQ2I0S,Idaea,20111222,31,3.935483870967742,45.58064516129032,35,7,28
A1S97PGDNHHL38,MedIT,20080125,32,3.9375,200.84375,50,10,40
A1SAPIX5B669DU,"Raj Narla ""Raj""",20090813,21,3.9523809523809526,106.61904761904762,133,53,80
A1SAZB83QFR0W2,"JackOfMostTrades ""Jack""",20051210,23,3.9130434782608696,188.04347826086956,54,15,39
A1SB2D2GMXLBYW,"J. Ogann ""Kimo from IA""",20071117,24,4.958333333333333,191.20833333333334,121,2,119
A1SB65W16YH2XL,Brady,20130701,24,3.8333333333333335,68.0,12,14,-2
A1SB9BNNGKNX2Z,Jim,20080118,106,4.6415094339622645,592.8867924528302,1252,112,1140
A1SC5OXLQNGPLN,"Dan InGold ""xz38""",20080312,49,4.551020408163265,140.12244897959184,354,39,315
A1SCWY8O0IL2HU,"rhhardin ""rhhardin""",20000125,29,4.344827586206897,102.75862068965517,248,20,228
A1SD1C8XK3Z3V1,"guitfiddleblue ""guitfiddleblue""",20110626,37,4.675675675675675,104.4054054054054,20,16,4
A1SDPA1J98UP4L,"THE AUTISTIC WEREWOLF ""Wolf""",20040529,55,4.254545454545455,332.23636363636365,360,75,285
A1SEWFXOP5UCFL,Coach Tom,20130429,22,3.5454545454545454,32.54545454545455,23,8,15
A1SFPA80X7TRBR,"James R. Troje ""JRT""",20090413,44,4.613636363636363,55.43181818181818,11,1,10
A1SGMPECIVAMD7,e40,20061202,22,4.2272727272727275,111.77272727272727,52,45,7
A1SHHQSPOWR00F,"E ""--""",20070306,66,3.3333333333333335,177.5909090909091,1537,257,1280
A1SI2993YY7C61,"tomahagne ""...""",20070103,24,4.208333333333333,263.25,55,11,44
A1SI2OMTENFC9A,Katano,20120524,35,4.857142857142857,101.48571428571428,12,3,9
A1SIA07X88TTL6,"Jason A. Schmedes ""J$""",20110731,26,4.230769230769231,130.34615384615384,24,1,23
A1SJCQKVGSHTZ4,...,20130228,31,4.774193548387097,37.41935483870968,3,1,2
A1SJKE44UJH3R3,"C. Hua ""A Student""",20080326,23,4.304347826086956,229.7826086956522,107,16,91
A1SM3YUTM0C135,WolfX5,20090304,24,4.041666666666667,149.29166666666666,64,29,35
A1SMA1O26JGSNS,Mark1968,20130726,21,5.0,36.0,1,3,-2
A1SMN1GWJ4OKEF,Bill,20070205,28,4.571428571428571,118.0,32,4,28
A1SORZL733985Z,"Michael Demeritt ""2bz2p""",20080330,33,3.8484848484848486,140.5151515151515,68,32,36
A1SP0OX5KLGJQT,"donstein ""Don""",20081220,34,3.7058823529411766,127.3529411764706,78,24,54
A1SP366J07MNU,"Adebisi A. Ilori ""beecee""",20100623,24,3.7083333333333335,156.75,28,12,16
A1SQ4E255QMI8S,Bruce Wolf,20101023,23,4.173913043478261,47.34782608695652,67,35,32
A1SQ62FCV65AA6,mousepotato,20110101,29,4.793103448275862,296.3448275862069,233,143,90
A1SQYZQ9AJMJIZ,"deepsoul13 ""deepsoul13""",20060325,25,4.24,112.12,97,5,92
A1SRBGHX2NL436,"David Kennard ""Dave Kennard""",20110531,25,4.52,54.68,5,3,2
A1SSJM57US7NFT,P. D. Beverleigh,20090106,21,4.761904761904762,48.61904761904762,10,1,9
A1STW7ZA3XZ9VV,Matthew,20100314,23,4.130434782608695,39.52173913043478,5,17,-12
A1SU14Y0TDWHCG,David,20060223,23,4.521739130434782,206.43478260869566,38,8,30
A1SV0FYYADJLPG,Patsy L. Alexander,20100913,38,4.7368421052631575,94.34210526315789,11,4,7
A1SWIAG3T2W6XH,Christopher W. Burke,20080223,25,4.28,226.12,164,92,72
A1SX9PHJWTDMF9,EASY TRAVELER,20080305,43,4.767441860465116,83.4186046511628,44,18,26
A1SXCGBJ9JW2MO,"Stephen W. Templar ""rexGun""",20110801,39,4.6923076923076925,103.82051282051282,145,61,84
A1SY0RMLP947Q0,T. Johansen,20080827,32,3.9375,83.75,29,2,27
A1SYLII0808HD6,M. Allen Greenbaum,20020125,29,3.9655172413793105,361.17241379310343,615,42,573
A1T18O5P9JZTP,Dave,20110402,29,4.413793103448276,160.75862068965517,33,2,31
A1T19DCB7QR2M6,Arlene,20120127,21,4.333333333333333,49.714285714285715,20,10,10
A1T1YSCDW0PD25,A. Wiersch,20041203,204,4.416666666666667,175.68627450980392,986,160,826
A1T24KNMDGCHXH,Ed Sauerheber,20121216,26,4.769230769230769,62.07692307692308,20,10,10
A1T2CM7TPQRQQU,george,20100701,27,4.777777777777778,61.96296296296296,17,7,10
A1T2ZO4ARVSUGE,"D. Greenbaum ""DoctorDave""",20100718,45,3.7111111111111112,229.0888888888889,102,31,71
A1T37F0OVOATEW,Sherry,20121226,22,4.636363636363637,66.5909090909091,20,1,19
A1T3A9M7WSR48A,"James Stevens ""Avid reader""",20080216,32,4.34375,85.03125,16,2,14
A1T3ABYJNZZN7C,"Amazon Customer ""The Shepherd""",20080225,27,4.333333333333333,67.18518518518519,59,58,1
A1T4C041IHH5QN,,20120130,21,4.238095238095238,181.38095238095238,31,5,26
A1T5H7HNRWDUNL,PH,20090311,22,4.409090909090909,106.31818181818181,65,16,49
A1T61QP7QHYBRQ,an honest reviewer,20071109,31,4.580645161290323,155.25806451612902,100,19,81
A1T78S9EI9IN73,Mikey likes it,20080112,37,4.4324324324324325,307.9189189189189,326,37,289
A1T7EHCMZ92TKC,Amazon Customer,20060305,54,4.148148148148148,157.11111111111111,145,36,109
A1T7IB6NJ3KZFB,"J. Miller ""a_tech_guy""",20041020,23,3.9130434782608696,148.65217391304347,54,44,10
A1T9MILRRZ00F8,Maclen,20071226,53,3.981132075471698,325.92452830188677,492,56,436
A1TAO7RR96YTOG,Rakesh Koul,20080523,27,4.074074074074074,236.59259259259258,271,55,216
A1TBCT7195A7IU,"Janell ""Just DC""",20091105,27,4.703703703703703,51.18518518518518,5,13,-8
A1TBH7Z4RK7PRK,"Ron G ""Ron""",20020502,35,4.428571428571429,91.74285714285715,104,136,-32
A1TCIUMK1S3MBI,nuke,20100814,28,4.428571428571429,60.142857142857146,63,22,41
A1TDM71I95JW2,Jansin,20120818,25,4.16,125.2,17,5,12
A1TDR7Y90SVCHL,"Rodolfo Q. Z ""roqz""",20020519,84,4.345238095238095,70.88095238095238,190,24,166
A1TDU9KYO4EFE4,"Mark A. Underwood ""knowlengr""",20070907,24,3.7916666666666665,220.91666666666666,47,7,40
A1TF8YM1TQXV41,MidTwentiesDude,20140212,27,4.333333333333333,38.0,10,0,10
A1TFDMY4YNTV97,"Serg ""Serg""",20090326,39,3.4871794871794872,228.25641025641025,264,87,177
A1TFMR7RE985MF,Countess Chocula,20081230,22,4.0,259.54545454545456,211,21,190
A1TGQOP7CG1UNF,Ray_TN,20110530,27,4.481481481481482,181.55555555555554,6,2,4
A1TGT1Q4QHXB2H,Peter,20110420,25,4.48,197.32,3669,229,3440
A1THSBWV04YAIK,Speechless,20101106,21,2.761904761904762,145.04761904761904,24,9,15
A1THTWOPC9UOS4,J.E.S.,20100208,21,4.523809523809524,45.19047619047619,7,1,6
A1THXEB6HIGSAD,DH,20110603,34,4.352941176470588,296.97058823529414,195,14,181
A1TIJM7MW4WLXA,S. Roberts,20080804,21,3.6666666666666665,143.9047619047619,11,3,8
A1TJ393OFP21I8,Clam Canoe,20071015,22,4.2727272727272725,285.90909090909093,69,12,57
A1TJT6GXDGNN8Q,JustAnotherEngineer,20060318,23,3.9130434782608696,367.5652173913044,444,24,420
A1TL1P030KYGAD,Dagmar Miura,20040608,28,4.75,115.89285714285714,97,3,94
A1TLKLFUROWCJP,"Ruben Dario Hiciano ""Music Maven""",20050827,39,4.153846153846154,55.69230769230769,124,24,100
A1TND9THMFVTQG,"Denver Consumer ""bluetinkerbell""",20051121,26,3.3076923076923075,87.34615384615384,58,44,14
A1TNG2A1GAG14B,Philip Greenspun,20011001,38,3.4210526315789473,156.97368421052633,345,239,106
A1TNK6MP89YXY2,Jamie Wilson,20020202,26,3.9615384615384617,432.38461538461536,382,27,355
A1TO6BO58N6PHJ,"AJC ""Average Joe Consumer""",20080927,26,4.1923076923076925,166.0,25,2,23
A1TP2RW7KDI5AZ,"John Werner ""JWW""",20050123,36,4.111111111111111,359.0833333333333,53,24,29
A1TPQIM8DOH9JN,"Karl Stocker ""pixeltek""",20060215,23,4.565217391304348,106.21739130434783,49,7,42
A1TPV4UQMV4WR2,"I. Siddiqui ""IAS""",20070313,30,4.933333333333334,152.7,86,7,79
A1TPW86OHXTXFC,"prisrob ""pris,""",20090705,34,4.029411764705882,226.85294117647058,183,11,172
A1TPZY6UK553OI,"Erik R. Tank ""Erik Tank""",20060824,23,4.6521739130434785,134.2608695652174,37,18,19
A1TPZZ9HDPBBS0,Trelor,20130801,27,4.592592592592593,58.18518518518518,4,2,2
A1TQBAHI3M4ZBQ,"Jeffrey A. Hensley ""Hensley's Bluegrass Music""",20080602,55,4.781818181818182,68.32727272727273,117,5,112
A1TQZUSOU22E9M,Sidarta Tanu,20060930,112,4.607142857142857,314.0267857142857,4503,163,4340
A1TR1KNR3VKPHY,OkinawanMatt,20111031,29,3.5172413793103448,461.44827586206895,392,27,365
A1TR1R2QKWRSRA,"D. Chou ""THE Savvy Consumer""",20040523,52,3.730769230769231,248.75,115,17,98
A1TR3G8YUR8QMG,Cecil,20081218,21,3.380952380952381,243.33333333333334,91,8,83
A1TR88P7O27MDJ,"Cory J. Trese ""Android Game Developer""",20060322,27,4.407407407407407,46.7037037037037,376,77,299
A1TS45JWJVOSSW,"Duane Sparks ""Duane""",20081127,37,4.324324324324325,92.86486486486487,36,50,-14
A1TT4CY55WLHAR,anonymous,20090626,37,3.7567567567567566,260.0810810810811,148,76,72
A1TT5YBX2MXKQX,Jim Tice,20070512,44,3.590909090909091,27.227272727272727,18,25,-7
A1TUUSQODOPXOE,"Frank Forrest ""Quasar""",20001209,29,4.206896551724138,449.7586206896552,358,31,327
A1TUYFEAE1CH93,dennis,20120313,25,2.84,123.12,60,209,-149
A1TV5620JELC88,JM,20060520,21,2.5238095238095237,235.57142857142858,205,29,176
A1TVTDKNMSQ7XU,Grandpa Pipes,20080513,30,4.166666666666667,90.9,129,35,94
A1TWV6DKAUUVDQ,Robert S. Papps,20081025,22,4.681818181818182,37.09090909090909,6,2,4
A1TY3KN1CYPDWZ,M. Giganti,20060301,22,4.136363636363637,53.90909090909091,24,10,14
A1TY97ZGQT5FGF,"Daniel Night ""Do to others as you would have ...",20070312,49,2.4285714285714284,241.46938775510205,140,204,-64
A1TZCTQW0SAFT1,"S ks ""S ks""",20091205,23,4.130434782608695,38.73913043478261,3,4,-1
A1TZLGFM02XN9N,A. Lee,20080406,23,3.869565217391304,189.34782608695653,57,1,56
A1U11IP6K6NHAK,41reviews,20121210,50,4.62,156.26,89,29,60
A1U2YHOESZHSAO,"B. Garbe ""Former Fat Boys Dot Com""",20100701,21,3.5238095238095237,142.42857142857142,13,22,-9
A1U326F7V11W5D,"T. Alexander ""T-REX""",20100614,30,4.333333333333333,92.16666666666667,33,16,17
A1U47NXNF84DIH,"J Lech ""sparkle1103""",20050829,24,4.291666666666667,77.5,40,4,36
A1U4GOVZWL8ZTL,"Richard J. ""Richard J.""",20100824,72,4.722222222222222,160.55555555555554,56,6,50
A1U5IJHJK84S54,Daniel A. Koblosh,20060107,93,3.870967741935484,278.80645161290323,3239,196,3043
A1U5NWJOYH2QQH,Old geek,20000425,93,3.946236559139785,118.01075268817205,357,52,305
A1U5WAWSCQLKEW,"Pulpit Pounding Political Pundit ""Peppy""",20050808,29,3.896551724137931,46.3448275862069,155,50,105
A1U6175SAO9162,"A. Duluc ""Carpe diem.""",20050119,22,4.7272727272727275,148.0,77,13,64
A1U671PFFQQDFI,Smart Frugal Demanding,20110423,22,4.090909090909091,103.27272727272727,5,1,4
A1U6RLUA8D5DSX,Gearz,20101206,36,4.694444444444445,69.05555555555556,15,2,13
A1U6WGB15DBB4Y,"Jonas Bendsen ""i'm trying to help you""",20050513,32,3.28125,416.78125,184,30,154
A1U6XG3OMP5S62,B. Payne,20061110,22,4.590909090909091,64.81818181818181,34,7,27
A1U6XPYATU9OPG,G. Denick,20120623,33,4.515151515151516,229.78787878787878,153,20,133
A1U71LN94K6W25,Dan P,20120327,26,4.576923076923077,315.65384615384613,21,3,18
A1U75DBAUXQKE3,"J. Boutilier ""Jim Boutilier""",20010819,22,4.318181818181818,251.86363636363637,395,22,373
A1U7IOWFY8HLI6,Levelle M Laney,20110503,36,4.305555555555555,80.91666666666667,6,8,-2
A1U7LS93I03MFW,Christopher K. Koenigsberg,20080610,31,3.5161290322580645,180.70967741935485,72,38,34
A1U7RNEQX9DLZV,JeffNJ,20110909,23,4.173913043478261,99.0,17,1,16
A1U7YAYZCG6ELL,D. Everts,20091204,26,4.346153846153846,346.96153846153845,53,27,26
A1U90MYVSLLFI1,Daniel Murtaugh,20110316,21,4.285714285714286,47.38095238095238,5,2,3
A1U9V4LBJ468NU,Hank Charleston,20070218,29,4.068965517241379,85.6896551724138,30,11,19
A1U9Y4XH0D8LQ7,PG,20091023,28,4.607142857142857,241.78571428571428,91,33,58
A1UARBNSRK1N2B,"Southern Cookie ""SC""",20090207,31,4.451612903225806,129.80645161290323,73,8,65
A1UAVLKVPTOCS7,John 'The book reviewer' Shane,20080710,21,4.571428571428571,93.52380952380952,41,17,24
A1UCAVBNJUZMPR,Dabuck,20050817,45,4.666666666666667,104.15555555555555,141,9,132
A1UCPXUBSESD65,mzglorybe,20090103,21,4.095238095238095,158.1904761904762,56,10,46
A1UE5IY4M7II1Y,Singleviking,20121211,33,4.545454545454546,67.96969696969697,54,6,48
A1UEL5C1N6E5SE,"Robert Salita ""Software Developer""",20030105,79,4.1265822784810124,164.63291139240508,1586,320,1266
A1UEQ4RFJBMGYJ,Dan,20140619,49,4.163265306122449,73.95918367346938,12,15,-3
A1UEZXK5A83ICO,"Benjamin S. Mitchell ""Disney Fanatic""",20100207,26,4.769230769230769,67.92307692307692,161,17,144
A1UFGLJPU5P4PN,D. Reilly,20080523,21,4.0,195.66666666666666,47,11,36
A1UFLVSJ3IRETQ,Eric Aderhold,20080330,41,4.341463414634147,193.8048780487805,30,6,24
A1UG4J8DEG9NVW,ResearchingMom,20070225,21,3.238095238095238,117.95238095238095,100,25,75
A1UHIEEEM83PFT,Hunter,20100925,21,4.571428571428571,65.33333333333333,3,1,2
A1UHTJ2NZ0IYJH,J. Shinn,20061214,24,4.166666666666667,168.70833333333334,58,5,53
A1UI6F76CPCG8Q,Michael LaBossiere,20090620,44,4.090909090909091,215.9090909090909,32,5,27
A1UIMU8Q87ZPCH,"Darren Levine ""He shoots, He Edits, He freque...",20120210,32,4.71875,349.9375,179,15,164
A1UJGZQJG6BP9K,Michael,20130831,24,4.5,141.16666666666666,22,1,21
A1UJNRYYZ2OJ5K,Capricorn One,20080826,23,4.565217391304348,199.30434782608697,17,2,15
A1UL2JH7XOUGM5,Ruined,20070803,48,4.1875,196.02083333333334,375,45,330
A1ULAF163Z7PM7,D. Jacobowitz,20070509,34,4.352941176470588,127.1470588235294,162,18,144
A1UMO57A3IQGT7,rjon,20140704,31,4.67741935483871,10.258064516129032,0,0,0
A1UMSB7LAW0RIR,"mom2twoboys ""Writer, Reader & Mage""",20090517,50,4.26,189.94,80,29,51
A1UNJ46NSB352E,"Moonlight Graham ""Ben""",20010720,50,4.56,153.94,63,37,26
A1UODWQ2K6DFXT,ellafan,20020118,32,5.0,97.75,260,24,236
A1UQBFCERIP7VJ,Margaret Picky,20090618,228,4.535087719298246,262.5570175438597,563,75,488
A1UQRSCLF8GW1T,"Michael D. Bigham ""M. Wassir""",20060505,22,4.0,134.27272727272728,399,36,363
A1UQUDT2Q0YENM,Michael,20060824,48,3.875,280.375,123,30,93
A1URXSRV6WDHVY,Marty Gillis,20070727,122,4.516393442622951,578.9508196721312,3212,220,2992
A1US0XD6JJ08OX,Roc Bowers,20130115,38,3.973684210526316,31.763157894736842,4,9,-5
A1USVFMQYJPCJR,BRKLYN,20050208,27,4.518518518518518,145.11111111111111,72,16,56
A1USYP4AXF5I1D,William E. Ferreira,20081118,39,4.128205128205129,70.33333333333333,50,48,2
A1UTAJZOWWO2PT,Robert Cain,20120226,25,2.88,138.96,22,43,-21
A1UTM65Y3G9HUL,Briggs,20120405,55,4.072727272727272,62.29090909090909,60,63,-3
A1UUEAO0O2XJZP,"olhipe ""olhipe""",20090117,31,3.903225806451613,52.354838709677416,19,11,8
A1UVWTNPX8TR0G,"K. Franklin ""Are we there yet?""",20071016,25,4.04,174.08,117,37,80
A1UWSU5ETQRQKX,"Robert J. Newell ""Bob""",20101211,42,4.333333333333333,450.2857142857143,174,26,148
A1UWZZ12W746CK,nBee1,20100507,29,4.068965517241379,82.48275862068965,24,20,4
A1UYZEBGMW65FY,odoylerules,20110509,24,4.625,49.625,22,15,7
A1UZ75VO01L2YK,"David Ayotte ""Dedicated American""",20100313,26,4.615384615384615,77.53846153846153,16,18,-2
A1UZG5OCBXX5BL,Stephanie,20130321,23,4.173913043478261,96.82608695652173,20,34,-14
A1V0BPMQVY24VX,"Randy Pullman ""master control""",20071118,21,3.761904761904762,97.80952380952381,30,39,-9
A1V3CLEE8KHTE2,Faith,20120817,40,4.675,87.425,55,6,49
A1V3LIFQNWB1FQ,SomeNYCGuy,20101004,42,4.333333333333333,212.0952380952381,122,22,100
A1V3PCKVCJ3TTZ,Henry Wolford,20080215,39,4.538461538461538,119.84615384615384,47,8,39
A1V3TRGWOMA8LC,"James Beswick ""Thanks for your time""",20080216,92,4.282608695652174,163.0326086956522,642,53,589
A1V4A5U5O3TMMD,AK,20101208,75,3.986666666666667,50.733333333333334,93,58,35
A1V4VVBQBFXRHC,Big-D,20010219,113,4.548672566371682,144.56637168141592,347,112,235
A1V5QP5KNFAM6X,C. Phonasa,20130104,23,4.478260869565218,33.95652173913044,3,0,3
A1V5TRJXTI6F01,Scott,20120115,45,4.777777777777778,48.577777777777776,38,4,34
A1V5UCC82BEETQ,cldsk,20121103,31,4.387096774193548,49.83870967741935,5,3,2
A1V60TVVH8A2PD,David H.,20090330,23,4.739130434782608,59.34782608695652,26,14,12
A1V68CETC0BXV7,"J. A. Eastman ""boomer""",20070816,22,4.636363636363637,149.54545454545453,15,17,-2
A1V7LKIXVMZTHJ,"Cornelius B. Henning ""Neels Henning""",20111231,21,4.380952380952381,247.9047619047619,153,13,140
A1V7QD51WZSNDP,Retired BSEE,20070610,21,3.761904761904762,108.38095238095238,14,3,11
A1V7SXUI8TBAHC,Shadow Moses,20121213,24,2.875,79.16666666666667,11,10,1
A1V8VLCK6C24,Johnwv,20100915,24,4.791666666666667,67.70833333333333,39,6,33
A1V9JPD85POOYC,Yakima_Dewd,20060709,22,4.954545454545454,148.04545454545453,33,2,31
A1VA1QF8KZNBLL,Jeff Lawrence,20100924,22,4.318181818181818,151.5909090909091,50,7,43
A1VBDMNT6I8RE5,"Katharena M. Eiermann ""Existential Diva -- Pr...",20090707,34,5.0,380.20588235294116,203,26,177
A1VEELTKS8NLZB,Amazon Customer,20090216,54,3.740740740740741,92.31481481481481,98,42,56
A1VF5LN6SHFVFJ,"Darth Mortis ""Dark Lord of the Sith""",20100408,25,4.8,138.52,22,7,15
A1VFTZ45CXKG4A,Glenn,20101108,25,4.08,70.2,8,1,7
A1VFX417XDNWIU,Canis Majoris,20070503,83,4.144578313253012,581.0963855421687,2239,129,2110
A1VG74IX3LTZH8,Linda G.,20120304,27,4.666666666666667,79.22222222222223,9,0,9
A1VGXHHR08G044,FlyingPolarBear,20051225,83,4.180722891566265,158.7710843373494,937,81,856
A1VHCO8RQFIGQJ,Indie Film Lover,20100915,94,4.4361702127659575,28.77659574468085,16,26,-10
A1VHDGG2CXBQ6T,"Luke Jarrett ""&#34;J.R&#34;""",20111215,33,4.666666666666667,97.3030303030303,423,47,376
A1VI4DV0HKKUS6,TechnoAmazonian,20111104,21,4.714285714285714,221.52380952380952,31,5,26
A1VIE8N8HW69GS,E IN MARYLAND,20111008,22,4.818181818181818,98.63636363636364,14,2,12
A1VIZFPC5FDDI5,Curtis K. Davis,20131209,26,5.0,41.61538461538461,2,6,-4
A1VJ0V58N0698J,"Angel_Pen ""angel_rising""",20040915,42,2.380952380952381,311.8095238095238,1457,599,858
A1VK4AWR4NPTFZ,phalgal,20101202,29,4.0,35.3448275862069,18,7,11
A1VK5P940H3AON,Douglas Stnschndr,20100515,22,4.954545454545454,112.45454545454545,49,9,40
A1VKAY0XWLA2CY,W. C. Bryant,20080211,36,4.527777777777778,546.5555555555555,934,94,840
A1VKBDONSZHDKK,"Reviewer ""FRE""",20090324,22,3.9545454545454546,53.81818181818182,73,49,24
A1VKO1VVYLY50K,"David Hocutt ""Tech GERD""",20130413,40,4.65,98.6,59,11,48
A1VLDT6C2KO9G5,"S. Powell ""bullmoon""",20110526,26,4.384615384615385,131.65384615384616,55,9,46
A1VLE2SH9J8WYS,"Allison &amp; Bill Dunn ""Alli""",20100303,45,4.488888888888889,152.2888888888889,77,7,70
A1VLVWTLV3LVHR,"Tim E Robertson ""Publisher MyMac""",20030403,55,4.2,681.3636363636364,1323,124,1199
A1VMCB9SBGZSL4,Jason,20120907,27,4.185185185185185,60.48148148148148,9,10,-1
A1VMPC92L1AQBU,A. Gift To You,20080420,25,4.36,123.8,40,7,33
A1VNUU48CSSRSY,"Rodger B. Terrey ""jeeping rodg""",20100606,38,3.6578947368421053,41.76315789473684,13,25,-12
A1VO7HA1MQY8SU,,20120616,22,4.136363636363637,108.54545454545455,9,16,-7
A1VOFY3QFT9WCG,AZ,20130122,41,4.853658536585366,89.36585365853658,16,5,11
A1VP1KVX7Y4PHQ,"James T. Barringer ""Just the facts, Ma'm""",20120201,24,3.9583333333333335,174.375,31,13,18
A1VPJT3BHZ9UAS,T. Caradonna,20120809,34,4.5,487.97058823529414,593,63,530
A1VQBEW0G4IH1J,J-J-J-Jinx!,20071020,64,3.671875,299.15625,131,30,101
A1VQHH85U7PX0,"MyBeesWax ""A Music Fan""",20071127,189,4.518518518518518,362.5820105820106,1454,104,1350
A1VR1HIOVQWN09,Mike,20101228,47,4.723404255319149,141.38297872340425,122,35,87
A1VR62D823PC8G,Carlos Cortes Gomez,20061109,21,4.333333333333333,98.38095238095238,46,5,41
A1VR9II0HC7ZQ6,Della Street,20110730,24,3.9583333333333335,51.833333333333336,8,17,-9
A1VRANSQ0WF1YS,"Robin M ""robin_M""",20021214,50,4.08,176.46,127,67,60
A1VRKW3QXN8UOF,ZacAttack,20100702,24,4.166666666666667,69.0,35,33,2
A1VS1LL905P5L5,hyytekk,20020215,47,4.23404255319149,291.70212765957444,387,77,310
A1VSNI84MLDRS0,JAC,20070222,30,4.633333333333334,141.03333333333333,150,16,134
A1VTBADV3JS1EC,Randi Morse,20080728,32,4.375,194.65625,86,17,69
A1VTCSCH8FFC76,Parker Hallam,20100104,109,4.073394495412844,104.21100917431193,161,108,53
A1VU192UIPG8O6,Mister  Happy,20111209,21,4.428571428571429,38.80952380952381,9,1,8
A1VUA80DLZGWIP,LT Sharpe,20050727,33,4.03030303030303,33.696969696969695,32,5,27
A1VUHTQ6GC4LH,Diana Carroll,20080721,23,3.4347826086956523,192.43478260869566,182,8,174
A1VUN4JU731CBH,I.Peters,20050327,65,3.6769230769230767,366.66153846153844,1460,97,1363
A1VUUO6EEBON7Y,"kev6677 ""TECHNO JUNKIE""",20060729,33,3.696969696969697,73.45454545454545,99,167,-68
A1VVRA3P6G1TWH,Luving it,20060414,70,4.1,300.5285714285714,693,100,593
A1VX8I4BVGKGB9,"intellectually_stupid ""iisgenius""",20070501,25,3.44,173.44,100,23,77
A1VXIY1511XQK2,J. Evans,20071002,40,4.15,181.35,68,20,48
A1VY7YDHTNLU0S,Baku,20100906,27,4.666666666666667,111.88888888888889,33,5,28
A1VYFEJM12ZP11,Jana Taylor,20060728,49,4.36734693877551,173.6326530612245,246,61,185
A1VYWOLFR6Q8EK,"S. Lee ""waterwoman39""",20070111,21,4.904761904761905,71.52380952380952,4,1,3
A1W0XQLEYWGQC5,B. Dawson,20060917,24,3.75,271.7916666666667,41,13,28
A1W2A0EHBM8112,Jack Heart,20110412,34,4.264705882352941,53.3235294117647,15,2,13
A1W35U95LIJ5LY,"R32_GTR_N1 ""-Raines""",20121126,29,4.862068965517241,54.96551724137931,10,0,10
A1W3CEEQBJ4GTN,S. Marchuk,20090907,27,4.666666666666667,50.851851851851855,5,1,4
A1W3KNBSWF19BE,marpater,20121102,39,4.948717948717949,58.30769230769231,26,4,22
A1W415JP5WEAJK,Alex S,20081107,108,4.37037037037037,283.9537037037037,827,46,781
A1W41I7MW62L9R,"Tom Funkte ""Tom A.Funke""",20100424,26,4.230769230769231,91.53846153846153,5,4,1
A1W476YCP7DZ2S,BillH,20070618,41,4.439024390243903,83.58536585365853,45,13,32
A1W4F91DH3XPB2,"M. Kelly ""Life is a Cabernet""",20080417,49,4.122448979591836,167.9591836734694,81,41,40
A1W4IPRLCVXR9U,LSA,20130214,24,3.5,98.08333333333333,21,25,-4
A1W5N8OT55A9Y3,"B. Christensen ""Frequent traveler, business o...",20041108,37,3.72972972972973,421.7837837837838,419,23,396
A1W5SO5D1C13RC,Mark Kitaoka,20060405,32,4.4375,362.90625,864,45,819
A1W66KMKC7Y81A,Leah,20130113,26,4.423076923076923,73.23076923076923,4,2,2
A1W78VPTNJJOF0,L. Wilson,20110428,24,4.5,170.29166666666666,35,10,25
A1W7R5ZAGVOSVQ,"J. Lee ""imajeel""",20090131,27,3.888888888888889,284.85185185185185,146,13,133
A1W83LEYOCCLZB,Szoo2,20130627,23,3.9130434782608696,145.2608695652174,29,2,27
A1W84YXJ54KG02,"J. Cullen ""researcher""",20091102,21,3.238095238095238,240.1904761904762,580,64,516
A1W8DGTJKDR545,"deezTx ""deeztx""",20100210,30,4.166666666666667,68.43333333333334,30,6,24
A1W8TURMFK3S33,Nicholas,20130108,36,4.305555555555555,61.75,70,13,57
A1W9QAREHO70U4,realexpressions photography,20120322,38,4.2368421052631575,46.60526315789474,47,8,39
A1WBIIZ5KF7D6H,Impetigo,20050303,32,3.8125,384.46875,558,73,485
A1WBM6NQU7TK36,Anthony Slatton,20110824,22,4.818181818181818,23.318181818181817,1,1,0
A1WBZA4OM02MXU,Brenda H,20060528,25,4.12,124.68,134,22,112
A1WCMXQK8SYE30,Craig Olson,20120527,26,3.6538461538461537,204.1153846153846,67,9,58
A1WCRIQUX3L1AR,B. Hayes,20061010,27,3.2962962962962963,240.40740740740742,407,124,283
A1WDCTSVCDKNIG,DIY Guy,20110909,22,4.090909090909091,61.63636363636363,25,7,18
A1WDKTBMZCUAM5,NGTO1,20110207,29,4.724137931034483,200.20689655172413,31,8,23
A1WDM0EFA58H69,Jerry Glonek,20100809,41,4.7073170731707314,92.29268292682927,29,5,24
A1WF4QNIE2Z3I7,N's Gadget Reviews,20140128,75,4.493333333333333,197.12,58,4,54
A1WFOFC1A72ZTZ,Michael Anderson,20070713,21,4.095238095238095,94.47619047619048,37,8,29
A1WG5SD91EWYXZ,J. Labore,20111230,22,4.2272727272727275,95.77272727272727,12,3,9
A1WG97A0EFHYXN,mark boucher,20131113,59,4.711864406779661,35.186440677966104,3,24,-21
A1WGGXBAR1GAUN,T-Square,20120622,25,3.48,229.04,59,19,40
A1WHLP7B7GGF7,"Guru H ""GH""",20081222,22,3.4545454545454546,105.36363636363636,62,24,38
A1WJ3P43SZUNDM,Techie,20110918,51,4.588235294117647,175.62745098039215,97,24,73
A1WKQ94M45D8MG,"Denise Crawford ""DC""",20090110,49,4.0,283.46938775510205,278,54,224
A1WKUY7T0EM0GM,"Krystal James ""genie""",20050411,32,4.21875,217.3125,365,24,341
A1WL8B38TM6KAR,B. Smith,20120727,27,4.111111111111111,28.37037037037037,6,8,-2
A1WLAQOT4R9RFK,Bunneh,20111222,22,4.2727272727272725,55.45454545454545,48,6,42
A1WM6XOZFJQ3PL,Daniel Ramirez,20110217,33,4.363636363636363,201.8181818181818,25,4,21
A1WMHFPD9YLVFV,Abester,20000805,27,4.333333333333333,263.22222222222223,237,22,215
A1WO88HMU10K3A,vixen2188,20110303,26,4.076923076923077,127.3076923076923,20,9,11
A1WOCDLPG4LGWZ,"JLo C. ""JLo""",20110928,33,3.878787878787879,79.51515151515152,26,23,3
A1WP4V9GZ8NRFT,aaanouel,20100724,21,3.857142857142857,91.95238095238095,39,12,27
A1WP7TOCJC3SWV,Steve,20070916,23,4.521739130434782,244.65217391304347,297,60,237
A1WPXG000113YQ,"M. Turner ""Mark T""",20071111,24,3.7916666666666665,173.70833333333334,46,15,31
A1WQIHZ2KXCQ68,Mario Alejandro,20130609,30,4.766666666666667,57.43333333333333,8,1,7
A1WR0KA61A2CTW,"W. Crawford ""HP DC7800, E8400 3.0Ghz, 4G RAM,...",20080722,39,3.641025641025641,217.69230769230768,417,52,365
A1WRXACOKPITBQ,"Leiah ""So, I Read This Book Today . . .""",20110109,21,4.523809523809524,101.28571428571429,8,3,5
A1WS4JLMA5GIEN,Marty,20110428,42,4.023809523809524,123.33333333333333,77,15,62
A1WSWGB24SHX9L,"Tony Harrison ""Be kind to one another, tender...",20101221,25,3.88,147.32,67,6,61
A1WTI1H1W1IX34,Hit by a bear,20070608,23,3.130434782608696,53.391304347826086,7,4,3
A1WU99RI2DTTJZ,"Steven M. Mcmahon ""deal hunter""",20050926,29,4.655172413793103,207.44827586206895,93,5,88
A1WUQF5HWBAQJU,JJG,20110319,56,4.392857142857143,767.125,3760,119,3641
A1WV711AD22U1E,"Pogo ""McIntosh""",20080429,22,4.409090909090909,140.6818181818182,23,18,5
A1WX6BYSC8VRA0,Hawaiiboy58,20101028,24,5.0,45.416666666666664,3,1,2
A1WXG10FJ353K0,MickeyJoe,20080205,85,4.458823529411765,302.1764705882353,213,40,173
A1WXJ1I42UOQ2V,AuburnTygr,20080809,31,4.0,189.5483870967742,79,28,51
A1WYSC85NLNM4Z,Ok2bclever,20060830,29,4.655172413793103,180.82758620689654,94,5,89
A1X0QMZ0M21J9U,Ivan Lavrusik,20100531,23,3.608695652173913,60.26086956521739,32,30,2
A1X141RMLQCIS7,"Brad M. Cassagne ""Computer Buff""",20041008,24,4.208333333333333,156.20833333333334,160,51,109
A1X14KJ08SENDJ,KO,20120413,21,3.5714285714285716,503.85714285714283,82,19,63
A1X1CEGHTHMBL1,jjceo,20090513,160,4.68125,323.95,893,79,814
A1X1CLFHGKEOUI,Zman,20130110,24,4.375,45.0,5,4,1
A1X1L0MLXK8HEZ,"Jerome Moye ""Big Rome""",20130223,23,3.9565217391304346,72.26086956521739,9,6,3
A1X260R0G6OHWU,Kenneth F. Krutsch,20100203,24,4.375,396.375,758,47,711
A1X2LENOF84LCQ,"D ""D""",20050413,80,3.6875,160.975,215,168,47
A1X3DA7C61WZLQ,Kris,20030206,51,3.549019607843137,236.52941176470588,2326,228,2098
A1X3ESYZ79H59E,chaos,20110127,76,4.2368421052631575,134.0921052631579,97,24,73
A1X4VWM6177NO0,fuzzy,20130301,30,4.7,57.53333333333333,18,5,13
A1X69RZ08LRNGL,steve_oakland,20041011,32,3.625,180.03125,115,25,90
A1X8BQQGCEHQ1V,"Kim Cantrell ""Soap Box Bandit""",20071226,28,4.321428571428571,176.60714285714286,176,32,144
A1X9NDNOVCABX3,"Chris D. ""Chris D., Photographer""",20120401,29,4.482758620689655,58.758620689655174,33,5,28
A1XAPRM0OO15SO,"LISA LOU ""LISA MARIE""",20130225,21,4.904761904761905,84.9047619047619,10,1,9
A1XAR9ESZ5Q6CV,"Amazon Customer ""LarsBerg""",20100105,26,4.230769230769231,101.23076923076923,29,18,11
A1XAXEL581ZQY3,Oldguy,20120808,32,4.375,192.84375,16,13,3
A1XB7JGJ459ERP,"Scott Chou ""Scott""",20020606,44,4.5227272727272725,127.6590909090909,142,21,121
A1XCCTKNN1RZMZ,"H. W. Fitzgerald, Jr.",20080120,33,4.03030303030303,41.57575757575758,55,7,48
A1XCO4HL2JYNWU,"GT ACE ""Say something about yourself!""",20090106,22,4.2272727272727275,75.54545454545455,7,4,3
A1XCWGU6FUK5QK,"J. Goldstein ""JG""",20110426,22,4.090909090909091,128.04545454545453,37,10,27
A1XD7G5102NMWT,buffy,20120710,22,5.0,37.27272727272727,9,0,9
A1XDMYX8QOW07N,Geoffrey Kleinman,20081231,24,3.7916666666666665,174.04166666666666,36,10,26
A1XE12PGTI9TBY,Seth Wandersman,20010818,22,2.6363636363636362,76.86363636363636,55,27,28
A1XE3M22N91451,Huckleberry,20101214,71,4.408450704225352,208.9718309859155,83,6,77
A1XE3S44YJ5NOL,Josh H-G,20090106,22,4.681818181818182,186.86363636363637,18,2,16
A1XEQGYY1IL8CD,CamiloXR,20111011,28,4.642857142857143,82.53571428571429,7,5,2
A1XFI340SHOS5K,Zenpony,20090111,28,4.0,173.75,14,11,3
A1XFKWAR5STF0,"John Woods ""TObject""",20050317,26,4.5,136.80769230769232,277,19,258
A1XFMXCDPBVJ5P,Ahikanana,20100223,31,4.548387096774194,145.61290322580646,40,8,32
A1XG38WOY3LY4V,Gadgets & Gizmos,20100121,41,4.146341463414634,101.0,51,9,42
A1XJL5W5L6CGPR,Dave,20110501,22,4.318181818181818,132.13636363636363,62,11,51
A1XJOSJN6FHFO0,"Shirley Priscilla  Johnson ""Author/Reviewer -...",20060521,46,4.8478260869565215,187.7826086956522,63,19,44
A1XK4VP74IB9TQ,Fastphoto,20090824,44,3.909090909090909,70.86363636363636,28,16,12
A1XL4YLORJ5IBS,Ana Pendragon,20100928,21,4.714285714285714,25.38095238095238,13,4,9
A1XLOLCKFF4EJG,Dennis Lockhart,20070629,25,4.12,53.52,46,4,42
A1XNCV67JBJVF7,Sam Beckett,20120101,36,4.138888888888889,129.11111111111111,14,2,12
A1XOM5G07FP93H,Richard,20081018,29,4.793103448275862,69.51724137931035,25,7,18
A1XP4LKVAV5GA7,Taonian Chen,20070512,21,4.619047619047619,111.33333333333333,32,5,27
A1XP5GMAIXJ10A,James Sibley,20091209,38,3.5526315789473686,100.36842105263158,50,17,33
A1XPT6TAPFPPEM,Mike60,20100102,25,3.16,76.68,27,28,-1
A1XSIEX9FQ9R3N,Daniel Jenkins,20110305,24,4.75,55.791666666666664,7,4,3
A1XSZF2A3ZV2MW,"Claudine Govier ""Lady Iris""",20080901,27,4.444444444444445,90.48148148148148,85,4,81
A1XTIPZ2GA9C98,"GWH ""Power Reader""",20130325,24,4.458333333333333,155.16666666666666,6,2,4
A1XTQSB4S24P0D,"Bob Terwillager ""Especial""",20090425,22,3.8636363636363638,95.5,26,16,10
A1XTSL9WZW301S,DyingJedi,20100727,36,4.388888888888889,154.55555555555554,17,39,-22
A1XVH630645EYU,"ChowS ""EH""",20130226,28,4.535714285714286,96.17857142857143,7,0,7
A1XVY7QFMOFD3V,Lie2me,20120613,27,2.962962962962963,221.03703703703704,31,72,-41
A1XX9RG82WGSY6,Adam Palmer,20120314,29,4.0344827586206895,31.862068965517242,9,5,4
A1XXMNLOLKNO0I,"Stanley J. Wynman ""Wynman""",20040217,83,4.9156626506024095,45.734939759036145,164,27,137
A1XYOVJW5J06X5,Pragmatic,20120602,34,4.264705882352941,147.38235294117646,210,24,186
A1XYXBMAT39J3C,Roland Barton,20091105,21,4.428571428571429,33.19047619047619,1,0,1
A1Y051MQ2SVPFI,Simon,20120112,50,4.2,278.92,650,76,574
A1Y1KEF16WBDH1,Ron,20120522,31,4.903225806451613,30.258064516129032,3,4,-1
A1Y1XIOKSTM28H,David Stewart,20110923,25,4.56,353.92,105,5,100
A1Y200FSB7XBP3,"Ian ""Ian""",20071010,24,4.166666666666667,111.66666666666667,56,3,53
A1Y2BG1GPW1VT6,Sir Force,20061106,25,4.68,99.92,20,4,16
A1Y32JMVKBL7ZS,"R. Avital ""R_Avital""",20051108,22,4.318181818181818,348.22727272727275,56,4,52
A1Y3CL24269GAV,Hazel,20130403,23,4.434782608695652,125.04347826086956,14,4,10
A1Y3PKMAQEVHK7,"Bruce H ""Bruce""",20070216,26,4.384615384615385,52.19230769230769,25,4,21
A1Y3XWYXN6HB7H,firas issa,20120304,24,3.7916666666666665,54.791666666666664,3,2,1
A1Y4EWMUTW73GD,Photo/Video Gearhead,20060316,45,4.4222222222222225,184.15555555555557,378,53,325
A1Y4V99GVH0B1W,"Robert Lyons ""RGL""",20080618,40,4.5,197.575,110,12,98
A1Y4Y0MMSFNJWT,Fish,20110402,27,4.0,93.25925925925925,22,11,11
A1Y5ERIKQBEMSP,"J. Schneider ""john_jps""",20100528,31,4.354838709677419,209.2258064516129,52,22,30
A1Y5IF71BX7URN,Jack Falk,20060312,30,3.7333333333333334,83.9,69,34,35
A1Y5RRW8I4YX5Y,"T-Bone ""Tony407""",20091002,23,3.782608695652174,183.7391304347826,48,11,37
A1Y6QK1II793JE,"Jamie R. Broughton ""JRB""",20130518,21,4.190476190476191,93.19047619047619,5,4,1
A1Y7SE29SF1QE,JGM,20120904,25,4.48,48.4,11,4,7
A1Y85GQ09Y95JL,"Mitch10 ""mitch10""",20020318,55,3.4545454545454546,168.1090909090909,590,127,463
A1YACRFEFAN48Y,Star BeGlitched,20100822,23,4.826086956521739,414.2608695652174,101,15,86
A1YAGM2QOSAAOT,Personal Robot,20070108,44,3.5,412.0,163,43,120
A1YAOKCZCYROWI,Gabriel,20110305,22,4.545454545454546,40.27272727272727,3,2,1
A1YCDZ4K4G0CN3,David Carlin,19990910,24,4.083333333333333,154.04166666666666,327,22,305
A1YDWLO2FPOUEC,D3TH5150,20130719,23,4.695652173913044,104.3913043478261,5,2,3
A1YE1IK0JYSIIE,Chain Saw Bob,20120705,40,4.4,32.475,1,9,-8
A1YEPFLLH42OU1,"Yu-jin &amp; Tracy Chia ""Yu-Jin Chia""",20060323,141,4.425531914893617,433.60283687943263,858,90,768
A1YFIN5WFNY1FU,Edom,20090409,22,3.5454545454545454,151.22727272727272,49,27,22
A1YGF9FFKQEB9N,L00king4nswers,20100603,23,4.434782608695652,106.8695652173913,5,0,5
A1YGX7IGS5AKPH,Doglet,20121214,34,4.529411764705882,69.44117647058823,25,10,15
A1YH6DMZOS59A2,TooManyHobbies,20060324,34,4.235294117647059,338.1470588235294,75,2,73
A1YHCYUM4P3XMD,mattm9y,20091106,21,4.285714285714286,96.66666666666667,17,3,14
A1YJMG0QJXZLD4,Woody,20090413,24,4.041666666666667,233.20833333333334,67,32,35
A1YK56DPXS5DFX,Carlos Santiago,20020505,23,4.565217391304348,404.6521739130435,384,11,373
A1YKL35EFRDS7K,John,20090916,23,3.869565217391304,119.3913043478261,64,26,38
A1YKTGDWITQPM2,Frank J. Perricone,20010723,27,3.962962962962963,133.92592592592592,428,55,373
A1YL67KU2QDEYR,Luis Gonzalez,20060922,22,4.045454545454546,39.36363636363637,17,31,-14
A1YLJGGB0EDFV2,S. Meyer,20050529,21,3.857142857142857,79.80952380952381,32,17,15
A1YLVLMKZGTGS5,Dave,20130124,21,4.333333333333333,39.80952380952381,0,3,-3
A1YLYR8JB6JVXQ,"faffie ""woodworkingchick""",20080801,22,3.3181818181818183,201.77272727272728,94,19,75
A1YM3BZ2FO1JYI,S. Schmidtke,20120310,21,4.0476190476190474,71.14285714285714,26,9,17
A1YMB134U0SU0A,"M. Whitmore ""lovetoreadforfun""",20110512,24,3.9166666666666665,141.04166666666666,11,25,-14
A1YMNXDESPUFOY,R. Harmer,20071122,24,4.625,106.54166666666667,61,7,54
A1YMY4JXEYFZZO,"Tim Payne ""tpayne""",20070221,22,4.090909090909091,54.18181818181818,14,11,3
A1YN5I4FINMBTI,Electronics man,20130321,56,4.642857142857143,30.160714285714285,14,9,5
A1YO6ZZY1AGJAG,Paul V. Matei,20071203,31,5.0,31.548387096774192,14,3,11
A1YOF7CINOIHR9,,20090629,23,4.086956521739131,48.91304347826087,35,23,12
A1YOGD8K6EV6VI,D.L.C,20020709,28,4.071428571428571,533.7142857142857,1803,97,1706
A1YOMI6M5M4W20,Chris Schmidt,20090810,27,3.1481481481481484,138.88888888888889,303,64,239
A1YP5WLIHGG136,"Techthusiast ""n00b""",20081003,33,4.7272727272727275,158.78787878787878,230,47,183
A1YP9BO80732WX,MINDSCI,20111130,22,4.409090909090909,309.04545454545456,174,20,154
A1YPM3SXTNT1FY,D. Melendez,20090813,22,4.181818181818182,172.72727272727272,88,4,84
A1YPOOY9CTUP70,physics lover,20081025,22,4.363636363636363,280.0,42,9,33
A1YQK9S2QR3X4H,Justin Z,20120820,21,4.571428571428571,71.0,6,3,3
A1YRC0168WONWL,"mgauss ""mgauss""",20080201,26,3.0384615384615383,84.15384615384616,262,335,-73
A1YTZQOF90CZRG,"Chris Smith ""cx2smith""",20120104,34,4.382352941176471,47.470588235294116,4,1,3
A1YU56S5VFTZ,L. Rothman,20100403,21,4.809523809523809,156.0952380952381,302,23,279
A1YUB4V9OHM4YI,Larry L. Hoffman,20041214,21,4.428571428571429,200.0,178,42,136
A1YUO1PPU8366,walleyeslayer,20090216,28,4.071428571428571,130.82142857142858,47,10,37
A1YUWK0O71JG0W,Muttley,20140413,25,4.56,453.48,12,0,12
A1YUZ3PFNAILHW,Traderkos,20061121,29,4.379310344827586,170.41379310344828,34,8,26
A1YVO5V1SO18DZ,"The Bee Bee ""BB""",20030120,80,4.4125,194.2375,268,83,185
A1YVZIA9TGLVMS,"j. salk ""linus""",20050911,22,4.181818181818182,127.31818181818181,115,18,97
A1YW2N9Q2KDLOH,Loy,20110310,27,4.851851851851852,44.22222222222222,4,2,2
A1YW7H051M0ME3,LanFear,20101230,25,5.0,99.92,7,1,6
A1YWMPU4NRLSW1,Michael Cline,20060726,21,4.809523809523809,76.14285714285714,15,2,13
A1YX49D4OL0387,"S. Morris ""Samdiver74""",20090125,23,3.782608695652174,173.8695652173913,48,14,34
A1YX6YUHJA11KE,"RDE1959 ""1911""",20110217,39,4.512820512820513,85.71794871794872,9,0,9
A1YXBYJCCS0R3A,Robert M. Rael,20080317,23,4.869565217391305,131.56521739130434,21,4,17
A1Z0E57WL12N9Q,"Chuck Pelto ""Chuck Pelto""",20090811,27,2.3703703703703702,107.74074074074075,78,42,36
A1Z16630QMH8Q6,"Bill Raley ""Vista Bill""",20061130,88,4.784090909090909,168.5909090909091,186,70,116
A1Z215B0OZ3BLL,"Fotoman ""Fotoman""",20120615,42,4.428571428571429,239.02380952380952,111,41,70
A1Z2D89VPJPD4I,Russell J. Pendred,20080308,22,4.818181818181818,33.95454545454545,7,3,4
A1Z3598J0371ND,Jeffrey,20110930,41,4.7073170731707314,58.19512195121951,19,5,14
A1Z3SFPOSZUVN0,PhotoFXusa,20120330,26,4.653846153846154,64.61538461538461,20,14,6
A1Z4930RTKRTKV,Bruno Freitas,20050919,22,4.636363636363637,302.27272727272725,501,59,442
A1Z4ETGZZHVT6W,"bmoag ""ae""",20090109,21,3.5238095238095237,214.47619047619048,73,27,46
A1Z4GII5CHCDG7,K and B,20080624,57,4.0701754385964914,190.01754385964912,757,99,658
A1Z4YY7V0KXPED,Hardright,20110802,33,4.606060606060606,55.878787878787875,33,12,21
A1Z7FZP81N8CDU,Amazon Shopper,20120120,28,4.071428571428571,139.5,20,4,16
A1Z7S2HB7ZF7PM,Jeff,20130120,23,4.739130434782608,33.82608695652174,0,1,-1
A1Z7SC7HH1BJKA,"Gyz ""Ig""",20090111,49,4.979591836734694,107.0204081632653,66,8,58
A1Z7U9K6X3FEOU,Brad Conner,20140507,57,4.245614035087719,51.35087719298246,3,1,2
A1Z8I0CPAH20FM,James L,20100325,28,4.428571428571429,226.03571428571428,8,2,6
A1ZA5SXZS8Z3CK,bamf70,20121130,47,4.51063829787234,51.297872340425535,18,12,6
A1ZBEIL78MLR9Z,"Doffod ""Bookworm""",20050923,57,4.2105263157894735,130.75438596491227,167,39,128
A1ZBGFVVMDPOPD,Mr. Fantastic,20081120,22,4.318181818181818,123.63636363636364,28,18,10
A1ZCC4FCBOUIFW,W. Sung,20071118,39,3.948717948717949,125.23076923076923,48,15,33
A1ZCSSCAGBCD49,"Joseph Spiegel ""Joe""",20040323,112,3.8392857142857144,320.33035714285717,245,114,131
A1ZE1LPZHGG1QP,Gym Cop,20061114,34,4.5,150.7941176470588,78,80,-2
A1ZG9WMHNMGY62,"ffass ""ffass""",20010724,26,3.3846153846153846,169.8846153846154,478,47,431
A1ZGHA3IJV01BK,"K-cee Kit ""CAH-M""",20060927,30,4.233333333333333,92.7,16,15,1
A1ZGNCN1VRUO1H,JC,20100923,28,4.75,221.96428571428572,217,5,212
A1ZH5ULI4SBO48,"S. G. ""s.g.""",20110426,24,4.166666666666667,213.375,65,19,46
A1ZHQBJ9GKLQUV,sly5789,20081220,29,3.896551724137931,107.65517241379311,111,42,69
A1ZJ8BWVM5L5GW,P. Tam,20060613,26,3.9615384615384617,48.88461538461539,30,21,9
A1ZKG86UBD8K8,"Arok5 ""AQ""",20100102,21,4.571428571428571,336.5238095238095,32,4,28
A1ZLD0S18W9OK8,jds,20110901,21,4.380952380952381,45.476190476190474,6,21,-15
A1ZM846Y7AUYD,M. Pickering,20070512,66,4.106060606060606,692.5909090909091,3115,140,2975
A1ZM9THVB0JUPS,T. Khetia,20110613,40,4.55,86.75,7,3,4
A1ZN48BMZLMZO1,Jon R,20080827,23,3.8260869565217392,258.1304347826087,119,16,103
A1ZN5JCQSWEGP9,DAVID A CAVALLARO,20110409,37,4.4324324324324325,74.8108108108108,37,37,0
A1ZNIC5MQB19AT,"V. Santos ""Jayspot""",20080922,21,3.857142857142857,86.23809523809524,30,7,23
A1ZPKKWT79C6HW,"APC Reviews ""APC Reviews""",20080728,41,4.487804878048781,408.9512195121951,580,74,506
A1ZPRJWAVMCBVC,indore,20120613,29,4.620689655172414,78.17241379310344,12,5,7
A1ZPUEHF4AES86,Josh B,20121029,47,3.9574468085106385,107.87234042553192,16,3,13
A1ZPY91VE3IDN1,JO,20080311,69,4.449275362318841,291.1304347826087,250,44,206
A1ZQR3EQ7K3LKJ,pc builder,20091205,22,3.409090909090909,39.22727272727273,10,80,-70
A1ZRXGT8QJXGET,"Bob Denton ""BDAZ""",20101201,22,4.2727272727272725,37.27272727272727,10,5,5
A1ZTR0FR5AW9B4,Consumer,20120208,55,3.8363636363636364,49.6,43,10,33
A1ZTS0O3YLLTN1,"ifitaintbrokeitwillbe ""you rush a miracle man...",20110805,29,3.7586206896551726,43.41379310344828,10,40,-30
A1ZU1G3AH5QIQF,VictoryRider,20130202,22,3.8181818181818183,32.18181818181818,7,10,-3
A1ZU55TM45Y2R8,J. Haggard,20060825,156,3.9294871794871793,358.87179487179486,5078,454,4624
A1ZUCLF5ROB3KI,"Ellis Guy ""Perry Ellis Fan""",20100809,34,4.676470588235294,153.23529411764707,21,8,13
A1ZV852X2MING9,jferras,20080304,29,4.241379310344827,285.7931034482759,62,15,47
A1ZVFCPHCWFV71,N. Savoiu,20070720,51,4.294117647058823,90.05882352941177,48,30,18
A1ZW0A0I80JNNM,SLH,20091130,29,4.379310344827586,52.275862068965516,6,1,5
A1ZWKX2XRUHGYO,Peter,20130222,39,4.230769230769231,53.743589743589745,5,5,0
A1ZWMRDI2N6EMS,"Gray Beard ""G WIZZZ""",20090911,21,4.666666666666667,43.95238095238095,16,4,12
A1ZWWMDVOI3QW7,Amazon Customer,20101207,28,4.071428571428571,170.28571428571428,52,10,42
A1ZXMMQPYC3Z9I,Lotus-Seven,20080904,39,4.102564102564102,294.7435897435897,544,34,510
A1ZXQH0IUQ1H7R,P. Lau,20120701,32,3.90625,58.6875,37,209,-172
A1ZXVKJTHKGA97,,20090524,24,4.5,34.666666666666664,1,1,0
A1ZY2DK4CXF2CI,Amarillo by morning,20110212,25,3.96,116.12,11,2,9
A1ZZ85SS43PCDJ,Ibleroy37,20120612,23,4.434782608695652,40.17391304347826,5,3,2
A1ZZR25X0CNOJX,"slim ""57psalm""",20070523,41,3.8780487804878048,173.78048780487805,123,48,75
A200DY76VXVGP9,handyandqu,20110702,55,4.945454545454545,68.52727272727273,9,6,3
A200NRJGN6RDKI,"Photocop2011 ""You Better Believe In Something!""",20120208,29,4.931034482758621,78.24137931034483,30,5,25
A200RY2ELZL2Q3,K. Lange,20090812,56,3.767857142857143,68.48214285714286,45,14,31
A2013JDMPUV6D9,"Scott Pointon ""Former Marine, Librarian, Wood...",20040727,28,4.678571428571429,139.39285714285714,381,32,349
A20140IW4006KU,Joe,20111110,27,4.851851851851852,53.77777777777778,4,0,4
A201BDGG33K0JN,"Ron Malinowski, Jr.",20041217,21,3.857142857142857,194.57142857142858,72,9,63
A201XDFAERS30V,Ambercool,20100615,22,4.136363636363637,106.0,32,15,17
A202DC58JWUAOS,"Glenn Fitzgerald ""GLF""",20110902,23,4.304347826086956,29.391304347826086,5,2,3
A202XNZLHBS6OJ,"Opinions are like... ""Al""",20130404,30,4.133333333333334,45.53333333333333,9,3,6
A2032YC2PRGNSR,kellyb,20091203,28,4.607142857142857,113.14285714285714,23,7,16
A20361V1Y2GZ5X,Jason Kim,20120725,30,4.733333333333333,131.1,13,2,11
A203OCQQ12MAVT,"HMMWV ""God, Country, Corps""",20061029,162,4.555555555555555,452.7654320987654,3061,316,2745
A203Q1G7IMYOVY,Bambs,20130124,21,4.190476190476191,44.095238095238095,18,30,-12
A203Q3VIFANQJW,R. Harry,20080611,23,4.3478260869565215,346.5652173913044,83,11,72
A203WLJ31GIUTB,C. Wilson,20130126,22,4.681818181818182,114.04545454545455,1219,27,1192
A20403BR0K7VM8,Ohio Guy,20120801,25,3.52,118.6,19,7,12
A204ETWOV23HO4,"David J. Huber ""Addicted to books!""",20000806,27,4.481481481481482,179.03703703703704,227,32,195
A204K1OFE8OB9Y,Winter,20050825,69,2.782608695652174,190.65217391304347,247,172,75
A204KVEV30UDE2,Corey Scott,20070625,33,4.212121212121212,238.0909090909091,269,20,249
A2053ZJUGCKUA5,LARRY,20120608,26,4.961538461538462,62.53846153846154,330,18,312
A2065HBMYDXJ1S,"Jenn B ""Happy Mom""",20060319,33,4.666666666666667,71.78787878787878,16,38,-22
A2068BC3ZXAVJQ,"scesq ""scesq""",20100414,40,4.575,338.125,49,15,34
A206CGM6J75UJY,Digital Donkey,20100207,61,4.295081967213115,80.70491803278688,83,24,59
A207KPKUFKNK96,Tivo Manic,20071114,21,3.8095238095238093,212.14285714285714,20,6,14
A208MPF7IMJKAU,P. Craig,20081226,23,3.391304347826087,112.56521739130434,156,13,143
A20951I210L0IB,"Brian Woodbury ""TheStonerGuy""",20120817,82,3.792682926829268,164.29268292682926,99,50,49
A209G57KXCBF4C,"Stephen ""radman2020""",20050416,53,3.6792452830188678,167.22641509433961,239,73,166
A20A523DFHLRBT,"MJC ""mjc""",20070330,32,3.9375,268.34375,211,30,181
A20A87A2H58LYO,HRC,20100603,22,3.3636363636363638,137.0,99,26,73
A20AHH3Z8CCB6S,Donovan Meador,20130401,22,4.863636363636363,59.72727272727273,13,6,7
A20BB7TPL5F7G2,zKi Comp,20101129,21,3.857142857142857,243.85714285714286,19,4,15
A20BC3R2NBN646,CMB,20120720,23,4.6521739130434785,208.3913043478261,28,5,23
A20BFJ0BHFO7X3,Todd,20110530,24,3.5,243.125,67,7,60
A20C4RCZJTWC9K,"R. Szymczak ""Rob""",20110328,22,3.8636363636363638,54.22727272727273,11,3,8
A20CNE1D08X2G8,"K. Wade ""In2deep""",20111027,27,3.6666666666666665,96.66666666666667,8,3,5
A20D9VGCF3P13L,RoyBlaze,20061013,36,4.5,110.55555555555556,32,6,26
A20DDH4NT6Q1E8,Koala1356,20050402,124,4.516129032258065,351.3790322580645,762,81,681
A20DMQGJ6O3EFN,B. Grant,20070206,21,4.809523809523809,60.19047619047619,57,3,54
A20DNGGAHQMSWI,"Margaret Thomas ""tygerkittn""",20081022,21,4.380952380952381,236.8095238095238,39,9,30
A20DOV7JIMJMJ2,"Alvaro Munoz ""MUAR""",20100222,27,4.814814814814815,54.370370370370374,12,10,2
A20DZX38KRBIT8,"Deimos "".""",20051115,156,2.75,115.73076923076923,485,1328,-843
A20EEWWSFMZ1PN,"bernie ""xyzzy""",20021031,41,4.658536585365853,201.65853658536585,70,21,49
A20EZ7E8WUH2GZ,"Shastastan ""Stan""",20080220,24,4.291666666666667,142.875,27,12,15
A20F84KUBWM88B,"Amazon Customer ""sports girl""",20100411,26,4.5,93.84615384615384,38,21,17
A20FR4GDESILPA,"TunaMan ""Engineer Nerd""",20080218,23,3.869565217391304,468.5217391304348,137,24,113
A20G074MWH9U7O,DZRhino,20061127,62,4.080645161290323,266.64516129032256,421,64,357
A20G0URDF5AKCN,"Bo Lorentzen ""Photographer""",20060630,26,3.730769230769231,246.5,454,34,420
A20G4LKP4XO6C3,Texasbluesplayer,20100226,25,4.32,128.92,28,4,24
A20H1M28WLI9J2,Brian M. Edwards,20051024,77,4.0519480519480515,191.85714285714286,733,61,672
A20HMQGKR7RET5,thecarace,20120505,30,4.466666666666667,63.766666666666666,8,5,3
A20HMWBXMXWW40,hiscifi,20120505,25,3.88,336.44,187,26,161
A20HUNW23T6YDU,KindleLoverMM,20130328,29,4.862068965517241,44.44827586206897,12,4,8
A20K0GPVMGXN9,"Rick Medugno ""Ricomandog""",20090215,22,3.909090909090909,87.31818181818181,24,4,20
A20KR574KL69VT,AVS,20110321,27,3.4444444444444446,105.03703703703704,32,10,22
A20L2Y5CIA3VF9,"Amazon Customer ""FOTOWAG""",20090210,22,4.2727272727272725,44.09090909090909,8,4,4
A20L63B48RPSOH,Wix,20080616,80,4.0125,158.6875,111,45,66
A20LYGBNUC09W4,Amazon Customer,20110323,33,4.484848484848484,78.96969696969697,18,4,14
A20MBPLK731VHY,Revit,20121113,25,4.4,48.16,14,4,10
A20MM8065EOMWP,Anon220,20110614,27,3.6666666666666665,45.74074074074074,17,4,13
A20MSVZXGMVU4Z,"J. Canfield ""John - old geek""",20090204,23,3.5652173913043477,366.82608695652175,205,33,172
A20N363LNX2CWJ,A.J.,20111130,21,4.285714285714286,350.4761904761905,47,3,44
A20NJ4SRSEF9KL,"L. Robbins ""Bubbles""",20101117,28,4.321428571428571,22.464285714285715,3,0,3
A20NJHXCDTDS0J,fxrsniper,20130206,42,5.0,27.095238095238095,10,4,6
A20NL7QAHXDCU5,Dave Y,20000524,33,5.0,16.060606060606062,26,4,22
A20OAXZSG607PP,"Bill Baehr ""whipperin1""",20090428,23,3.608695652173913,93.91304347826087,28,20,8
A20OBCQWBKCGZT,Flaherty,20080529,113,4.238938053097345,171.6283185840708,215,63,152
A20PAT9NYFJACX,Amazon Customer,20061111,30,4.333333333333333,226.23333333333332,202,26,176
A20QMISU4S0XRC,A Pudgy Pug,20120910,31,4.806451612903226,54.16129032258065,5,1,4
A20RPF0I215N6O,Jonas J. Schreiber,20081107,26,4.1923076923076925,179.53846153846155,58,18,40
A20S4G1EXF2OM7,Electronic Gadgetphile,20050625,29,4.103448275862069,246.10344827586206,570,55,515
A20TBH9J5WN1YO,Brett B.,20130924,23,4.869565217391305,28.608695652173914,11,3,8
A20TZLGORUSGSF,"whatthe... ""dogsandcats""",20060524,21,4.523809523809524,234.85714285714286,150,46,104
A20UC2I114OT4F,Amazon Customer,20100923,33,3.9696969696969697,291.93939393939394,93,12,81
A20UNE9L6WKTSI,Syd,20101022,24,4.291666666666667,174.95833333333334,23,0,23
A20UU20K7M9ZPF,k_tree,20110731,49,3.816326530612245,92.40816326530613,99,19,80
A20UU4506ECYTV,"Rich56 ""Photo Rich""",20100716,30,4.533333333333333,379.56666666666666,44,6,38
A20V7N5A22F4BM,Brian D. Newby,20091201,48,4.020833333333333,230.45833333333334,106,48,58
A20VG5W98SX99L,"Y. Kim ""Zelium""",20071015,77,3.909090909090909,492.23376623376623,1019,61,958
A20W2NNKTMUR4J,"Travis Dockweiler ""tdockweiler""",20030904,32,3.96875,593.375,1299,241,1058
A20W55PTAUBWZK,Ali,20080725,28,4.214285714285714,130.85714285714286,2,1,1
A20WS8TZ5840ND,"Adam Dachis ""adachis""",20050125,37,3.5675675675675675,875.1081081081081,1493,146,1347
A20WUUD9EDWY4N,"Neng Vang ""Neng2012""",20110609,48,4.666666666666667,37.354166666666664,19,24,-5
A20WY1MTGCZD7L,Trevor J. Fayas,20100228,24,4.583333333333333,52.833333333333336,3,2,1
A20XGDRQTHX21O,IIVIIATT,20111204,24,4.75,62.5,8,3,5
A20XOKI1KEUFXO,"Henry T ""Globetrotter""",20020626,25,3.8,183.72,184,65,119
A20Y433PDWVNRZ,Sen,20131030,22,4.454545454545454,42.68181818181818,7,5,2
A20ZM879PCQQEZ,bob fox,20070206,42,4.309523809523809,140.83333333333334,69,51,18
A210BLG2JTAU08,Todd Chiniquy,20121219,31,4.67741935483871,82.61290322580645,7,3,4
A210R1TWSLAT91,"Dan Levy ""Dan Levy""",20090712,31,4.419354838709677,148.8709677419355,34,7,27
A211A51H4XNPUF,Teacher Man,20120112,25,4.2,75.48,27,27,0
A211S17M6MQ13K,d,20110804,22,4.818181818181818,181.1818181818182,13,2,11
A212MDP6K4VJS5,"Bill Stockstill ""&#34;Bill&#34;""",20020612,71,4.47887323943662,289.3521126760563,569,65,504
A213J54E63SYOP,Rl Shuey,20100306,101,3.8613861386138613,88.04950495049505,48,53,-5
A213POYMNUCVC6,"Godslayer333 ""Godslayer333""",20090704,43,3.744186046511628,44.86046511627907,17,11,6
A214PATZBRO7SB,C. M. Evans,20071111,26,4.0,126.07692307692308,101,8,93
A214W34F0Z78MX,Mike Ventura,20071212,21,4.619047619047619,138.47619047619048,384,20,364
A214W7SK2DJQ99,Gabe,20121029,42,4.190476190476191,47.80952380952381,12,11,1
A215IN14OKAE2T,"Thew ""Thew""",20091104,49,3.510204081632653,220.30612244897958,258,28,230
A215WH6RUDUCMP,"Jamie Wilson ""Shilom""",20090507,55,4.527272727272727,122.10909090909091,32,37,-5
A218A1NFBSHZ0U,David B. Minter,20020504,26,3.0384615384615383,242.80769230769232,143,37,106
A218THF45IKWKH,"David D. ""David D.""",20100909,26,4.615384615384615,289.6923076923077,194,22,172
A21911QJJHVGD2,"NutMac ""NutMac""",20011031,36,4.138888888888889,436.6388888888889,2669,91,2578
A2197WR2BE9X5S,Shawn,20120803,25,4.68,58.04,5,1,4
A21AIWGKF63IK0,anonymous,20030706,23,4.695652173913044,115.3913043478261,36,4,32
A21AM13CHGNCDW,Brian_F,20061104,23,4.043478260869565,97.73913043478261,104,21,83
A21B8AV7E3MPXE,Natalie V. Galasso,20080509,36,4.277777777777778,83.22222222222223,89,42,47
A21BDRUCQKVZIX,"Dantes_peak 19 ""Snake""",20090809,23,4.217391304347826,64.95652173913044,7,13,-6
A21BPMOV9NV2DJ,"H. Su ""Webwalker""",20060312,21,4.095238095238095,63.476190476190474,20,23,-3
A21BV7SEL1ST1Y,morgan,20130304,21,4.285714285714286,42.57142857142857,4,3,1
A21BVL7PKG9BX8,Yoda OK,20080813,24,3.75,220.875,57,21,36
A21BX2V5UK4IPN,R. Chow,20050312,25,4.4,91.72,28,2,26
A21CE99Y7OQU6Y,Lnd Svyr,20070311,21,4.380952380952381,47.23809523809524,25,2,23
A21CJLXIU27CBK,Ross J. Mehan,20100330,22,4.2272727272727275,55.31818181818182,8,3,5
A21EDMG94ID7D,"Clark Isaacs ""Clark's Eye on Books by Clark I...",20110805,21,4.523809523809524,115.95238095238095,8,5,3
A21EG1JA5Q7FK,D. Drummond,20081111,31,4.645161290322581,148.51612903225808,81,10,71
A21G8XF090VXN4,Robert,20051023,39,4.282051282051282,71.61538461538461,59,22,37
A21GMBV4KU0V4,"Momof2boyz ""Momof2boyz""",20121206,27,4.814814814814815,72.70370370370371,44,3,41
A21GW4L8FO307V,Venom,20121210,47,4.446808510638298,62.91489361702128,20,7,13
A21HIGQ101UR5Y,AR,20100902,33,4.545454545454546,57.515151515151516,46,16,30
A21I1N8JO0LQMO,Jeff Geerling,20061229,38,4.7894736842105265,204.23684210526315,116,6,110
A21I5LOKZ19YN5,"Lawrence Foulkes ""I.T. Tech""",20100605,21,4.857142857142857,80.76190476190476,15,4,11
A21I62TCDL4754,Peter E. Safir,20080517,71,3.943661971830986,43.38028169014085,48,35,13
A21ILMJT9DDCZX,techobrien,20130829,30,4.033333333333333,66.8,19,8,11
A21INUA35HX4XQ,"Simmer ""itsme0209""",20100413,77,3.909090909090909,293.85714285714283,418,48,370
A21KNRUAA5RK5E,Trevor Goodchild,20050702,51,3.764705882352941,113.19607843137256,155,108,47
A21L3KTA0D1TED,Admin,20090716,21,3.380952380952381,548.2857142857143,293,49,244
A21LDIFT02EMXX,RPC,20120323,33,3.9393939393939394,24.09090909090909,5,1,4
A21LR9WMFLTU8T,Bryan D,20130207,37,4.72972972972973,61.945945945945944,8,4,4
A21MLQQXFC7VGU,alex Dahik,20121226,22,4.681818181818182,25.863636363636363,4,4,0
A21NS06GDEA3V0,"Mitchell A. Brown ""Mr Bean Jeans""",20100614,39,4.17948717948718,65.56410256410257,16,9,7
A21O7N84JA8Z7X,Joseph P. Olah,20081126,21,4.666666666666667,27.80952380952381,2,2,0
A21OA8773GTIKD,old dude,20061102,35,4.628571428571429,96.42857142857143,25,7,18
A21P2TV5Y8G6V,Andres Serrano Garcia,20120512,42,4.976190476190476,119.19047619047619,49,3,46
A21Q29J3ZWPDNP,From Detroit,20050808,37,4.54054054054054,162.05405405405406,69,5,64
A21Q9JVG4SII51,electronics guy,20050219,53,4.584905660377358,403.8679245283019,541,86,455
A21QCWAHGHF1E,Jeffrey Kaplan,20060619,21,4.190476190476191,134.23809523809524,118,7,111
A21QMWC2TEC3N4,Andrew Erlanger,20021014,25,4.28,54.2,25,8,17
A21R934BTF819E,DaveA,20120818,24,4.333333333333333,97.16666666666667,15,7,8
A21RMLSZNFDRO1,"Charles S. Reed ""audiomook""",20091125,26,4.461538461538462,113.11538461538461,12,3,9
A21RRRHNH616JK,"P. M. Leavitt ""JudgeGuy""",20120325,26,4.153846153846154,26.423076923076923,3,2,1
A21S26XYPGXJZX,"Jody ""bigdumptruckdotcom""",20040823,48,4.479166666666667,166.14583333333334,259,22,237
A21SL94J53BDS9,LGM,20020728,21,4.666666666666667,361.4761904761905,142,9,133
A21T0D2F7SKG5S,SJhiker,20070227,50,4.04,80.44,182,112,70
A21U4DR8M6I9QN,"K. J ""justine""",20060627,21,4.714285714285714,99.85714285714286,47,8,39
A21UQDMQ0Y5ZES,"Ryan T. Begley ""Ryan""",20130323,27,4.555555555555555,59.925925925925924,13,8,5
A21UV9ADZUKXTI,Jamesbeane,20121124,24,4.708333333333333,109.375,2,2,0
A21V6HGU6SU4JG,The Den,20090817,35,3.4285714285714284,103.51428571428572,115,31,84
A21VM9WVF8EOSJ,"J. Warren ""NiALTA""",20100518,57,3.473684210526316,96.59649122807018,223,64,159
A21VUD32OENHJE,C.R.S.,20110409,22,4.7727272727272725,47.81818181818182,16,3,13
A21XHU9D672WYM,"P. Brown ""babybrownbooks""",20060619,25,2.44,160.12,47,5,42
A21XUDC9QBLLSI,jlundin,20130106,37,4.72972972972973,119.13513513513513,47,9,38
A21XUFWCSX7BOF,safenet,20081022,22,4.318181818181818,100.0909090909091,28,11,17
A21YQTAQRSGPNN,J Johnson,20131024,21,3.9047619047619047,43.57142857142857,2,3,-1
A21ZD45J6SW3ZZ,"Daniel Bender ""Daniel Bender""",20121121,21,4.285714285714286,81.76190476190476,34,3,31
A21ZDL4ESK6U5B,James M. Johnson,20100830,26,4.269230769230769,105.1923076923077,347,24,323
A221AYJCX6Y5WB,"Kristi ""all my facts come from fiction""",20090211,29,3.793103448275862,272.58620689655174,48,20,28
A221HTD29MIAKU,Visual8,20120716,29,4.482758620689655,77.0,12,1,11
A22200AUZF7RW5,Jon E.,20110404,40,4.675,90.475,10,1,9
A2227NOW3899R7,R. Atkins,20090107,33,4.212121212121212,306.3030303030303,57,5,52
A222VVX6L2SFPF,B. Nikrad,20100319,24,4.666666666666667,83.58333333333333,32,4,28
A2236W0X2LTB7J,Jayebee,20110119,32,4.625,61.4375,17,7,10
A2240J73FTPR21,Robert C.,20070924,27,3.4074074074074074,687.8518518518518,727,56,671
A224CZ2E4C48WW,Some Dude,20081124,25,4.16,252.16,564,43,521
A224I95EG74M69,"Amy Tsuneishi ""Amy T""",20050912,22,4.409090909090909,106.13636363636364,37,3,34
A224KM22RQ5CD4,Amazon_Junkie,20061224,27,3.5925925925925926,123.70370370370371,40,13,27
A225G2TFM76GYX,J. White,20051017,140,4.507142857142857,99.46428571428571,664,165,499
A2265X68RLA8AD,Shopper,20130101,31,4.451612903225806,204.48387096774192,115,6,109
A226GFM0Q9L37H,Marisa Nitsch,20031102,24,4.5,217.45833333333334,91,17,74
A226R1R1SL13UC,S. R. Kimball,20080224,24,3.8333333333333335,170.79166666666666,35,18,17
A226VGZWOEBPGL,microeconomics,20080303,75,4.44,192.68,277,63,214
A227R053UR64P4,Paul L Randall,20120212,21,4.476190476190476,83.71428571428571,25,2,23
A228O5I7XWT0CJ,Arock,20130531,23,4.6521739130434785,60.0,3,4,-1
A2294LS59GC5K7,David Hofmann,20071208,63,4.253968253968254,186.6984126984127,307,31,276
A229DGCMXUEUL6,"Samsudin B. Kamis ""sambog""",20081221,21,3.5238095238095237,145.42857142857142,28,16,12
A22AUF8HFWBJ1H,nothingness,20100425,44,4.840909090909091,71.18181818181819,35,10,25
A22BKEOA4GCQWB,Richard W.,20130529,26,4.8076923076923075,32.57692307692308,2,2,0
A22CT4ZGGD2FJF,"S. Chang ""Steven Chang""",20070814,24,4.5,113.75,43,11,32
A22CW0ZHY3NJH8,Noname,20070507,255,4.2745098039215685,270.2313725490196,2448,77,2371
A22E3KHZNRB190,Doug,20100806,37,4.783783783783784,113.10810810810811,27,11,16
A22EN4920L3F1E,senhorpedro,20120508,25,4.76,85.96,25,3,22
A22FY6FPTT6ST7,White Lotus,20050131,42,4.142857142857143,444.85714285714283,937,134,803
A22G0HMYN6JQ3M,PRB,20090106,42,5.0,109.02380952380952,64,5,59
A22G6CZZXS4MZ8,C R,20010911,28,4.071428571428571,57.857142857142854,32,6,26
A22I55P15NSAOX,"Two kids mom ""scienceteachermom""",20070211,86,4.3023255813953485,326.3488372093023,793,69,724
A22IC88K739YMA,"Bill ""Bill""",20050204,27,4.62962962962963,252.14814814814815,339,18,321
A22IDP8YERZ79X,"MicheleLK ""Michele""",20040202,41,4.2926829268292686,119.0,213,22,191
A22IMZK5XK0XPI,Glauco,20110922,26,4.576923076923077,120.57692307692308,40,10,30
A22JQ98QWZEH4G,MaysEffect,20110311,21,4.476190476190476,243.66666666666666,73,17,56
A22JRVAY052312,Omar Mohatarem,20130602,34,4.735294117647059,66.02941176470588,9,5,4
A22K36X80X815R,"Abe Vigoda ""part-time inventor""",20090114,29,4.241379310344827,115.0,231,35,196
A22KCASYYMD3NX,Brent Foust,20080602,31,4.064516129032258,203.7741935483871,68,6,62
A22KGO6Q2YWS0C,Dean!,20070715,37,4.081081081081081,387.72972972972974,162,18,144
A22KHWES7PX8MX,"G. W. OMary ""omaryg""",20080223,21,4.666666666666667,46.095238095238095,15,3,12
A22M5EMIPD2NRB,coconutman,20111107,21,4.714285714285714,91.57142857142857,4,1,3
A22MANL4US4RMY,Book Carpenter,20071225,93,4.591397849462366,81.96774193548387,110,24,86
A22NKFOH9RATRC,"M. Larimore ""RatingsFan""",20060913,44,4.363636363636363,74.27272727272727,46,11,35
A22P140WC3CRSQ,Anonymous,20120306,27,4.777777777777778,77.37037037037037,10,1,9
A22PER4P3LP2PU,Sir Lion,20101028,24,3.7916666666666665,77.54166666666667,45,16,29
A22PKZZK5DSONS,Jeremy C,20120112,39,4.153846153846154,173.25641025641025,504,21,483
A22PUBSSNP54L,"G. Little ""DealSnob""",20100415,31,4.193548387096774,84.51612903225806,21,22,-1
A22PVH1UOUX5KN,Tempuraki,20030902,24,4.125,120.91666666666667,324,22,302
A22QKNGN59XYZG,Croppled1,20070719,24,4.625,329.4583333333333,49,12,37
A22QN8JDZS8YOF,"Skip Thomsen ""riverguy""",20091030,31,3.774193548387097,174.19354838709677,33,37,-4
A22R3FVF2B1B0I,Flyguy,20090827,23,4.521739130434782,138.08695652173913,186,26,160
A22R9L5DAVYYWR,"F. Carr ""flrhcarr""",20050507,42,3.738095238095238,206.45238095238096,116,47,69
A22RW51298Z15M,RMeinhardt55,20111217,28,4.678571428571429,50.92857142857143,13,1,12
A22RY8N8CNDF3A,"Loyd E. Eskildson ""Pragmatist""",20070709,35,3.8857142857142857,61.08571428571429,75,53,22
A22S7D0LP8GRDH,"Jacob Hantla ""hantla.com""",20020524,96,4.572916666666667,222.79166666666666,325,53,272
A22SY0Z6MEVGM9,"T. Dorman ""TimD""",20070506,24,3.5416666666666665,89.5,53,5,48
A22SZV0N4O2FQM,"Amazon Customer ""remo""",20100210,21,4.523809523809524,106.61904761904762,29,4,25
A22TUEB5TG0FTQ,"J. Elmore ""Jason E.""",20090322,22,4.318181818181818,180.8181818181818,24,12,12
A22UAP44GIB0OQ,Korey Higa,20131231,26,4.769230769230769,72.0,3,0,3
A22V4R58MDI27V,J. Boyd,20060927,27,4.037037037037037,176.33333333333334,154,21,133
A22VM1VEPI21QM,"Andrew Rabatin ""wtravlr1""",20021226,23,4.913043478260869,42.47826086956522,13,2,11
A22VNXHU6IZ5MT,"Jason P. Pumphrey ""the movie & music man""",20060910,41,4.024390243902439,70.48780487804878,62,31,31
A22WDNLXFIETW5,Clintre,20120228,24,4.25,107.08333333333333,28,5,23
A22YUDXGGX4AX8,"Andrew Butts ""College Cinephile""",20090222,23,4.521739130434782,117.17391304347827,1473,172,1301
A22Z4UHZJZZPET,Jack Wong,20100721,27,3.1481481481481484,104.25925925925925,34,82,-48
A22Z554ZQ8NFPC,"AF ""Whigs""",20100517,22,4.636363636363637,172.95454545454547,17,2,15
A22ZNMEVMP660Q,"Fred J. Morgan ""Jeff Morgan""",20101208,32,4.125,129.96875,64,19,45
A22ZSZRGTC2J79,Yano,20110221,34,2.911764705882353,232.35294117647058,806,314,492
A230L0WI75QQOF,--chris,20050205,28,4.25,130.82142857142858,69,8,61
A231HAEWH5RTMJ,Gerald Khoo,20050606,24,4.208333333333333,216.5,508,26,482
A231WM2Z2JL0U3,Rheumor,20000805,162,4.401234567901234,158.8395061728395,3545,356,3189
A23275FFR2H0N4,VT,20070515,39,4.230769230769231,118.02564102564102,101,25,76
A233TZONT1OGR0,EMY,20110121,40,4.05,118.975,47,19,28
A234GO3KZYKKTE,Nikwax,20010719,44,4.4772727272727275,127.4090909090909,226,30,196
A234V74W5JW277,"Kyle ""cylem""",20071017,43,4.27906976744186,336.3953488372093,385,59,326
A235FTJ4VL068Z,R. Boatman,20100313,29,3.4827586206896552,379.6896551724138,143,33,110
A235NA61RC6YC1,George Dionne,20100103,33,4.242424242424242,165.8181818181818,28,17,11
A235UFZGCFN3J5,Eva,20081215,32,4.59375,207.25,62,2,60
A236V1U1P2K4OG,Andrew I. Munro Sr.,20040101,39,3.4615384615384617,214.6153846153846,248,79,169
A236XRE6MLXPKY,David D.,20130919,25,4.28,69.2,5,0,5
A238V1XTSK9NFE,Andrew Lynn,20010812,22,4.590909090909091,175.5,412,27,385
A239IYFSGKMAY8,Kyle Lowe,20121213,21,4.380952380952381,37.57142857142857,2,1,1
A23AGMSWEUGUQ3,Notmy Realname,20040411,27,4.148148148148148,66.55555555555556,35,5,30
A23BF7PYYT23UK,A. Gabriele,20091205,29,3.103448275862069,104.37931034482759,47,42,5
A23BL0Y36R3ZD3,S. Wigginton,20100416,22,4.818181818181818,50.72727272727273,9,1,8
A23BXVNBGXQ33Y,"Richard R. Capuozzo ""Also known as &#34;Cap&#34;""",20060626,25,4.72,32.56,41,27,14
A23D13HKTA95WX,"David Hostetler ""SuperDave3006""",20100329,42,4.023809523809524,297.23809523809524,68,21,47
A23DFB8IUTIZM0,Dan Sherman,20030126,21,4.428571428571429,199.04761904761904,631,27,604
A23DT6NNRGZ9RL,"Amazon Customer ""cyberjamin""",20071025,24,4.375,118.79166666666667,81,6,75
A23E9QQHJLNGUI,William Oterson,20021209,48,4.833333333333333,141.89583333333334,107,19,88
A23FB18MNBX4J5,"Mark Twain ""wwwumax""",20031125,35,4.257142857142857,113.54285714285714,47,18,29
A23FM0S3J3JYAL,KRISTOFFER FEATHERINGHAM,20130628,22,4.7272727272727275,57.5,7,1,6
A23G3A8YQU6RJM,"Bob Konrardy ""R Konrardy""",20130105,24,5.0,33.125,4,1,3
A23GFTVIETX7DS,Debbie Lee Wesselmann,20011204,241,4.406639004149378,388.28215767634856,2508,269,2239
A23I738USCNCBM,Jason M. Eiting,20100525,21,4.523809523809524,82.80952380952381,14,5,9
A23IUQF3T4FVHI,NegroISO,20111107,24,4.458333333333333,160.70833333333334,38,14,24
A23J1T7UNX14TK,"Nolan Lewis ""Indrid Cold""",20061028,22,4.181818181818182,137.72727272727272,45,8,37
A23KDA686N6T4Y,Nick Alec,20100516,34,4.5,290.02941176470586,137,16,121
A23KEN4HK5CBN3,Amazon Customer,20090302,28,4.535714285714286,87.0,155,20,135
A23KMD1VYV8LN0,casselkid,20110831,21,4.142857142857143,65.0952380952381,32,8,24
A23LF95HUEIGUR,"Clyde O. Stephens ""&#34;Old Fart Ex Tex&#34;""",20070118,21,4.285714285714286,53.38095238095238,15,5,10
A23LMOB2AXLR4W,Iamwally,20110414,25,4.6,203.96,50,5,45
A23MULFKUD4N6T,Derek White,20060129,22,4.636363636363637,325.27272727272725,398,30,368
A23N28VWUZK9CA,L. F. Hunter,20071120,25,4.32,123.2,104,13,91
A23NCQ3RDBMAHI,R. E. WORSLEY,20051018,34,4.588235294117647,131.02941176470588,101,10,91
A23NDJFM03CK0Y,EricJohn004,20130318,34,4.735294117647059,269.44117647058823,70,10,60
A23NSKTMSPPBTR,Wayne,20050917,110,3.809090909090909,518.6727272727272,1083,101,982
A23ONMGKEWDG4M,R. Sutton,20051011,96,4.364583333333333,100.3125,554,136,418
A23PCEL26412R1,"DocRWM ""docrwm""",20011201,34,4.411764705882353,164.64705882352942,309,22,287
A23PT3YQW2SX99,,20110713,25,4.08,83.72,255,21,234
A23PYCN8O9IUNH,Cody,20120605,31,4.096774193548387,74.70967741935483,35,14,21
A23QII83UGZP5U,"Wayne ""Omegafiler""",20050926,60,3.966666666666667,812.5666666666667,3661,333,3328
A23QSTB241NRF3,Dead Spot Shots,20090728,32,4.53125,65.5625,22,52,-30
A23QU283QFK74F,"KeriJane ""Keri""",20061118,24,4.416666666666667,177.70833333333334,80,11,69
A23R3EOZ837242,"Colin Brown ""Colin Brown Microsoft MVP""",20011022,60,4.083333333333333,443.3833333333333,327,93,234
A23R7Y2G9EGRLU,A. Shiekh,20020918,25,4.08,68.92,36,3,33
A23S159FK7W4IK,Nitpicker,20090930,26,4.8076923076923075,125.15384615384616,106,13,93
A23T22W638YWOP,StlJim,20100910,22,4.2272727272727275,127.9090909090909,23,2,21
A23VC0TERZJR6N,"Amazon Customer ""Shanti""",20100805,21,4.428571428571429,190.95238095238096,438,45,393
A23VTC6VKNFZVE,Robert D. Williams,20100308,33,4.666666666666667,211.54545454545453,71,16,55
A23WBD5753O029,Colin,20130114,34,5.0,69.17647058823529,9,4,5
A23WPWLYT3P1CZ,Tiffany Youknowyouloveme,20101228,46,5.0,25.543478260869566,9,5,4
A23WY8GAAF4EU8,Bruno J. Bischoff,20080203,21,4.9523809523809526,37.95238095238095,3,1,2
A23X0QV7Q3SPCX,"Jeffrey R. Brant, MD",20060622,23,4.304347826086956,264.7391304347826,51,4,47
A23XEUZWVI8LYK,"John Van Walsum ""Frequent flyer extrodinaire""",20070308,41,4.609756097560975,140.17073170731706,61,5,56
A23YGAIIIVTXEJ,Josh Y. Lee,20081016,22,4.7727272727272725,60.90909090909091,12,7,5
A23YLPW55X1XZ,FrogRacing,20080806,21,4.476190476190476,88.0952380952381,24,6,18
A23YU1JBLQT86Q,AwesomeSauce,20121121,22,4.363636363636363,141.27272727272728,18,1,17
A23ZNGL704AW7O,Jennifer Ray,20070128,84,4.178571428571429,509.9761904761905,1305,110,1195
A23ZXHFLC6TBLD,Matthew W.,20090715,63,4.571428571428571,142.22222222222223,53,7,46
A240FRPD4MEXND,Phyllis Staff,20070516,70,4.214285714285714,244.82857142857142,520,78,442
A242IFN64X6R4E,Grumple Dumple,20040913,32,4.84375,157.625,679,43,636
A242NHKVYIYHHP,"Joseph R. Norman ""bnorman""",20070317,35,4.428571428571429,88.6,29,2,27
A244CRJ2QSVLZ4,J. B. Hoyos,20100501,43,4.5813953488372094,698.8139534883721,84,37,47
A244ZOEIN2H8A7,David Calder,20090420,26,3.9615384615384617,150.80769230769232,55,7,48
A245847KYYDMSN,"kevin ""Old HP Guy""",20110314,22,4.318181818181818,102.45454545454545,20,9,11
A245AST0T0AZTJ,J. Lindner,20020808,22,4.5,324.6363636363636,136,9,127
A245DTGCSY59ET,dj lg,20110516,32,4.59375,185.90625,42,9,33
A245M6JE6I5B6O,C. Taylor,20100713,31,4.419354838709677,97.54838709677419,31,17,14
A2465B935KYILR,Jeffrey D. Hauck,20080829,21,4.142857142857143,30.333333333333332,23,12,11
A246YIFE5M6M2C,"Shawn Kovacich ""Shawn Kovacich""",20100625,28,4.428571428571429,250.53571428571428,45,22,23
A247L282PID4PE,Paul,20120626,41,4.7560975609756095,82.8048780487805,14,31,-17
A247VUU8B9WSDU,"Tushar Tyagi ""shell kernel""",20060820,26,3.923076923076923,80.38461538461539,120,20,100
A248KV0TY6IMKS,"Amazon Customer ""Laram""",20091116,31,4.193548387096774,96.0,28,5,23
A2492XE7PBMELT,"K. G. Schneider ""Librarian, Writer, and Booka...",20031114,25,4.16,252.4,525,64,461
A24957HBA987VN,"C. Moore ""The Authorguy""",20041023,21,4.142857142857143,209.57142857142858,549,27,522
A2499SB2WPLUW1,"Stuart Schneider ""Author of books on collecti...",20071019,23,4.782608695652174,63.04347826086956,17,26,-9
A249FZIEJXNWR,"Mrjustdis ""Mrjustdis""",20081102,24,4.375,97.33333333333333,23,4,19
A249QYXQ3B0EHL,"Gia Jacobs ""BodyByGiGi""",20120223,21,4.619047619047619,81.0952380952381,15,6,9
A24ARANWS5E3T8,Richard V. Mullen,20081229,50,4.38,100.4,52,19,33
A24B1HPOUB5RVY,"E. Meiners ""pawnslinger""",20081225,34,3.911764705882353,105.1470588235294,64,36,28
A24B990VP9QC6C,"Cathy Stucker ""IdeaLady.com""",20080821,21,4.238095238095238,225.52380952380952,73,11,62
A24BSKCWXC4M6D,teagirl,20121217,22,4.363636363636363,45.86363636363637,15,3,12
A24D5F1AHSXKNV,Sam-Wise,20111125,21,4.095238095238095,71.0952380952381,7,9,-2
A24EMGY9DC4Z72,John S. Socha,20100313,30,3.933333333333333,213.03333333333333,178,15,163
A24EQC4LXYPT4E,Dave,20110710,28,4.392857142857143,42.17857142857143,5,7,-2
A24F385BETBP4N,FC,20130424,22,4.863636363636363,36.36363636363637,23,4,19
A24FQNZ2ZCP9UH,Jen,20130128,22,4.681818181818182,129.45454545454547,20,2,18
A24FS9EKQDRGOD,Amazon Customer,20080614,27,4.407407407407407,78.88888888888889,3,4,-1
A24FXPXRPL17ZE,jray,20090504,24,4.25,285.75,191,26,165
A24HWYHR28JJ7A,&#131;&#367;&#142;&#378;&#376; &#969;&#364;&#...,20070427,114,4.5,1312.280701754386,2100,203,1897
A24J2Y1O22JYZX,"Chris Boylan ""MrBoylan""",20040516,52,4.3076923076923075,619.1153846153846,7380,310,7070
A24J6PQ0FN55A6,WestGrl,20090428,27,4.444444444444445,217.8148148148148,256,37,219
A24JOL9F1R4I67,Gary L. Labandter,20090922,21,4.809523809523809,32.523809523809526,4,2,2
A24KBB6X5URQ63,"HMH ""hmichael0330""",20110107,22,3.8636363636363638,125.68181818181819,28,9,19
A24L7CNCQY0FT4,"Michael Willey ""Photog101""",20130713,36,4.0,80.13888888888889,29,4,25
A24LLNKVW5NX8U,Stan,20000629,28,4.464285714285714,43.464285714285715,27,6,21
A24N1BAS3CU27H,Nse Ette,20050528,23,4.521739130434782,368.7826086956522,635,33,602
A24NHM36GTLOTQ,DanMan,20110127,27,4.444444444444445,252.40740740740742,52,8,44
A24NN1DJGINMRG,Aaron,20121126,21,3.857142857142857,134.04761904761904,26,12,14
A24O06NZGVHZLR,chad,20120712,28,4.678571428571429,222.03571428571428,23,22,1
A24P4E3RJ6AX94,PrettyPicky,20111228,62,4.580645161290323,87.20967741935483,48,4,44
A24Q3H66SCDCFO,oortcloud,20110519,30,4.566666666666666,53.06666666666667,25,17,8
A24QFMD1RXLJMB,thelastpiece,20120411,42,4.190476190476191,75.07142857142857,22,8,14
A24R30PNVRG4VG,An ordinary consumer,20021218,34,4.117647058823529,261.8235294117647,144,37,107
A24RCBRDXRXR0Y,James A. Nichols,20071219,54,3.9074074074074074,132.3148148148148,244,40,204
A24RT6AVJXJZHF,"John P. Thiel ""John P. Thiel""",20060131,45,4.688888888888889,420.02222222222224,460,44,416
A24UY2BFLGK163,Peter Besenbruch,20090408,25,3.8,397.6,260,20,240
A24VB5D1XAUMY1,"JAMES C. NORRIS ""J.C. NORRIS""",20120504,27,3.6666666666666665,45.22222222222222,8,11,-3
A24VXP1V38HSLG,colormepink,20090125,22,4.818181818181818,100.72727272727273,29,7,22
A24W1A0CW6CW5R,Brooke,20111103,25,4.48,54.12,158,18,140
A24WJULX7UOLFB,"F. Jury ""dsunglasses""",20071204,25,3.92,457.8,222,54,168
A24WJXSXVNB9KF,"Bob Roush ""a Jeep guy""",20090604,22,4.909090909090909,96.36363636363636,30,6,24
A24Y4T8OCYTDYQ,Siphandone,20120511,25,3.72,74.44,12,6,6
A24ZMNWTW8AQUR,"SciFiChick ""The SciFiChick""",20081021,24,3.5416666666666665,116.83333333333333,19,25,-6
A24ZT9S719KJPF,Amazon Customer,20081227,24,4.625,91.25,10,1,9
A2503LT8PZIHAD,"Gertrude, the Innocent ""Live well, laugh loud...",20090528,100,4.13,266.38,272,75,197
A2507ZYWGMY9BK,Gcat,20050703,34,3.911764705882353,275.0882352941176,358,55,303
A250AXLRBVYKB4,"Nathan Beauchamp ""ConsumerAdvocate (nathan(at...",20080813,178,4.241573033707865,273.5,3408,241,3167
A250HHH6LNASFA,,20110919,22,4.090909090909091,367.1818181818182,164,27,137
A250I9ASXF968Q,Cullen Lorsung,20121214,23,3.9130434782608696,66.95652173913044,20,15,5
A250M88M3P5783,"HL ""Laughter brings happiness""",20050128,26,3.5384615384615383,258.96153846153845,286,44,242
A251OKWDZIA702,homesweethome57,20110712,36,5.0,46.25,121,28,93
A253IOATGMT2UP,R. Beaton,20080317,73,4.493150684931507,52.04109589041096,35,24,11
A253X5E4L0DM0W,Andrew,20100321,31,4.32258064516129,40.87096774193548,6,1,5
A254MDH9GJ1HQD,"Maleko ""islndsnw""",20071118,27,4.777777777777778,208.88888888888889,120,14,106
A255MXZ2359C3Y,Gus Smedstad,20020422,26,3.6923076923076925,334.6923076923077,136,45,91
A2563KH97YRG98,"David B. ""David""",20130702,23,4.391304347826087,140.17391304347825,14,1,13
A256SA0PNN78BD,aljacobs,20110420,23,4.695652173913044,108.56521739130434,99,6,93
A256T5PCQ0UZIM,Bob Dobbs,20070903,27,4.296296296296297,119.62962962962963,39,4,35
A257FDIK89QBE9,Theresa,20130127,24,4.416666666666667,59.208333333333336,14,3,11
A257J492D81PS8,bitbob,20111215,24,4.125,101.20833333333333,51,7,44
A257X1MQJO82P2,Kanehi,20070804,55,4.781818181818182,98.07272727272728,52,14,38
A258IZLBPL93YO,"John R. Shockley ""Rick Shockley""",20120213,24,3.875,43.833333333333336,7,2,5
A258JIBV22UWM8,W. McKinney,20070219,32,2.96875,114.1875,215,50,165
A258NDMTLH29RJ,Ed C,20101028,22,3.909090909090909,50.22727272727273,8,6,2
A258ORY2G5SHVT,Sleepy,20140329,26,4.0,92.8076923076923,15,4,11
A25932ULAHQSB3,paul,20121208,25,4.68,38.4,37,7,30
A259MPG6SOL02P,"Josh-Daniel S. Davis ""xaminmo""",20010208,87,3.4367816091954024,185.28735632183907,610,72,538
A25AFBV75QOEJD,Arnalb,20120606,24,3.9583333333333335,54.041666666666664,2,1,1
A25B7ZC77JVVA7,Chuck,20130509,21,4.285714285714286,49.333333333333336,12,3,9
A25C2M3QF9G7OQ,Comdet,20070425,261,4.616858237547893,304.2605363984674,1701,141,1560
A25C5MVVCIYT5D,Natalie Dawn,20090709,33,3.727272727272727,88.84848484848484,18,20,-2
A25CDG2JO0G6VH,Lloyd Dawson,20110520,24,4.541666666666667,51.708333333333336,7,3,4
A25CGBLRJB6X0S,Brass Monkey,20080107,31,4.161290322580645,214.4516129032258,36,11,25
A25CY0I386755K,Kevin Khan,20090112,27,4.222222222222222,40.0,11,3,8
A25EGTGMF8V06Y,"R. Spencer ""PC game review expert""",20120112,23,4.565217391304348,83.6086956521739,7,4,3
A25EPLCBAOLY67,"Jermaine Stewart ""stewy_gt""",20040312,22,3.8636363636363638,308.90909090909093,143,16,127
A25FDSTIHHAFKX,C.C.,20120311,26,4.653846153846154,59.34615384615385,23,9,14
A25FL6VLD7S23S,"OILMAN ""OWEN""",20021112,91,4.868131868131868,95.13186813186813,492,211,281
A25FV0XA4SGG9P,MustangMichael,20120113,35,4.714285714285714,291.74285714285713,154,27,127
A25FY0JD54B09P,M. Hsu,20081231,25,3.48,94.6,21,13,8
A25H64OFHIODZN,T. Tyler,20090606,29,4.620689655172414,43.310344827586206,17,33,-16
A25HBO5V8S8SEA,"Brent D. Payne ""SEO Director, Tribune""",20041105,41,4.853658536585366,212.21951219512195,2316,188,2128
A25IHLWYOK158R,"E. A. Bustos ""Techie""",20080909,35,4.3428571428571425,363.14285714285717,63,6,57
A25JUE9AFX7SUC,Matthew,20131015,22,4.409090909090909,85.5,13,6,7
A25KDAMREZ38KJ,Tommy Jordan,20110806,21,4.285714285714286,97.66666666666667,22,5,17
A25KKXUQQ0OLWB,"Lynn Ellingwood ""The ESOL Teacher""",20070227,45,4.7555555555555555,70.04444444444445,30,18,12
A25KVM6GJBLISZ,John F. Wright,20051102,22,4.0,211.86363636363637,200,46,154
A25LM23UM50GD,"Mark ""Sorokahdeen""",20060415,29,3.310344827586207,514.8965517241379,349,76,273
A25LXOYTSL3GL3,Marigno,20120125,21,4.571428571428571,81.9047619047619,18,3,15
A25MDPTWBJPGBT,"Craig S. Burnett ""On-Camera Talent and Video ...",20100803,42,4.857142857142857,116.83333333333333,117,10,107
A25NT9MZV9RTR7,nitsa,20110507,23,3.608695652173913,199.43478260869566,63,52,11
A25OPQ3GYAVT6L,mrfixit2011,20130729,38,4.631578947368421,36.5,4,4,0
A25P1BXEEKBAO7,Roland,20080617,34,4.411764705882353,98.1470588235294,25,4,21
A25PKF8V3Q4IOL,Tom L. Pittman,20120605,25,4.6,138.04,19,5,14
A25Q4C2UDIOPXC,Daniel Lee Schmidt,20090704,28,3.8214285714285716,43.07142857142857,3,0,3
A25QJBK33C4O0R,"terpfan1980 ""Barry""",20080605,84,3.7976190476190474,676.3809523809524,495,133,362
A25RTRAPQAJBDJ,Ted,20070209,41,4.414634146341464,146.3658536585366,237,45,192
A25RXGCZ69JUZJ,Paul D. Bui,20060915,24,4.875,111.91666666666667,67,32,35
A25SDTIJI2EFPG,Enigma,20060712,26,4.653846153846154,154.69230769230768,267,19,248
A25TNBMJ4ZO7RD,M. Potvin,20080311,46,3.782608695652174,211.5,281,36,245
A25TQLMIAPI1T6,Ronaldo,20111228,55,4.545454545454546,35.81818181818182,14,5,9
A25UBYD3S1AWJ4,"Valley of The Sun ""SUNSHINE""",20120608,38,4.605263157894737,40.28947368421053,10,3,7
A25UZ7MA72SMKM,Brent Butler,20100420,106,4.113207547169812,293.16037735849056,333,59,274
A25W2FDZ2JANPG,bradenbru,20130511,23,4.608695652173913,64.73913043478261,19,2,17
A25WJCAP606YMP,"ESVK ""SVK""",20051121,64,4.28125,112.890625,218,61,157
A25Y4KW08CXT24,SouthernBoy,20140126,23,3.5217391304347827,60.69565217391305,8,4,4
A25Z6I5VL0O5XX,mister e. shoppa,20071227,21,3.4285714285714284,102.76190476190476,108,13,95
A25Z7BEZM1XXXD,Anon,20111220,22,4.863636363636363,95.4090909090909,7,2,5
A260SSASBXC090,Ryan,20100727,32,4.46875,239.84375,498,28,470
A265S2Z6U63RBU,G. Berger,20060821,42,4.5476190476190474,173.66666666666666,374,15,359
A266QFNGPX2ZAU,Luca Tommasino,20090130,32,4.8125,57.3125,20,1,19
A267CNXZTWED3N,"C. Harmon ""Florida Maveric""",20080113,27,4.962962962962963,49.925925925925924,7,4,3
A267FU71Z01CIH,"Kippoe ""Kipp Poe Speicher""",20110511,59,4.3559322033898304,102.27118644067797,66,31,35
A26877IWJGISYM,"Lon J. Seidman ""lon@ lon.tv""",20070219,65,4.246153846153846,276.32307692307694,1259,121,1138
A268EEWUXYCA8Q,Terry Mesnard,20061203,44,4.159090909090909,468.59090909090907,260,40,220
A268S3JIG60QZF,Darrell J. Lew,20080902,24,3.6666666666666665,90.41666666666667,76,12,64
A268WAQS5WNMGJ,Thomas B. Gross,20001206,31,4.0,197.90322580645162,544,108,436
A269FH9V0X3593,J. England,20100316,27,4.888888888888889,61.666666666666664,54,10,44
A269I61I2FZEQ9,"Gerardo Pedraza ""Gerry""",20081212,25,4.0,94.28,19,15,4
A26ADVY1B04F6K,David Grunat,20120630,27,4.592592592592593,57.407407407407405,9,13,-4
A26BDXG9KVH7SU,Mom of One,20011010,81,3.6296296296296298,151.46913580246914,180,96,84
A26C9L4LGGE6D7,"KnarfOH ""KNARFOH""",20110317,24,4.541666666666667,171.875,80,24,56
A26CPEEWB2WKRE,Phil in MIdland,20070520,50,4.06,375.52,674,53,621
A26CPEMD4T2EU1,Brice,20110114,22,4.2727272727272725,142.86363636363637,43,19,24
A26DG05WFGH2V0,Gary Parlato,20120112,29,4.379310344827586,50.86206896551724,13,8,5
A26DQMYF5E0GL6,Don Walton Jr.,20090108,27,4.222222222222222,202.40740740740742,18,11,7
A26EB0MDHMDD5U,Amazon Customer,20070329,21,4.666666666666667,45.0,23,7,16
A26EQ8U96JA92T,Jody,20090118,80,4.6625,63.875,32,9,23
A26EU313M9XOC1,Amer Bedi,20090416,29,4.482758620689655,54.55172413793103,72,47,25
A26FEJTPYJ934F,"Taylor Corbet ""Taylor Corbet""",20100617,27,4.148148148148148,74.0,64,17,47
A26IKBWCSJ2Y9K,Nitrousbird,20110424,35,3.914285714285714,243.22857142857143,62,22,40
A26KHZE0HTS057,Burgmicester,20081219,28,3.5357142857142856,216.78571428571428,151,31,120
A26KXNN6H1IL0I,A. Tegtmeier,20080514,91,4.329670329670329,236.14285714285714,416,52,364
A26LD9FQHTM8ZH,OlyNomad,20090613,56,4.142857142857143,133.5,242,52,190
A26LQSC65AMTGK,"Dawn Dowdle ""Mystery reviewer""",20091021,27,4.111111111111111,67.66666666666667,20,21,-1
A26MKYA0OFD9XI,Amazon Customer,20080629,33,4.848484848484849,68.9090909090909,181,21,160
A26NSWOAKB86LM,Cabfarm,20110523,30,4.233333333333333,77.23333333333333,28,5,23
A26P08DCAHSM77,Genryu,20130119,21,3.9047619047619047,291.42857142857144,71,9,62
A26PKRMRF54AJ0,king kaos,20120724,27,4.37037037037037,36.48148148148148,6,1,5
A26Q0YA18H7SHM,Chris S,20121119,22,4.136363636363637,53.40909090909091,15,10,5
A26R7LLAFTPC3U,William Hardin,20040816,24,4.0,223.95833333333334,190,68,122
A26S0R5B6D0BP9,Jeffrey Gillman,20090511,35,4.057142857142857,146.11428571428573,71,8,63
A26SN2CVQM4FKM,bayou bob,20100609,31,4.096774193548387,34.516129032258064,6,1,5
A26SO3TOT2TLJE,Marla,20051217,72,4.347222222222222,115.61111111111111,78,42,36
A26VF18X91983P,Richard,20060719,40,4.625,115.825,241,48,193
A26W371UODZMXJ,Louis Schwab,20110125,38,4.894736842105263,60.55263157894737,2,1,1
A26WW5UQ7JMQ5Y,Amazon Customer,20070115,21,4.190476190476191,126.33333333333333,33,5,28
A26X7W5UM5QFT4,Grits,20080731,31,3.7096774193548385,322.64516129032256,108,18,90
A26XAKUKHTIIM9,NYC Baby,20070512,37,4.891891891891892,90.08108108108108,47,6,41
A26XGR0BXINK63,William C. Hast II,20100614,21,4.809523809523809,38.095238095238095,7,2,5
A26XIJUJK1KRL0,"J. Clark ""Jen""",20111129,43,4.744186046511628,120.09302325581395,70,15,55
A26Y7WIS3JBL65,"Matt J. Rose ""Blu Aficionado""",20081105,26,4.961538461538462,275.38461538461536,380,29,351
A26YF89Q2JN162,Locutus,20110828,22,4.636363636363637,39.77272727272727,12,6,6
A26YHXZD5UFPVQ,2K1Toaster,20130607,26,4.653846153846154,90.3076923076923,14,0,14
A26ZK8QFWXN859,"dalepres ""dalepres""",20070505,22,4.090909090909091,123.22727272727273,67,15,52
A2701UXI8QGRHE,Leslie Ann Lewis,20080902,31,4.612903225806452,175.7741935483871,48,16,32
A2716HB74GDFN7,Amazon Buyer,20070319,38,4.131578947368421,82.8157894736842,39,18,21
A271SYCDU6ZWQD,Patrick Rouse,20110429,23,4.782608695652174,205.7826086956522,27,6,21
A27234H03Q7Q9X,Amazon Addict,20120229,21,4.380952380952381,59.57142857142857,10,4,6
A272Y6VXIMOKSF,Frank Collins,20070211,30,3.8,178.0,133,31,102
A273KT0BQJCAXE,"PKS ""Laughing Buddha""",20090317,26,4.153846153846154,125.11538461538461,77,14,63
A274MXTX3DYLUV,BB Indiana,20080816,49,4.285714285714286,203.0204081632653,320,35,285
A274X54O9CN2SR,J. Moritz,20071230,43,4.069767441860465,82.86046511627907,43,27,16
A275EOYAIDKYAU,Jimh615,20050315,29,4.137931034482759,206.68965517241378,630,49,581
A275L12XC23G9I,Dr. Z,20091216,32,4.375,54.84375,5,6,-1
A275NAX5OLEU3L,Sello,20071025,31,4.967741935483871,140.74193548387098,40,4,36
A276OI0NHBYORX,Rebecca N,20041124,41,4.585365853658536,177.9268292682927,243,42,201
A278V4RQOW79GG,kdogg,20121005,47,4.319148936170213,31.51063829787234,22,8,14
A279A4Y2N1CQ26,Crestviewer,20081125,21,4.428571428571429,184.85714285714286,118,22,96
A279FUL12R7MBD,"Brandy Fortune ""Brandy Fortune, Author of &#3...",20060118,35,4.085714285714285,108.74285714285715,151,176,-25
A279M2SJNQDWM7,lhobbs4,20120509,24,4.791666666666667,33.5,3,6,-3
A27ADCSD15F3GL,Schwartz,20081114,91,3.934065934065934,376.6043956043956,412,58,354
A27AF4DLLOBQDQ,"B. Marshall ""Bronco Fan""",20060406,52,4.384615384615385,144.98076923076923,72,9,63
A27B1U3OWCU14J,Method2Madness &#34;Alex&#34;,20050603,69,4.246376811594203,344.95652173913044,1140,99,1041
A27BRS9UA93O6X,A. Chen,20111019,24,4.416666666666667,59.416666666666664,12,4,8
A27CEMG5JZO95F,C. Hudson,20090802,22,4.2272727272727275,95.63636363636364,8,6,2
A27CQ4V6YYVC3G,Phil @ Amazon,20021209,21,4.619047619047619,378.5238095238095,46,29,17
A27CTW0GPEE0AZ,Firefly,20110202,21,4.857142857142857,66.04761904761905,3,19,-16
A27D0VRNOOUNRR,"Steph ""booklover""",20100709,22,3.8636363636363638,229.63636363636363,27,12,15
A27DDHWHE540I5,Pie Grrrl,20071206,40,4.575,614.075,447,64,383
A27DITPCCZIVAH,"C. Ball ""An idea that is not dangerous is unw...",20080801,22,4.7272727272727275,154.36363636363637,27,13,14
A27E44IWS3B7VD,"silhouette_of_enchantment ""zenfully awake.""",20100404,39,3.641025641025641,160.74358974358975,93,21,72
A27F1N27M1X0NM,Kenneth R. Shaw,20051009,22,4.363636363636363,112.31818181818181,58,16,42
A27FFCXM6PVP9Z,David Ecale,20110611,24,4.333333333333333,158.125,21,10,11
A27FJMTTINZO3R,Sean Gately,20120311,29,3.8275862068965516,120.96551724137932,12,6,6
A27FP0S5QH7GNE,IslandSandy,20110530,22,4.954545454545454,105.0909090909091,41,3,38
A27GA298ZWO31B,"Sam Beckett ""Quantum Leap""",20081027,22,1.5909090909090908,141.72727272727272,174,341,-167
A27GITTN6AVW5I,"Morimoto ""Morimoto""",20011212,54,4.148148148148148,220.72222222222223,174,33,141
A27H0T39U3FZB5,"P. MSakamoto ""boy clothes""",20080501,94,4.053191489361702,418.28723404255317,610,96,514
A27H61OHW44XA7,"W. Smith ""MoBoarder""",20070311,46,4.543478260869565,64.78260869565217,156,41,115
A27H9DOUGY9FOS,"K. Harris ""Film aficionado""",20100405,23,3.9565217391304346,318.5652173913044,226,36,190
A27HLTDITCL1O8,L. Wick,20080221,28,4.285714285714286,101.25,99,49,50
A27HLVZVPJG6HC,"K. Bennett ""Low End Thumper""",20101015,21,4.809523809523809,106.95238095238095,7,0,7
A27I8YBSY7I1NM,antcin307,20111031,22,4.5,98.77272727272727,17,3,14
A27IEA7DADM64W,ioBuddha,20120222,25,4.68,98.44,198,18,180
A27J46WPFY7ADM,Gordon S. Ferris,20101224,39,4.3076923076923075,76.84615384615384,85,14,71
A27JXR6QL0I80S,pitbullman216,20100804,34,4.764705882352941,37.88235294117647,10,3,7
A27KTLDSBWXNED,"David C. Filmer ""David Filmer""",20090821,28,3.6785714285714284,263.60714285714283,149,22,127
A27LB0VUIXIX8H,William Brown,20091005,29,4.586206896551724,64.62068965517241,150,23,127
A27LKFHOX8D7I5,traveleinfool,20121030,27,4.296296296296297,77.70370370370371,14,3,11
A27M18RREZO0PO,Gambino,20110420,27,4.0,59.7037037037037,26,8,18
A27M75LRSJ788H,Bruce Sobocinski,20130207,92,4.880434782608695,53.09782608695652,133,10,123
A27MX4Y22QZW1N,Etienne,20091012,22,4.5,208.5909090909091,32,19,13
A27N36BPXB2EKB,80sGuy,20060125,34,3.5588235294117645,395.29411764705884,333,43,290
A27N884RIHU7T9,NJer,20061226,33,4.424242424242424,62.121212121212125,29,6,23
A27NKDSY5J9MEB,JRD,20070615,32,4.375,86.5,175,23,152
A27PNH29CY07L2,Ddm33,20110425,23,5.0,46.869565217391305,18,1,17
A27QXQQOLAMRRR,"Bone ""JLLaser-net""",20070527,94,3.904255319148936,357.6808510638298,328,66,262
A27R1FLUS2KTIX,Jonathan K. Perkins,20050920,31,4.129032258064516,141.96774193548387,174,27,147
A27R5JQPF8C0RF,C. Kelly,20120302,29,4.620689655172414,216.86206896551724,61,6,55
A27RIKJSPFF2J1,Pcmofo,20130613,22,4.545454545454546,107.72727272727273,4,0,4
A27RVM5HMAHK9A,"Karla U ""KMU""",20110625,22,4.409090909090909,114.31818181818181,10,6,4
A27S3EKWYSFRJZ,Christopher,20100827,31,3.838709677419355,264.9032258064516,250,85,165
A27SAQH0SH6AHN,Alin S. Steglinski,20091012,34,4.147058823529412,232.52941176470588,439,71,368
A27SEH7FJJIKIC,BF,20120801,30,4.6,94.63333333333334,32,2,30
A27T4RQ3XA661C,"Randy M ""rdm""",20031111,73,3.8493150684931505,306.4109589041096,496,129,367
A27TL6S5B34O1Q,winstoncubed,20110723,25,4.4,96.68,25,8,17
A27TN8D0CZ8LUY,"John ""John""",20090306,58,4.0344827586206895,78.06896551724138,50,31,19
A27TQA0XCZUXZY,Feles31,20090127,34,4.117647058823529,75.47058823529412,30,18,12
A27UJPP9SQWGDO,Amazon Customer,20061220,24,4.458333333333333,153.25,41,9,32
A27WLWSDJ7ONIZ,daReviewer,20101223,21,3.4285714285714284,230.95238095238096,34,48,-14
A27WV4V47468DU,"P. L. Steele ""snotbottom""",20110425,25,4.24,60.84,16,2,14
A27XEJX3W4FCUK,"William C. Milo ""Bill Milo""",20080209,24,4.166666666666667,93.54166666666667,38,18,20
A27Y4OEC9MD9PA,George Wey,20110302,49,4.938775510204081,83.89795918367346,193,43,150
A27Z1LWMZKJFW3,Daniel J. Pickering,20090130,26,4.8076923076923075,146.96153846153845,28,4,24
A281387UUS2IN5,Beantown Jim,20080301,21,3.9523809523809526,127.71428571428571,53,9,44
A281T8MXBOSWY5,granger,20020228,36,4.444444444444445,197.91666666666666,287,29,258
A281YNUJLGXDXO,J Ponder,20120102,26,3.9615384615384617,167.65384615384616,35,9,26
A282GHZU48ONQZ,Kevin Curtis,20110403,23,4.782608695652174,53.82608695652174,19,1,18
A282RNKOO2P5RT,AreYouKidding?,20070724,35,4.171428571428572,196.0,700,77,623
A2830FG65LOK6S,Stacy Burns,20130204,24,4.458333333333333,72.70833333333333,3,2,1
A283G3CMA1NS6Y,"H. Koerner ""a coffee lover""",20100105,23,4.3478260869565215,107.78260869565217,12,5,7
A283HYRKHPCZT5,Cambeul,20081201,23,4.217391304347826,67.04347826086956,23,8,15
A284Y9E8UP7FNJ,Online Shopper,20040928,36,3.1666666666666665,98.75,402,274,128
A28525P0S5ZVJ3,"Edison ""hightech lover""",20060531,44,3.7954545454545454,181.5681818181818,411,96,315
A2858RV2VLI14X,Dr. Lamb,20140108,45,4.533333333333333,43.888888888888886,3,1,2
A285J3SRDFV74G,"Prietito ""Prietito""",20110408,24,4.458333333333333,85.41666666666667,23,3,20
A285W3N2KHGII1,Andrew Greimann,20100316,34,4.5,279.8529411764706,56,8,48
A28621TSIR5EOG,"Walk Around ""Osprey""",20080902,61,4.901639344262295,71.45901639344262,40,8,32
A2862MIILFPLMO,"Retired Tire Engineer ""Drew""",20071001,25,4.6,66.8,17,8,9
A2877636PYV2A3,"T. Russo ""Capt Tom""",20080423,26,4.384615384615385,114.73076923076923,94,28,66
A287ASQPTD7MP,"Brian ""continuum""",20070108,22,4.318181818181818,81.5,10,3,7
A287BJ5PH5D7IH,sn2002bt,20110324,27,3.0,71.96296296296296,24,15,9
A287VIG5J2SQTX,"Mikatoga ""Mikatoga""",20070109,29,3.896551724137931,66.55172413793103,79,12,67
A288CEKL8FA6QC,Jeffery Keller,20130701,31,4.806451612903226,62.38709677419355,6,3,3
A2894L07WQIL4Q,Mike90125,20080302,37,4.5675675675675675,127.97297297297297,135,33,102
A289ARF9YKYKD4,"F. Dumanoir ""vintage hifi-geek""",20060826,27,4.518518518518518,199.92592592592592,97,12,85
A28A81IY1GIHO4,"Cole K. ""Cole""",20090810,23,4.304347826086956,124.1304347826087,30,3,27
A28AFDBZ8MD5B6,Tom,20100828,22,3.272727272727273,172.13636363636363,151,28,123
A28AHI180H69GK,68redcedar,20110917,24,4.125,210.625,20,1,19
A28BX3MM90A6FI,"Amazon Customer ""hotdog""",20070711,69,4.463768115942029,212.7391304347826,1138,60,1078
A28CCN6VYHRUKS,"Andrew Gray ""Beezer Review""",20070929,29,3.8275862068965516,232.79310344827587,48,20,28
A28CCQNXWV6WA2,"Mar ""Marinera""",20071114,43,3.372093023255814,57.604651162790695,114,218,-104
A28CIYZUKDZ6RE,Nathan V,20101130,21,3.9047619047619047,111.9047619047619,19,3,16
A28CK4RY72NI5T,ICONMAKER,20121227,27,4.703703703703703,57.7037037037037,12,9,3
A28DJ4FW2LG77Z,"John Mckee ""John""",20090611,34,4.823529411764706,33.64705882352941,6,1,5
A28EMTHVF120XV,Happy To Be Here,20130318,29,4.793103448275862,163.72413793103448,93,4,89
A28HUBMSCXVQW0,AK,20051013,32,4.09375,183.4375,1020,58,962
A28HUH3VYWJ9T9,Michael L. Willis,20080808,25,4.16,72.92,51,15,36
A28HVL8ZZJEH21,"KenP ""ken-p""",20080719,25,3.52,70.6,24,25,-1
A28HZTGUEXWSGV,"R. Snyder ""whatsthedeal""",20080409,26,2.730769230769231,68.92307692307692,70,71,-1
A28I19Q54MYXGV,Buffy,20090430,37,3.5945945945945947,120.02702702702703,87,43,44
A28I5UM0FT3I6T,jmachado,20110322,43,4.186046511627907,29.488372093023255,21,29,-8
A28IPDM32N01PY,J. M. Carter,20100826,23,4.3478260869565215,59.91304347826087,9,2,7
A28ISUIFUMLQD6,Stormy1,20111027,31,3.774193548387097,243.96774193548387,86,11,75
A28J3123I1QDKI,"Bowser B ""Bill""",20100812,53,3.9245283018867925,163.56603773584905,140,38,102
A28KAXBXSXYZXY,R. Blakeney,20080830,31,4.516129032258065,33.806451612903224,21,5,16
A28KI92RSY1Y11,"Terry Herzog ""TeRRyZx""",20061230,30,4.166666666666667,62.166666666666664,14,12,2
A28KY5HDFLRZP1,J. Higgins,20080809,29,4.896551724137931,111.17241379310344,48,11,37
A28LUOEY0ECT9G,,20100906,49,4.571428571428571,27.53061224489796,10,39,-29
A28LXIZQOEQ6KY,"A. Rabun ""A. Rabun""",20091209,29,4.344827586206897,180.89655172413794,144,36,108
A28MJ51GOXSEDB,sroc,20070905,24,4.916666666666667,68.45833333333333,22,3,19
A28N2AWOVO2PB,"Simon Cleveland ""S. Cleveland""",20070920,74,4.527027027027027,107.06756756756756,105,65,40
A28O0F8ZN06NL4,"Doug Buchan ""CEO of Buchan Consulting LLC""",20080922,33,4.424242424242424,91.03030303030303,20,6,14
A28O8R0T3BIFMD,"Matt P. ""Coder of Fortune""",20080907,26,4.423076923076923,74.3076923076923,70,13,57
A28O9KEI7Q3L2L,B. Ablia,20100526,22,4.681818181818182,102.04545454545455,2,1,1
A28OB1QLXN5BM6,"Karen Joan ""Siren""",20081103,46,4.478260869565218,333.4347826086956,607,85,522
A28P7V9KI7MXP,etcwhatever,20130217,48,4.770833333333333,165.60416666666666,62,3,59
A28PFY1B19HNKA,"Actmeister ""The Dougster!""",20060312,26,3.8461538461538463,194.53846153846155,195,14,181
A28PQWS9Z01FG3,M. Moreira,20030314,34,4.235294117647059,41.0,26,0,26
A28Q0JA9H8WZOD,Bichon Mom,20090715,25,4.48,211.88,953,46,907
A28RSMADFCBJDT,Pete Chen,20070110,56,4.053571428571429,160.55357142857142,105,21,84
A28RWJ08DPAKAI,Garrett G. Graham,20091124,31,3.774193548387097,93.45161290322581,50,15,35
A28S3Y2UYTP4XK,C. Conkey,20080604,25,4.68,40.28,13,3,10
A28TCUOTKTP8ID,"ppmd ""Professional""",20020828,21,4.809523809523809,57.285714285714285,66,2,64
A28THGTH733J7C,Xabier Granja,20090204,21,4.238095238095238,120.14285714285714,12,11,1
A28TWWUAWFVCTR,Never pay retail,20030622,40,3.975,233.625,74,37,37
A28UMA3GW9L124,Paul,20060709,133,3.56390977443609,186.09022556390977,578,127,451
A28VO2EWAADJ3N,"BooBoo ""BooBoo""",20110509,24,4.75,70.125,8,0,8
A28WEIBTTM21J1,MJNC367,20120726,29,4.482758620689655,270.6551724137931,76,7,69
A28X0LT2100RL1,Eusebius,20100816,53,4.339622641509434,157.0566037735849,60,2,58
A28X7NZ02016FO,eCognition,20071229,33,4.636363636363637,252.72727272727272,129,21,108
A28XZAPB7Y9RGW,Clyde R. Henderson,20100817,26,3.269230769230769,371.03846153846155,125,14,111
A28Y587UOB6VCS,Daniel Rich,20100325,23,5.0,78.1304347826087,3,2,1
A28YBL28P03P8V,Bradley Nelson,20081230,26,4.153846153846154,153.57692307692307,25,8,17
A28YMQH26AX2KN,Josh Jeffords,20091214,35,4.0,115.85714285714286,37,18,19
A28Z27JNHJK9Q3,Hyme Dagreat,20110930,35,3.9714285714285715,88.6,57,33,24
A28ZCI6F3R7TBV,BSprite,20120129,26,4.846153846153846,115.38461538461539,40,6,34
A28ZDVY6NV75P,"AZ Desert Rat ""movie buff""",20080310,42,4.380952380952381,94.07142857142857,341,29,312
A28ZNQA9A9VZNQ,"L. Bowman ""KC Photo & Video""",20130105,31,4.419354838709677,143.03225806451613,46,7,39
A290GZQ84UZQ5H,aquido,20111203,28,4.285714285714286,113.67857142857143,58,10,48
A291XTI6NO7DEG,"B. T. Denyer ""UX Designer""",20040423,43,4.5813953488372094,302.6511627906977,789,38,751
A292JUY8KQV3EB,A.,20110222,37,4.027027027027027,64.83783783783784,28,8,20
A292TRC6DX2GKK,Eric Capasso,20090305,30,4.466666666666667,131.33333333333334,18,12,6
A293HA28PN3VO4,":::DIGITAL BABE::: "":::DIGITAL BABE:::""",20080821,28,4.75,122.07142857142857,44,8,36
A2948QWE72VNMQ,S,20121127,32,3.84375,56.25,3,3,0
A294BKN913UOGP,"J. Moro ""JM""",20090211,45,4.733333333333333,311.0444444444444,362,42,320
A294CCMZDX3AKP,Janine,20080714,27,3.814814814814815,162.74074074074073,77,106,-29
A294SHLWPSG1BP,Ryan Winkleman,20100201,35,4.0285714285714285,624.1142857142858,198,32,166
A296QED1MV1V0J,"Dwegs ""Dwegs""",20120510,59,4.220338983050848,133.89830508474577,667,145,522
A297R44X7WEQ8T,Another opinion,20121019,21,4.380952380952381,43.523809523809526,4,2,2
A297Y763KFR9Y7,Juan,20130203,33,4.878787878787879,38.18181818181818,4,0,4
A298GL2D0BHGKZ,J. Fig.,20090909,52,4.173076923076923,301.86538461538464,261,47,214
A298Q3B5R3X54L,H. A. Syed,20080125,27,4.703703703703703,84.81481481481481,8,10,-2
A29B4PAIOL7HYG,"N. Caruso ""gibsonjunkie""",20021213,38,3.6315789473684212,163.89473684210526,61,45,16
A29BA6LLBLJILF,"Eric DiPier ""Life is a gift horse.""",20100807,22,4.090909090909091,178.77272727272728,27,8,19
A29E3ENX3ALT1L,rydvy,20100808,25,4.44,72.88,9,0,9
A29F8SWMZ27HRG,"Emmanuel ""ShutterMan""",20090606,21,3.8095238095238093,211.1904761904762,679,74,605
A29FO5HWPH9PKX,PB,20081117,31,4.161290322580645,243.03225806451613,98,23,75
A29FXD4BM20WWY,Gyong,20041004,40,2.8,103.475,134,85,49
A29GWIJL72GXXZ,Jon,20080308,49,3.9183673469387754,186.40816326530611,209,71,138
A29HHD1M6QPCWX,sr,20101226,21,4.428571428571429,43.0,11,3,8
A29HTPTAH1VKXL,B. Carr,20071207,34,4.676470588235294,161.97058823529412,101,9,92
A29IP2N2DSBH3T,Made Media Photography,20090905,42,3.5,36.214285714285715,48,39,9
A29IQP4FX164T1,Chris,20120326,22,4.818181818181818,46.95454545454545,2,1,1
A29JUMRL1US6YP,HTBK,20100512,23,4.391304347826087,225.30434782608697,38,7,31
A29JV3BCIGAIRK,buckaroo,20101030,22,4.909090909090909,46.45454545454545,5,2,3
A29KJ32G75L7G9,"Amazon Customer ""w7hd""",20091008,80,4.4875,45.2625,42,14,28
A29L0NIWBAGELM,Adam Van Pelt,20100516,22,3.8181818181818183,663.9090909090909,400,70,330
A29L25X4LFYYC0,david r,20121231,28,4.321428571428571,61.42857142857143,5,4,1
A29L9MHE4WG16O,Kevin Hersha,20061130,23,4.739130434782608,85.82608695652173,174,10,164
A29LIYLZJNL4TE,,20081210,25,4.0,247.92,243,32,211
A29LSNGSA44V4K,Magnolia Studios,20121210,22,4.454545454545454,36.22727272727273,2,1,1
A29OENZ57Q3C48,Ryan,20120603,22,4.636363636363637,50.31818181818182,3,3,0
A29OH3JI952QW3,"Dan Briggs ""woodworker""",20070717,25,2.68,57.8,27,78,-51
A29PBY10CGDKA0,"Mike From Mesa ""MikeFromMesa""",20091102,30,4.4,371.6333333333333,928,51,877
A29PE8R32252G5,garyedavidson,20120821,37,4.864864864864865,41.62162162162162,14,4,10
A29PQH8RIUG4KZ,hrbud,20001220,36,3.2222222222222223,143.77777777777777,400,95,305
A29PS21AMQQB9C,Modern Paleo,20110121,23,3.739130434782609,174.82608695652175,21,4,17
A29QCPFDSDNNKQ,Avert Inc,20080309,36,4.444444444444445,68.83333333333333,11,8,3
A29QXFY9SQKHXF,R. Fung,20120608,21,4.333333333333333,281.1904761904762,64,11,53
A29RHXL9SG6Y6Y,Shawn,20071203,36,4.416666666666667,229.86111111111111,175,29,146
A29RXL1I0SYJ63,Christian S.,20051021,22,2.9545454545454546,145.13636363636363,85,14,71
A29SJORCEI33OK,Jeffrey Zimmerman,20130301,27,4.703703703703703,36.333333333333336,10,1,9
A29TOZWK44675K,"Santos Dumont ""14-Bis""",20040527,30,3.9,104.33333333333333,79,29,50
A29UNXK7F3S93L,W. Hiratsuka,20091114,23,4.6521739130434785,115.56521739130434,31,7,24
A29VG90T649CSU,Sasha Q.,20090618,34,4.470588235294118,132.26470588235293,47,17,30
A29W3MFXS4JW3N,SyITec,20120622,24,4.75,133.0,18,0,18
A29WNPLQ83DZ4Z,Paul W. Borden,20110404,22,5.0,35.90909090909091,2,0,2
A29X08DG25ON03,W. Riggens,20101231,31,4.580645161290323,82.35483870967742,14,0,14
A29XK5H3AA5S01,"T. Cecchino ""Golf Nut""",20120901,41,4.829268292682927,27.75609756097561,2,5,-3
A2A0FBLKJN4ZY5,W. freeman,20090722,30,3.533333333333333,563.3666666666667,262,134,128
A2A1ZQMSPAX5B7,just me,20101119,22,4.5,104.13636363636364,8,3,5
A2A2M8EGBY2FV0,"Rudy ""rainmanva""",20040313,29,4.137931034482759,226.89655172413794,278,16,262
A2A37CA2585XG7,"Ruslan Moskalenko ""Ruslan Moskalenko""",20020726,21,4.761904761904762,245.23809523809524,961,50,911
A2A3B0JX2JRS6S,Dustan Dennington,20121103,24,4.625,40.708333333333336,8,1,7
A2A3HMUOLB1IZB,Casper,20130529,26,4.269230769230769,55.34615384615385,7,1,6
A2A4X545ERLS7H,Edward Streiff,20100128,56,4.321428571428571,93.26785714285714,19,8,11
A2A6E98JMFLIWU,K. Yi,20090131,32,1.9375,144.96875,160,1546,-1386
A2A6G52JG3IS0Z,J. Carter,20070511,38,4.131578947368421,80.52631578947368,35,13,22
A2A790WB73RIVB,David Burkhart,20120120,22,4.045454545454546,180.1818181818182,38,1,37
A2A7KXM9B4XW90,"Oslek ""Amazon all the way!""",20071214,32,4.09375,61.875,39,16,23
A2A7RLHAZYVAE2,Larry Cody,20100414,22,4.409090909090909,37.90909090909091,6,3,3
A2A8IY4GTR7GWQ,Azu~Nyan,20090917,27,3.740740740740741,176.4814814814815,47,20,27
A2A8ZU5ZIQU1HV,R. Reed,20060224,35,4.371428571428571,198.8,97,7,90
A2AA3MND6ED8TM,Robert Gardner,20070922,21,3.761904761904762,58.095238095238095,26,43,-17
A2AAB4Y69I91Y0,Dan Whetzel,20110824,24,3.7083333333333335,58.916666666666664,22,7,15
A2AAOTWCPRFYYT,"Schuylercat ""Schuylercat""",20070224,31,3.935483870967742,150.0,253,49,204
A2ABBO6U73VRZ4,DrewH,20131102,23,4.826086956521739,70.26086956521739,14,1,13
A2AC6GQ24S45GA,Patrick O,20070922,57,4.43859649122807,393.2631578947368,746,77,669
A2ACJ55JHHJ3FU,Amazon Customer,20030422,24,4.25,363.3333333333333,123,22,101
A2AD3YB13PUDGU,Doug Boreland,20121202,28,4.428571428571429,66.07142857142857,8,1,7
A2AE973BDA0415,james,20110208,25,4.36,44.48,120,17,103
A2AEVZY5XASNE6,Ricardo A. S. Batista,20070111,21,4.761904761904762,62.095238095238095,30,21,9
A2AEZQ3DGBBLPR,Ragnar Danneskjld,20010728,57,3.3684210526315788,116.75438596491227,530,166,364
A2AF0ISXVVB6SP,planetmike,20100105,25,4.52,68.88,12,4,8
A2AF0NOCM71J0B,"G. Cox ""Shanghaied""",20071231,102,4.578431372549019,269.4117647058824,464,134,330
A2AFTRU43PY9P5,"P. Triana ""Pete""",20090513,46,4.6521739130434785,52.0,29,7,22
A2AG7SZRA78F04,"R. V. Cadena ""Arkantos""",20100616,28,4.678571428571429,39.07142857142857,163,11,152
A2AGFIECS7XZ90,ronjon,20100626,22,4.818181818181818,33.18181818181818,2,2,0
A2AGFZRQI1BZMV,Homer L. Arment,20130701,27,4.0,68.51851851851852,3,2,1
A2AGU27KHDIMR,"DrLee ""PharmD/MD2B""",20060509,22,4.045454545454546,252.1818181818182,88,13,75
A2AHTUMQC1O3M8,"Glenn Wagstaff ""GBW""",20100821,23,4.086956521739131,53.82608695652174,18,4,14
A2AINLLX0560S1,Graydon Blair,20100915,26,4.153846153846154,317.1923076923077,28,3,25
A2AIQYXKN9V80L,BD King,20081128,38,3.736842105263158,91.02631578947368,45,17,28
A2AL3G901ZFFVE,"Music Man ""Aficianado""",20060530,27,4.518518518518518,77.14814814814815,36,10,26
A2ALA1RT2C1MTO,Chris M,20120530,43,4.5813953488372094,65.46511627906976,5,5,0
A2ALRZ0ENQLYY5,Jon,20110407,55,4.6909090909090905,106.45454545454545,42,4,38
A2ALX5U55NTGTL,"Danny Boy ""Danny Boy""",20060110,46,4.760869565217392,138.06521739130434,47,31,16
A2AM9IPXQKNO8L,Boris,20110728,40,4.725,57.15,33,11,22
A2AMTEB5UZEOXE,"Kelly ""Cat lover""",20070826,25,4.12,144.88,18,12,6
A2ANICQ82D7RJV,rshackle,20071230,29,4.9655172413793105,62.689655172413794,20,4,16
A2AOBXQDUI3M18,T.Key,20120201,30,4.233333333333333,90.76666666666667,8,2,6
A2AOW20EGSCAY2,C. A. Boswell,20081011,31,4.709677419354839,101.80645161290323,45,14,31
A2APYRZ8SAVAIQ,"Dan S. Tong ""avid SF reader""",20090119,28,4.142857142857143,235.21428571428572,159,5,154
A2AQK72ZFPKQJI,Diana Lorena Delgado,20121216,21,4.857142857142857,27.61904761904762,2,3,-1
A2AQSV7K5FEXHK,Anna Gregov,20130514,22,5.0,21.772727272727273,2,1,1
A2ARDVMUGDFED6,MiRSD,20070323,121,4.338842975206612,533.8347107438017,2797,137,2660
A2ARKEEDO6679D,Michael T,20050625,40,4.525,87.725,171,43,128
A2ASNOYJJ8RLIQ,Mens Sana,20050824,21,4.428571428571429,83.71428571428571,70,14,56
A2ASP462CGXSMN,DixitS,20090216,39,4.461538461538462,102.28205128205128,101,26,75
A2ASURKS0UQK6B,TheKewlOne17,20140430,24,1.5416666666666667,153.08333333333334,9,5,4
A2AT0Z19QMMZ06,"Steven E. Colburn ""Steve C""",20130824,22,4.7272727272727275,122.72727272727273,7,4,3
A2AT71MXCGDTT3,Howard L. Gault,20120419,40,4.8,92.2,26,7,19
A2ATXVDSRI1WLO,Scott H.,20111207,21,3.4761904761904763,113.76190476190476,15,9,6
A2AVGSWVV7FDRQ,"J. Morris ""photo_jeff""",20020430,27,4.148148148148148,210.44444444444446,114,14,100
A2AVMEB8PQOTTE,,20101215,30,4.933333333333334,100.53333333333333,25,33,-8
A2AVYTX2ZCZNX5,"A. Dezutter ""Grey Rider""",20130120,21,3.9523809523809526,99.71428571428571,30,7,23
A2AW7N8CAP381R,Bob L. Williamson,20070104,27,4.7407407407407405,24.88888888888889,9,28,-19
A2AWAUSQ2ZIZU,Jeff Martens,20040921,21,2.9523809523809526,104.95238095238095,139,27,112
A2AWSHXOW9U2PQ,An Honest Engineer,20120105,26,4.076923076923077,114.8076923076923,23,14,9
A2AWVROFGSZU4E,My Fake Name,20071113,28,3.642857142857143,855.6785714285714,70,84,-14
A2AX2UGB167J31,"justin dysart ""Justin""",20130719,56,4.785714285714286,57.75,21,2,19
A2AXKUSM1SB5BD,"N. Mashmoor ""iko""",20091212,21,4.095238095238095,119.52380952380952,22,16,6
A2AXN1I18XIP72,Diesel Ness,20110801,24,4.125,61.0,21,12,9
A2AXRINZGFJIEE,"EleganzShopper ""EleganzShopper""",20100214,25,4.76,145.84,60,3,57
A2AXWQVA5V9GPJ,A. Benenson,20070626,27,3.3333333333333335,253.74074074074073,141,19,122
A2AY4YUOX2N1BQ,Ciaran,20091210,228,4.5701754385964914,339.92543859649123,3223,153,3070
A2AYEZ8NP2SS25,Amazon Customer,20131108,22,4.863636363636363,50.18181818181818,15,5,10
A2AYJSMMTWMVL0,"JC Customs ""Vinyl Solutions""",20110908,25,4.8,77.64,5,1,4
A2AZWCITJKQMWA,Ward,20121216,21,4.0,57.42857142857143,10,1,9
A2AZXU0QBSR2P9,Zac,20091219,21,3.6666666666666665,560.6666666666666,104,16,88
A2B0VVPQ2LFR36,"Michael Z ""Remnantman""",20070922,22,4.909090909090909,252.9090909090909,102,12,90
A2B3CIEV3SW6EG,"Michael E. McGown ""mmcgown""",20070916,36,3.1944444444444446,178.97222222222223,154,65,89
A2B46SV9H0FIZ4,FLOWERPOWERMD,20130114,43,4.558139534883721,57.81395348837209,13,9,4
A2B54000WDS6D2,J. Johnston,20100505,29,4.241379310344827,164.72413793103448,64,9,55
A2B5RVOAEPEDLH,"Stan57 ""Stan57""",20140202,24,4.916666666666667,38.083333333333336,1,0,1
A2B6LR4IRRPYXF,AZ Mutley,20070824,24,4.166666666666667,205.83333333333334,211,29,182
A2B7232N5XAOGO,"D. Sausa ""Investing Without Losing author""",20070913,25,4.0,82.2,120,19,101
A2B73MUGLPB65O,Bart J. Schuck,20080530,26,4.230769230769231,149.96153846153845,88,7,81
A2B7BUH8834Y6M,"Shelley Gammon ""Geek""",20010816,115,4.452173913043478,293.8086956521739,1604,222,1382
A2B7QM5GSQ0MFR,Jorge Roman,20050920,23,3.739130434782609,59.69565217391305,20,23,-3
A2B7VX6R4YVCXM,BX5 Fan,20080303,22,3.272727272727273,115.9090909090909,13,8,5
A2B8GXSCB1R05T,Zack Davisson,20080611,38,4.157894736842105,287.2894736842105,308,51,257
A2B8R96NNS8H8E,pseudosavant,20090813,25,4.16,103.04,31,14,17
A2B95D7YB0VWVU,Eric B.,20130428,23,3.869565217391304,68.30434782608695,5,4,1
A2BA2TH39PLLTQ,Peregate,20070717,24,4.791666666666667,119.95833333333333,30,3,27
A2BAAKZHSUGCDP,"Jill Clardy ""So many books, so little time....""",20100925,36,4.861111111111111,278.0833333333333,52,7,45
A2BB4DGBRVGKWW,"A Customer ""customer12345657""",20050618,22,3.5454545454545454,283.72727272727275,593,31,562
A2BCB516A8HV6K,Greg Michaels,20120909,40,4.975,57.85,24,1,23
A2BCDZO1XQLDH,R. Lanthier,20020108,61,3.9508196721311477,172.14754098360655,1104,164,940
A2BCE305MUUP8R,"MiraclesMan ""Mark""",20081102,24,4.333333333333333,277.5833333333333,63,18,45
A2BEHJMCLCXR10,J. Phillips,20091208,24,4.041666666666667,79.79166666666667,12,17,-5
A2BGDI7RRK6YJ5,"M. Smith ""Weird ear""",20091117,22,3.1363636363636362,88.04545454545455,3,6,-3
A2BGEAETT7XL21,Tom,20100321,21,4.0476190476190474,421.3333333333333,219,20,199
A2BGLAUV7ZA3U,Junster,20100414,27,4.851851851851852,109.70370370370371,26,2,24
A2BGZ52M908MJY,ira_nyc,20010206,22,3.909090909090909,126.5,468,100,368
A2BH04B9G9LOYA,Alex P.,20011118,30,3.6333333333333333,181.93333333333334,196,29,167
A2BH9DHKBIBDX3,J. Crisler,20101204,29,4.448275862068965,47.689655172413794,18,3,15
A2BIAZVVPAEB9U,Well Read,20110628,25,4.72,137.8,22,2,20
A2BIJMB2BITQUM,James Ridgway,20021104,55,4.363636363636363,172.8,348,95,253
A2BJ9I0BQ1LH5S,guitarchick24,20060327,34,3.8823529411764706,98.41176470588235,80,12,68
A2BJBAHPEN0FZF,"Carlos Duarte ""Carlos L Duarte""",20070116,21,4.761904761904762,98.33333333333333,37,15,22
A2BL7H1OKLIAGF,"R. Workman ""Grizzrob""",20091012,28,3.4642857142857144,73.75,23,4,19
A2BLFCOPSMBOZ9,Dave Edmiston,20080412,159,4.138364779874214,281.75471698113205,1080,80,1000
A2BLGCXUR8IT79,Tech Reader,20080923,23,3.9565217391304346,235.0,46,5,41
A2BLITJITO97N5,Ingalls,20031215,31,4.387096774193548,203.25806451612902,1024,87,937
A2BLR3DOSX0QTA,Brian Bear,20110516,22,4.545454545454546,40.68181818181818,16,3,13
A2BLXHZADILNL3,Misa,20110914,34,4.529411764705882,70.3529411764706,9,2,7
A2BMZRO0H7TFCS,Ed,20020419,189,3.9682539682539684,540.1534391534392,5869,477,5392
A2BN9DIBP9A0XG,D. Vance,20110120,32,4.0625,107.1875,35,14,21
A2BRH62ZMFNS1G,"Gemmer ""nitedawg""",20090904,28,4.285714285714286,103.21428571428571,260,34,226
A2BUQ240COLAOP,Dave from Tacoma,20070527,45,4.2444444444444445,129.64444444444445,184,20,164
A2BV6D29EIY9MY,Mom2boys,20120427,24,4.208333333333333,79.25,21,3,18
A2BVOBG7YDSVOZ,"R. Padilla ""RMP""",20010724,27,3.888888888888889,189.4814814814815,248,40,208
A2BVV8ND8Q6S6A,adero1780,20130111,39,4.564102564102564,40.97435897435897,7,4,3
A2BX8DDQGCCG2J,MWebb,20091030,91,4.714285714285714,651.3076923076923,4428,241,4187
A2BX8GOW35YWV1,James Rose,20040831,29,4.379310344827586,210.82758620689654,326,37,289
A2BYFGD27QAIOG,Lee,20110324,22,3.909090909090909,423.77272727272725,83,20,63
A2BYV7S1QP2YIG,"Dr. Oceanfront ""Oceanfront""",20110610,120,4.666666666666667,146.46666666666667,766,20,746
A2BYYAC37POD57,Tech Lover 6969,20110209,26,4.076923076923077,51.11538461538461,14,24,-10
A2BZ16RKE13PKV,ShannonAnna,20081214,36,4.388888888888889,148.75,29,20,9
A2C1Y5F8DE9H6P,"Clann Mother ""Clan Mother""",20090126,36,4.666666666666667,111.5,34,7,27
A2C264HY1HHZVX,"Nicholas M. Folts ""Nikk""",20070306,24,3.8333333333333335,82.45833333333333,51,16,35
A2C352EB1Z0PZK,"q256 ""Richie""",20100602,21,4.0476190476190474,100.80952380952381,10,9,1
A2C3A5EFYIIKOM,Liliana,20121218,21,4.380952380952381,115.33333333333333,14,6,8
A2C3IUNCJEWKZ5,Emmett82,20121113,31,4.354838709677419,24.387096774193548,9,10,-1
A2C4FZCY8A6W6M,R. A. Myers,20070627,26,4.576923076923077,35.0,16,6,10
A2C4R3MYEN97GK,Gerardo C. Guzman Lozano,20051025,29,4.517241379310345,52.6551724137931,89,87,2
A2C5LCVTHITXFY,"Grippy ""WR""",20081227,23,4.173913043478261,105.82608695652173,10,6,4
A2C66ZWC2V5FES,Grace G,20111209,21,3.8095238095238093,86.19047619047619,9,0,9
A2C6MCD8DTHR7O,dantheman,20130121,23,4.217391304347826,28.217391304347824,8,5,3
A2C7D65XX6K2OD,"David J. Thompson ""Shop Geek""",20070705,27,4.481481481481482,58.851851851851855,29,9,20
A2C7F0SCPDT0WQ,J. Dauntless,20060301,29,4.137931034482759,105.03448275862068,119,8,111
A2C8I2RQ0WG940,Honest-Abe,20100620,27,3.111111111111111,82.66666666666667,48,56,-8
A2C9ZOF0R2JQTO,Objective1,20111226,25,3.88,173.8,41,9,32
A2CBZMETQJTNEE,"fdoamerica ""fdoamerica""",20051226,28,2.5,128.17857142857142,308,59,249
A2CCN79NZT5PKM,MyLastSong,20130701,24,4.583333333333333,71.33333333333333,2,1,1
A2CDEOM9RZMI74,Archie,20120430,35,4.571428571428571,136.31428571428572,25,11,14
A2CDMX49G757H3,D. Goolsby,20080331,30,4.5,152.0,118,10,108
A2CEXG5KTTSW10,M. Bose,20081016,26,4.730769230769231,105.53846153846153,62,19,43
A2CF4NGV5Z1TKU,Steve G,20040904,32,3.8125,141.3125,146,24,122
A2CG0LVSIKV8AZ,J. Kersh,20100130,22,4.181818181818182,88.81818181818181,11,3,8
A2CGL6SJXR0A2D,Scott B,20101002,24,3.8333333333333335,73.375,400,18,382
A2CIMOITO2S0ZY,Stanley Fu,20090324,28,4.428571428571429,241.03571428571428,842,106,736
A2CIQEY05SPHTZ,"Michael Countryman ""mike the camera man""",20070829,67,4.0,223.44776119402985,180,60,120
A2CJVQQT09MRDX,Jimmy,20091102,23,3.782608695652174,63.30434782608695,33,9,24
A2CKDAXQSU7Z9D,oi101,20120113,26,4.730769230769231,30.615384615384617,2,3,-1
A2CL818RN52NWN,stewart  L,20051023,29,4.448275862068965,89.37931034482759,296,57,239
A2CLRN5A3XR0J7,Rickford911,20120429,26,5.0,64.57692307692308,14,6,8
A2CM17ODJY6WZ7,Dennis Renfro,20100205,27,4.7407407407407405,130.59259259259258,65,7,58
A2CN2OZ855BXIK,Max,20070628,21,4.761904761904762,105.57142857142857,56,10,46
A2CNXS86JY4JV4,"DP ""DP""",20130218,33,4.515151515151516,54.54545454545455,9,3,6
A2COBKZZN2AYPT,kpin,20120217,21,4.285714285714286,43.61904761904762,7,2,5
A2CORJXW6VMIPZ,Philip B. Davison,20101022,24,4.666666666666667,115.875,33,2,31
A2CPP7BZKOF9TP,R Zimmer,20120328,50,4.62,78.42,13,2,11
A2CPTH3C7XTHPM,ViolentMetaphor,20110421,35,4.714285714285714,125.0,7,7,0
A2CPWZ4KCQHN6M,mac,20111206,28,4.214285714285714,28.035714285714285,12,1,11
A2CQR1RP0QHY7F,Robert Nilsen,20080908,31,4.741935483870968,43.483870967741936,21,12,9
A2CRF098PBFCLK,Dakota H.,20110804,24,4.416666666666667,51.875,13,4,9
A2CRIQOX1SYA3I,C. Taylor,20110616,31,4.193548387096774,124.35483870967742,19,8,11
A2CUZZ2TBBSJ7H,"Marcoz C ""MC""",20110204,32,4.59375,50.46875,8,8,0
A2CV33795L4KHH,A. Davis,20060209,32,4.40625,251.125,623,44,579
A2CVGAHIPK8HJT,Amazon Customer,20110604,29,4.0,81.27586206896552,15,3,12
A2CVXUY1EYQGGA,Bobbewig,20080101,29,4.344827586206897,231.48275862068965,301,24,277
A2CW9GKMNFAU6R,Handyman,20090904,25,4.16,129.96,245,26,219
A2CWIYIETNBAK3,Michael Birman,20071012,53,4.547169811320755,348.33962264150944,301,66,235
A2CWUM49ZWMGEY,Clubbby,20120212,42,4.523809523809524,115.52380952380952,29,2,27
A2CX2UB1V5FCB0,Thomas Lecoq,20121031,27,4.481481481481482,57.074074074074076,6,1,5
A2CYJUFYK4JKNP,john d,20120605,27,4.148148148148148,23.555555555555557,7,23,-16
A2CZ01RAAY5VTK,,20130130,21,4.571428571428571,45.80952380952381,8,3,5
A2CZ98V784SRJ0,L. Perry,20100306,27,4.185185185185185,122.66666666666667,31,21,10
A2CZDT27T36DBB,"Ricardo Oliveira ""RSO""",20090904,30,4.466666666666667,30.566666666666666,11,3,8
A2CZLJ6W1AUJZM,Victor Johnson,20111027,29,4.241379310344827,51.3448275862069,28,2,26
A2CZOVFIJL99OB,R. Gibby,20080619,25,4.56,62.52,9,3,6
A2D0B515XVVRH7,"Frank Furter ""lawnboy4536""",20110628,34,4.382352941176471,36.5,15,6,9
A2D0CM6SAMN31R,Randall G. Rich,20060223,31,4.612903225806452,51.064516129032256,71,16,55
A2D0CO1OA6DSWY,Gil,20100103,50,4.4,209.74,167,20,147
A2D0MFG4FSOYUJ,Kevin M. Hubbard,20040101,22,3.772727272727273,136.1818181818182,109,29,80
A2D1LPEUCTNT8X,Ali Julia,20100928,95,4.484210526315789,383.0315789473684,308,7,301
A2D1MRAEQD5FVH,Sean R.,20120710,30,4.466666666666667,43.666666666666664,22,4,18
A2D1ZQEFS1NBH2,"David Washington ""little dave""",20060908,78,4.243589743589744,87.17948717948718,134,58,76
A2D25ROXJ9BGUF,"xgrep ""xgrep""",20080423,26,4.1923076923076925,331.38461538461536,94,25,69
A2D2YF5XS1G8V3,"Setter Dog ""Jack""",20080223,33,4.7272727272727275,165.15151515151516,159,7,152
A2D37EEIG4K2VA,Virtue,20121206,28,4.714285714285714,47.857142857142854,4,0,4
A2D3N6RSLPTU10,"Amazon texas shopper ""Amazon shopper""",20091111,21,3.142857142857143,92.14285714285714,74,35,39
A2D44C448RSL1Z,"Paul E. Seals ""Lunasdude""",20091201,30,4.566666666666666,72.36666666666666,104,14,90
A2D4615GLTXCIT,Extremely Satisfied with Pink Moose Company,20121212,22,4.545454545454546,69.27272727272727,8,2,6
A2D4YAAIJI2PEZ,"Mr. Stunner ""Stunner""",20070705,27,3.925925925925926,56.03703703703704,19,7,12
A2D55MIJHJR67S,"M. HAYCRAFT ""mdbicycleman""",20100120,23,4.0,113.52173913043478,16,3,13
A2D77SR2EP3U7Q,KS DEED,20130627,22,4.5,81.81818181818181,26,6,20
A2D7B5I7ZQ51XL,Anthony Pittore,20100107,21,3.4761904761904763,153.38095238095238,17,13,4
A2D7OBHVA6SFJZ,Amazon Customer,20120203,21,4.9523809523809526,109.42857142857143,14,1,13
A2D8RTOXBEEF2Q,William L Grimm,20110507,24,4.041666666666667,25.375,2,14,-12
A2D9DSJIH4FRMC,S. Vogt,20100803,41,4.365853658536586,457.2926829268293,2773,137,2636
A2D9VD96W8PADC,"Thomas W. Jones ""PC man""",20130730,24,4.0,30.458333333333332,2,4,-2
A2DA2NJZ2RIYAB,M. Brown,20110519,36,4.805555555555555,53.611111111111114,9,11,-2
A2DBCMB95OXWFG,RWL,20111116,31,4.612903225806452,44.45161290322581,16,10,6
A2DCE0ENI3RZ29,"Toshi Yamioka ""Toshi""",20110131,33,4.606060606060606,160.87878787878788,169,29,140
A2DDF8NAREKGAF,William J. Kelly,20091128,29,4.793103448275862,54.44827586206897,13,4,9
A2DDPEYPS4MVO0,Reviewer  #5,20120206,23,4.6521739130434785,57.0,9,0,9
A2DF62DP20RIXF,"M. R. Simmons ""Techie""",20041112,48,3.8958333333333335,383.3541666666667,315,30,285
A2DFM26VLNVYNY,"Homer ""consumer""",20080130,29,4.551724137931035,157.48275862068965,96,21,75
A2DG63DN704LOI,Eric Slay,20090130,106,4.481132075471698,219.21698113207546,1941,170,1771
A2DGP3CC6D0TKL,paparazzi83,20030114,29,3.7586206896551726,109.79310344827586,99,33,66
A2DHHUN5URIODB,"C. Decker ""Team Louish""",20100502,28,4.321428571428571,58.285714285714285,26,15,11
A2DI61Z9U4L5MT,"D. B. Gore ""IT guy""",20080614,29,4.620689655172414,195.0,469,23,446
A2DIQTZPF26T1L,M. Nichols,20100228,54,4.611111111111111,174.9814814814815,87,27,60
A2DJFYBB2L5VSN,UniversityDoc,20090805,42,4.5,179.54761904761904,44,7,37
A2DKQQIZ793AV5,Twister,20130413,59,5.0,767.6271186440678,668,78,590
A2DLH2L00JK3NJ,"J. Doyle ""Power User""",20100716,21,4.571428571428571,136.9047619047619,75,5,70
A2DLK5KEQU4TX9,KB7RKY,20120206,32,4.46875,134.28125,57,11,46
A2DN7RUNX06BZ1,nychen,20000927,24,4.083333333333333,327.9166666666667,93,16,77
A2DNTJYRT6XRU4,Desert CatMom,20080809,31,4.903225806451613,59.25806451612903,13,1,12
A2DO0R87H16CN3,Paul M. St John,20080322,23,4.478260869565218,69.65217391304348,14,17,-3
A2DOKI3HUPALWE,A. Noid,20081030,24,4.125,104.0,81,4,77
A2DQGD2M6EZRS6,JJ,20050114,35,4.142857142857143,108.34285714285714,168,32,136
A2DQVO87OFSLCP,peb,20090224,25,4.08,164.76,55,9,46
A2DRYHBYLO5S8T,E. Moscato,20050807,43,4.372093023255814,350.3953488372093,237,28,209
A2DS9DLMSU2M2Z,"txmikey ""Tx Mikey""",20081019,54,4.611111111111111,79.16666666666667,40,8,32
A2DSB3556MW53N,"Tom C. Chen ""tom in califonia""",20060628,29,4.517241379310345,55.724137931034484,16,5,11
A2DSN56RQA699G,Matt,20091214,25,4.8,110.08,32,5,27
A2DSNWWXBEWHMV,"Stephen Quinn ""Unclezeebie""",20020707,27,4.074074074074074,63.44444444444444,17,9,8
A2DTRR9SEAT878,Yo' Vinny,20070109,25,4.6,110.52,146,35,111
A2DTZUZK9YRJVK,clearanceman,20070106,27,4.407407407407407,92.11111111111111,55,7,48
A2DUJJEXQP8FOJ,"G. Ramirez ""G-Mo""",20070827,30,4.466666666666667,60.46666666666667,54,36,18
A2DUYUBT3E3HGR,,20130124,21,3.3333333333333335,52.333333333333336,16,6,10
A2DVBBARHJIW9J,KCinDC76,20081227,29,4.413793103448276,160.89655172413794,174,28,146
A2DVC8HR1BVTEB,STEVEN STEIGER,20130202,25,4.0,53.4,4,11,-7
A2DVEJ33QVVQ1Z,D. Ortego,20070719,27,4.62962962962963,138.96296296296296,35,3,32
A2DVFWJBVOEHUO,michael paniagua,20101130,22,4.0,285.3181818181818,43,23,20
A2DXENZNO2JT4F,"Sam Stone ""Sam Stone""",20020105,53,4.3584905660377355,163.16981132075472,270,31,239
A2DYMDOAJURO5F,"Aceto ""All Knowledge is Sorrow""",20090415,41,4.121951219512195,358.8780487804878,163,45,118
A2E0FAQGKT8HV4,SKOOTERBUM,20130110,23,4.391304347826087,58.21739130434783,36,5,31
A2E0HOFVNJ0GWL,Steve,20130102,22,4.136363636363637,73.77272727272727,6,0,6
A2E0TJ49NACDBA,DelusionalAngel,20100223,25,3.92,260.16,15,19,-4
A2E1EFNIZL2FVA,&#9899;   RIZZO   &#9899;,20080219,55,4.509090909090909,177.8909090909091,109,40,69
A2E1OU9011O1KE,Steve H.,20090116,23,3.9130434782608696,191.2608695652174,88,7,81
A2E1VIZWXSNGM9,MacMike,20041217,21,4.333333333333333,174.14285714285714,21,9,12
A2E1XXNLTHKFTO,Neal J. Elward,20090303,21,4.190476190476191,68.71428571428571,8,2,6
A2E24PEUR40NKW,Karl,20101204,23,4.521739130434782,227.8695652173913,53,5,48
A2E3V9CPOOK4KN,T. Borgstadt,20110219,25,4.8,64.36,5,1,4
A2E44CGMHKBRQ9,W. BrennanDubbs,20100201,29,4.137931034482759,110.06896551724138,20,4,16
A2E4MZXFXIWZTB,Mahor!,20130124,29,4.689655172413793,104.72413793103448,2,5,-3
A2E4PFVGSQUH8K,RM,20081024,23,4.869565217391305,151.1304347826087,40,3,37
A2E4Z216B8LFLZ,LE,20040522,22,2.9545454545454546,103.13636363636364,148,55,93
A2E6AHFDJ3JBAZ,robosolo,20080918,29,4.310344827586207,105.51724137931035,44,10,34
A2E6G7SEKRAF5A,D. Brinkley,20060204,21,4.238095238095238,235.95238095238096,110,26,84
A2E6IBAW9VRW4A,Engineer,20090215,26,3.8461538461538463,131.6153846153846,17,11,6
A2E6PWPHTD2JMG,John S,20121101,28,4.857142857142857,115.35714285714286,12,5,7
A2E7CF67MQ982Q,Yuva,20110510,27,4.62962962962963,108.03703703703704,60,9,51
A2E82QT2WB1BZ9,Matt David,20100701,24,3.25,193.83333333333334,26,25,1
A2E8FKPFV98B8T,myst,20090125,32,4.09375,89.5,16,8,8
A2E95ZZNAQ24GS,"Amazon Customer ""mikeklement.com""",20070927,29,4.310344827586207,48.827586206896555,10,3,7
A2EB4X07KFT1P9,R. Young,20110328,33,4.333333333333333,28.0,5,10,-5
A2EC3UBQ9TB89F,"Clinton Cook ""Professional Geek""",20071103,22,4.409090909090909,172.36363636363637,18,9,9
A2ED50E3KWKUKW,"KEN TELLS ALL ""Perfectionist""",20061022,55,4.745454545454545,178.54545454545453,163,64,99
A2EDTVVR9IFNLW,Doug Hibbard,20110603,37,3.7837837837837838,304.3243243243243,283,39,244
A2EDWI5EGP4V9N,sharkychick,20061114,26,4.615384615384615,245.80769230769232,373,15,358
A2EF1KIQ7TMPPF,"Nitty's Mom ""Dog lover""",20110622,25,4.64,194.28,172,14,158
A2EF49XMAVBR65,"Gadget Gizmo Freak ""Gadgetfreak""",20091130,32,3.1875,112.90625,184,95,89
A2EF8N7ZE7ONWX,"Snap, Crackle and Pop",20020605,62,4.096774193548387,520.8548387096774,3238,129,3109
A2EG6PT45NLSJ1,J.,20130816,21,3.857142857142857,52.57142857142857,4,0,4
A2EGVV7O4CEOIT,Max Hughes,20130327,32,4.90625,67.8125,14,7,7
A2EHYCA29NSQLU,Bud,20051001,49,2.4489795918367347,258.40816326530614,526,99,427
A2EL5GW6B8LWQB,"Bill W ""Bill W""",20070511,21,2.7142857142857144,95.19047619047619,52,41,11
A2ELKOZRB1JY8U,"W. J. Henderson ""world traveler""",20081130,29,4.689655172413793,62.172413793103445,11,4,7
A2EMM9HWOSY2Q5,Jemmie Wang,20010116,27,4.592592592592593,69.25925925925925,24,5,19
A2EMQB1VX2YFW6,"Ol' Dan ""ExTexan""",20090206,21,3.8095238095238093,200.61904761904762,23,6,17
A2EMUM49CE0JV4,"Mark S. Mocarski ""VideoFan""",20091012,46,4.760869565217392,98.17391304347827,25,26,-1
A2EN82VBJT44QP,"Bob DUMON ""Bob D.""",20090415,77,4.48051948051948,111.79220779220779,97,18,79
A2ENA7P3RSBF5N,mac1950,20120328,29,4.413793103448276,95.37931034482759,20,14,6
A2ENBKGI9TI7DX,"Amazon Customer ""crazy cat lady""",20070907,34,4.970588235294118,82.79411764705883,12,4,8
A2EOLXPGVSYTY8,"Aaron Moore ""Aaron""",20130630,36,4.75,25.72222222222222,5,2,3
A2EPAYNDFCUKVL,"Gary G. Russell ""ggrussell""",20120430,24,4.666666666666667,67.58333333333333,51,4,47
A2EPVLDHV7NX4R,"Michael Shreve ""Mike Shreve""",20130123,23,4.217391304347826,27.869565217391305,4,0,4
A2EQ0QDOSGH6AC,"Matthew Agnese ""Matt""",20120112,21,4.619047619047619,106.52380952380952,12,1,11
A2ER8G4JJJ7XER,Jeffrey Morse,20030914,35,4.057142857142857,187.85714285714286,156,28,128
A2ER9SRSFRM5IO,Glenn Campbell Jr.,20090201,28,4.821428571428571,98.07142857142857,87,8,79
A2EV399NUQW9AJ,Ray I,20130520,21,4.619047619047619,84.42857142857143,15,8,7
A2EV4250MPLXLK,Kalaab M. Pickering,20110103,41,3.975609756097561,310.390243902439,422,15,407
A2EV8A4U0VAKQ3,"Joe P. of Pennsylvania ""JP""",20090607,21,4.523809523809524,49.714285714285715,5,2,3
A2EW01G2LNJN06,"Z. Mehrbach ""Zach""",20121119,61,4.557377049180328,200.4262295081967,169,19,150
A2EW5HKLL0HUS1,Jim Murphy,20050920,35,4.885714285714286,72.2,22,3,19
A2EXR5YN1OKTOS,The Yeknod,20110820,32,4.4375,136.15625,31,3,28
A2EYO7D7R8SNNC,Rabinzero,20070302,32,4.6875,101.5625,20,5,15
A2EYVLDGH8OJZB,Robert Cozzi,20051024,40,4.075,276.575,1156,151,1005
A2EZBKKBVLNXQ4,kyldh,20120913,22,4.454545454545454,156.45454545454547,20,9,11
A2EZTM9WY5B5IL,Frank J. DeFelice,20060504,59,3.694915254237288,61.69491525423729,83,154,-71
A2F050JSV0QJB0,A. Freitas,20090505,23,4.0,71.17391304347827,30,3,27
A2F0E69BAX0T0T,Dan Leithauser,20070826,34,4.205882352941177,638.2058823529412,415,54,361
A2F0MX3FT66GL1,lpedreros,20120718,25,3.92,52.28,15,8,7
A2F0POG1KOAP5J,"Jorge Gomez ""jl""",20100109,22,4.0,67.0,29,12,17
A2F0XN0L5K7N0T,Jerry,20131231,21,4.0476190476190474,5.761904761904762,1,1,0
A2F1P10GGZ7K2T,Erik1988,20051024,41,3.707317073170732,269.6585365853659,152,36,116
A2F25UERHUS5RV,"PAF ""Jalopedro""",20011213,23,4.130434782608695,186.2173913043478,122,12,110
A2F2F7N94SR1KQ,"Razornoodle ""Razornoodle""",20110617,54,4.203703703703703,82.44444444444444,22,11,11
A2F2GLVFRNV7JJ,Marilyn Armstrong,20101002,62,4.483870967741935,169.1451612903226,675,99,576
A2F2L9SO2SVHPB,Tomgadgets,20110518,23,4.434782608695652,206.43478260869566,306,20,286
A2F2S1L61X1LA9,"Bromptonboy ""Bromptonboy""",20051017,36,4.833333333333333,117.27777777777777,40,7,33
A2F30TRZIIDMXY,"Joshua D. Washburn ""jwashbur""",20090531,31,4.516129032258065,117.41935483870968,104,13,91
A2F4HP0J5VNOYR,Gauteng,20080302,45,4.5777777777777775,173.44444444444446,197,12,185
A2F6NONFUDB6UK,Malvin,20091002,26,4.6923076923076925,202.92307692307693,78,37,41
A2F6QBIXYJGQS5,PA,20100828,24,4.083333333333333,57.833333333333336,40,8,32
A2F7CSE6KT7NI4,Dougie Fresh,20061218,90,4.155555555555556,344.05555555555554,395,51,344
A2F7E9LKWUVJ20,Saxman642,20040528,22,4.5,155.6818181818182,324,10,314
A2F7MX6U5J42BO,SWY11389,20131108,30,4.133333333333334,49.46666666666667,6,1,5
A2F92M62KN324B,Kapitalist,20080508,49,4.183673469387755,74.12244897959184,52,22,30
A2FA749WEY82I3,Lord Vader,20080807,24,4.333333333333333,180.625,79,39,40
A2FB2HRCHCCA6T,Matt Lewis Reese,20090212,27,4.222222222222222,208.0,77,17,60
A2FD2MCXW6EER5,D. Pates,20090429,25,4.84,135.04,146,14,132
A2FEWR4OVNEXNU,Johnny,20110401,25,4.68,50.96,2,3,-1
A2FFWYG9YYZFA5,She,20110504,26,3.8846153846153846,125.57692307692308,36,14,22
A2FG061KDA1ARB,Mike from Jersey,20120211,39,4.641025641025641,108.35897435897436,43,9,34
A2FGSRTR4XFHMC,Jonah Koonce,20120303,29,4.0344827586206895,161.79310344827587,48,9,39
A2FHHZ6DTSHLXG,"K. Sampson ""sampson2269""",20100103,30,4.866666666666666,87.4,87,27,60
A2FHPXFQYLBKY5,Bookworm,20101218,23,3.652173913043478,63.391304347826086,14,0,14
A2FHTXLKY1XJDB,"Thomas Grillo ""Thomas Grillo""",20090531,48,3.8541666666666665,218.875,174,28,146
A2FIC05DY3HT7J,"Philster ""Philster""",20101129,21,4.571428571428571,308.95238095238096,63,2,61
A2FJZ3IYQ9N65S,kk,20090909,25,2.72,110.64,88,25,63
A2FKC9NP6QCKND,Kevin,20110629,21,4.666666666666667,32.476190476190474,18,4,14
A2FKNI9T7DN07P,Nono,20111029,24,4.041666666666667,80.08333333333333,5,1,4
A2FLJCVP5XX3C4,A RHEA,20090528,27,4.037037037037037,191.07407407407408,22,4,18
A2FNA5903D9E6Y,Carol Toscano,20100225,44,4.068181818181818,212.45454545454547,54,27,27
A2FOOWE5E379J2,Steven S. Abadi,20121126,22,4.7272727272727275,49.59090909090909,10,5,5
A2FPRECIF03DMU,,20110630,21,4.285714285714286,45.476190476190474,2,3,-1
A2FPUVI1EIFCDF,Dawn Trantham,20101122,24,5.0,34.0,4,1,3
A2FQ08CLTFE4WW,johndoe13,20021114,36,4.277777777777778,87.36111111111111,80,18,62
A2FQB5EAJCMYVW,"TV Guy ""TV Guy""",20060709,21,4.714285714285714,82.23809523809524,107,11,96
A2FR95O3K6WZMU,,20130118,24,4.125,61.333333333333336,6,2,4
A2FRAS05LEI6JJ,Sadie,20100620,33,3.6666666666666665,226.63636363636363,189,51,138
A2FRFAQCWZJT3Q,"B. Davis ""The Happy Hermit""",20050829,30,4.433333333333334,129.26666666666668,62,12,50
A2FRKEXDXDN1KI,Dennis A. Amith (kndy),20011013,95,4.4,678.5157894736842,1540,119,1421
A2FRTX7JBU8B3Y,"L. Wilson ""Lou W""",20090117,33,4.2727272727272725,116.15151515151516,157,232,-75
A2FSOHSM9X13JT,Scott D. Welch,20101106,72,4.666666666666667,318.02777777777777,271,21,250
A2FSUMOO31ZVNQ,J. Davis,20100614,25,4.84,93.76,9,3,6
A2FUD7TNC8HRYG,"T. Meadows ""TM""",20111224,36,3.75,77.88888888888889,60,26,34
A2FUGWBZ7P6ND1,C.K.N.,20081116,22,4.136363636363637,123.81818181818181,23,1,22
A2FWXZ1JATXRH7,S. Mc,20071117,38,4.184210526315789,115.65789473684211,28,5,23
A2FWZ58M6IQMD7,Doc Stew,20030621,61,3.721311475409836,302.24590163934425,422,54,368
A2FXBWR4T4OFQ,"Chris Z. Samaripa ""Zion""",20130323,68,4.764705882352941,44.36764705882353,17,4,13
A2FY5MB92979TG,Con Sumer,20080313,25,3.04,110.72,60,68,-8
A2FY8306QHI5LE,Bryan Barrow,20070116,29,3.8275862068965516,127.89655172413794,102,32,70
A2FYIB8I55KZEL,"Roy C. Lewis ""zzoom""",20080307,21,4.190476190476191,131.47619047619048,5,0,5
A2FZPRT0S0MLKT,"student, teacher",20130512,25,3.36,105.24,13,107,-94
A2FZQF0MH29VYN,DeeWhit,20110723,46,4.543478260869565,115.65217391304348,9,4,5
A2FZRO46DF0UHN,"D. Mertins ""AUDIOGURU""",20080507,21,4.9523809523809526,287.9047619047619,117,11,106
A2FZZ5GBGKN1D5,Ryan,20130423,21,4.428571428571429,99.0,2,0,2
A2G04D4QZAXL15,xkydivr,20110320,29,4.379310344827586,153.06896551724137,162,43,119
A2G0RTP38IM7RR,Good Sabum,20110803,31,4.580645161290323,30.741935483870968,3,2,1
A2G0ZVWUWYRXLK,"Phillydog ""Phillydog""",20120922,21,4.714285714285714,45.80952380952381,59,13,46
A2G2DXPFZKG48W,Audio Maven,20040310,24,4.208333333333333,124.91666666666667,15,8,7
A2G2QNKDL1Y6AC,mister_t42,20001010,32,4.71875,168.28125,1583,44,1539
A2G2XFMX6U2YWZ,"Fred Rose ""Gadget Boy""",20070917,21,4.380952380952381,60.80952380952381,38,14,24
A2G4YXW5IXUGH6,Active Media,20111207,31,4.806451612903226,83.54838709677419,33,3,30
A2G563AC1HME2R,"Eric J. Spencley ""Eric Spencley""",20110626,49,4.448979591836735,199.6326530612245,88,19,69
A2G5M8JN4K3EWG,Ryan R.,20110531,26,3.576923076923077,45.65384615384615,43,15,28
A2G5TBOB0CGLRZ,Derrick W.,20130711,21,4.571428571428571,67.9047619047619,5,0,5
A2G5VVB795WPBC,Jason D.,20101008,23,4.0,192.43478260869566,66,15,51
A2G82MAM4V06T8,"Kevin J. Bouffard ""kevinthescribe""",20110514,22,4.5,40.90909090909091,9,3,6
A2G97FURZ94KH7,E,20120501,23,4.565217391304348,49.56521739130435,14,3,11
A2GAADJ9YMV9EU,ABM,20130317,23,4.434782608695652,52.56521739130435,10,0,10
A2GANR9I6XHTU9,Amy Lynn,20040108,22,4.318181818181818,185.72727272727272,196,11,185
A2GAX9G9ANHFT8,M. Lee,20120422,22,3.227272727272727,103.77272727272727,42,49,-7
A2GD2HORAJHBK5,smiley,20130206,25,4.64,61.64,4,4,0
A2GGCVZS11R7QC,"Amazon Customer ""CorkyMuldoon""",20061130,24,4.458333333333333,112.0,94,27,67
A2GGIZ16A65PPJ,J. Jangula,20060818,26,4.6923076923076925,68.23076923076923,11,2,9
A2GGKJ318HO2GE,"Michael Horn ""mikie""",20050422,39,4.538461538461538,315.56410256410254,749,22,727
A2GHU6H46Z15EO,pokeba,20040819,25,4.2,111.6,105,21,84
A2GHU8I0P3HFRW,"Wandrwoman ""Wise as Aphrodite, Beautiful as A...",20090310,38,3.6315789473684212,255.89473684210526,269,31,238
A2GI43A75633P2,Scott,20110215,28,4.464285714285714,89.71428571428571,11,6,5
A2GI8J7RW5XTUL,"G.B. ""G""",20100211,45,3.6,95.95555555555555,66,20,46
A2GISQ90CZVKZC,RKG,20110319,34,3.411764705882353,104.44117647058823,17,8,9
A2GIUHN8JU8YOK,Snapperheadjoe,20120101,24,4.375,95.41666666666667,19,0,19
A2GKMXRLI7KLFP,Howard,20090310,63,4.714285714285714,196.17460317460316,274,18,256
A2GL70AZ8MWXI3,GWT,20041202,26,4.5,287.3076923076923,113,26,87
A2GL934UT3XENH,"J.E. Ocean ""The SilverPen Reviewer""",20110808,32,4.84375,217.84375,25,14,11
A2GLLQPRTM8P3J,ReighnDae,20120725,21,3.857142857142857,121.0952380952381,14,2,12
A2GMJ3DJ7CBM1D,L. M. Mccarthy,20110828,32,4.84375,59.8125,4,4,0
A2GMZZ6TDYOHY7,A. Mefford,20100714,54,4.777777777777778,135.9814814814815,47,5,42
A2GNBUTAVO1G06,"Circus Circus ""Ken""",20130224,25,4.88,141.88,22,3,19
A2GOHNFBHUU3UI,"Gadget Man ""Gadget Man""",20041123,67,3.955223880597015,272.64179104477614,1235,152,1083
A2GP1QHN2GBBUE,"M. Philips ""Ezermester""",20011109,30,3.4,150.03333333333333,72,29,43
A2GP3MF3JV9XSO,"Daniel Pacheco Jr. ""Skeptic Buyer""",20090823,21,4.476190476190476,109.66666666666667,9,4,5
A2GP6XJ1V3MM3L,BumbleB Media,20100826,34,4.323529411764706,200.2058823529412,3178,47,3131
A2GPJR489OIH42,sb-lynn,20080805,30,4.2,246.06666666666666,294,28,266
A2GPQZHM465OUK,Ted Detjen,20130120,21,4.761904761904762,62.095238095238095,8,0,8
A2GQJ9VSQFDG01,T. Nielsen,20080428,30,4.633333333333334,171.03333333333333,25,0,25
A2GS03YOVGDQ1U,Ryan Lester,20120731,29,4.448275862068965,92.89655172413794,7,3,4
A2GTBEL7DQCHPM,"ffabric ""ffabric""",20111208,22,4.590909090909091,142.3181818181818,12,29,-17
A2GTQBVT71MVIA,bklynbob,20120229,21,4.380952380952381,41.0,6,1,5
A2GUE1T9LNWZ0T,"Robert in NY ""wldtrav""",20070704,22,3.1363636363636362,235.8181818181818,167,17,150
A2GUHS41OS6GAS,"K. Wall ""the_brick_wall""",20070726,21,4.0,86.85714285714286,27,18,9
A2GV96XCT8BJPI,Big B in South Carolina,20090619,26,4.115384615384615,48.88461538461539,19,8,11
A2GVM2T7J83D22,Amazon Customer,20040318,23,4.6521739130434785,273.69565217391306,318,19,299
A2GVVAO242EK1D,J. W. Mullins,20080128,36,4.638888888888889,182.69444444444446,40,4,36
A2GWDDQNDHE20V,"James A. Jacob ""Jim""",20121201,26,4.6923076923076925,24.884615384615383,6,4,2
A2GWTD011BTSTG,"Jeffrey Peterson ""Jeff Peterson""",20110404,28,4.607142857142857,97.71428571428571,101,7,94
A2GX4KWO3V42Z,T. Shields,20050115,26,3.1923076923076925,63.46153846153846,22,22,0
A2GX51B0L0Z98U,Ham,20090520,24,3.5,50.166666666666664,19,7,12
A2GY5WCU9PKTMI,jennahw,20061103,26,3.8461538461538463,225.26923076923077,22,21,1
A2GYV87WW0DMSN,DesertDweller,20120523,53,4.547169811320755,151.56603773584905,219,27,192
A2GZ3PAZ7LJL3G,F. Lamaestra,20051001,24,3.4583333333333335,283.3333333333333,236,25,211
A2H0T0PY5IMEFX,Alan Dale Daniel,20070629,22,3.0454545454545454,396.22727272727275,94,43,51
A2H44WVZS59KKT,"Cheryl Stout ""broiderqueen - army mama""",20100808,25,4.44,288.72,92,20,72
A2H4B42VDSFV2V,"Annette1915 ""Annette""",20111130,22,4.2727272727272725,34.5,2,1,1
A2H4OMJLE7JFM2,Dan S. Birdsill,20090321,41,4.7317073170731705,38.36585365853659,4,15,-11
A2H4R3DOVF10TI,R. Oden,20080318,30,4.366666666666666,124.53333333333333,62,8,54
A2H4U79ISQHVEV,"Peter J. Skuba ""+Skoobs""",20091209,21,4.238095238095238,199.1904761904762,18,3,15
A2H5KD2A9MUZEX,Gaazmon,20130306,37,4.486486486486487,53.2972972972973,5,1,4
A2H667ZUNLNTF1,"Wendi Barker ""Wendi's Book Corner & What Wend...",20100917,44,4.409090909090909,164.5909090909091,13,10,3
A2H8OSFZTHDFBE,"Steve K. ""Music Junkie and a Dad""",20070615,24,3.1666666666666665,188.45833333333334,257,39,218
A2H8QTYB4OG1HI,"John Wilcox ""Family Man""",20070120,29,4.620689655172414,213.72413793103448,60,9,51
A2HAEGTOU4E45R,forkboy1965,20110103,21,4.0,172.14285714285714,39,10,29
A2HB8OXRKARU0U,"Tom S ""Tom S""",20081110,21,4.666666666666667,172.28571428571428,38,11,27
A2HBOG4LVIY15L,"Casch ""Chris""",20090310,50,4.44,187.7,422,9,413
A2HC94KQKVGIA1,D. Stephens,20041207,43,4.3023255813953485,119.04651162790698,175,24,151
A2HC9549CZAKNN,"B. McCarthy ""Engineer, CERT, Amateur Radio Op...",20050809,45,3.7555555555555555,172.46666666666667,758,141,617
A2HCHU60G30OFD,C.,20131030,22,4.045454545454546,49.72727272727273,4,4,0
A2HDHWSJ8KOT55,RickS,20120601,23,4.739130434782608,158.7826086956522,14,2,12
A2HDJ8C53PNI1V,C. Price,20120415,27,3.8518518518518516,132.2962962962963,41,10,31
A2HDNC32IICQXZ,DMK,20110208,35,4.771428571428571,69.0,11,4,7
A2HDTOF8222KN3,Mendy,20130311,53,4.981132075471698,138.9056603773585,14,2,12
A2HELIKP5RV27F,"L. Marrott ""Books&Amazon4Me""",20110715,23,3.8260869565217392,181.7826086956522,39,16,23
A2HH26HJLVPNVF,Joseph E. Desaavedra,20070105,27,4.185185185185185,40.25925925925926,15,8,7
A2HH8V0HSEMNHD,Stephen Larsen,20080222,23,4.521739130434782,127.78260869565217,51,1,50
A2HHAV29CZ1OIE,TheProf,20080322,38,3.473684210526316,117.92105263157895,33,22,11
A2HHJV0VGJPOFT,Robert Kirkpatrick,20080604,27,4.296296296296297,114.88888888888889,23,135,-112
A2HHZDHNBQ89PX,"Sarwat Ezzeldin ""PrinceAly""",20071108,24,4.083333333333333,212.95833333333334,257,11,246
A2HI35H2BOCV9R,MTBrider,20110121,21,3.7142857142857144,71.19047619047619,24,6,18
A2HIFEA5O00M69,Dr. James Williamson,20081024,30,3.433333333333333,68.76666666666667,72,34,38
A2HJY7418G1KV1,L. Freel,20070118,39,3.58974358974359,131.56410256410257,147,35,112
A2HKUM9OEBQKDW,Kona Mike,20100613,71,4.253521126760563,53.929577464788736,10,8,2
A2HL35J93PQOFW,M. Ali,20100411,23,3.6956521739130435,92.78260869565217,22,14,8
A2HLXJBE9N7MPQ,D. Thomas,20041020,27,4.518518518518518,108.29629629629629,45,10,35
A2HM0AZ8WQFWU7,Yoda,20070718,24,3.8333333333333335,209.375,107,4,103
A2HM2RMX1CBZGM,"Taylor Marsh ""DESOLATER IV""",20111208,25,3.84,116.16,14,29,-15
A2HMF8ZR67BNZS,Bill A. Belt,20080702,119,4.697478991596639,150.07563025210084,109,34,75
A2HNH4PKE5DPSI,"Ms_Ladi ""...just wandering the world.""",20071019,78,4.653846153846154,205.26923076923077,277,136,141
A2HNTIOL6HFPVE,Brian M Wise,20100503,21,4.0476190476190474,266.76190476190476,64,16,48
A2HOCKOV7WTQ4H,Steve D,20090607,27,4.555555555555555,53.7037037037037,143,12,131
A2HOCQJKNNN2GQ,"G. Chock ""Gadget Freak""",20121227,22,4.818181818181818,50.59090909090909,6,1,5
A2HOZIW0BRGHE1,Maurice Henry,20080503,34,4.852941176470588,76.44117647058823,37,35,2
A2HP63L85NI0CC,"Greg Fridder ""Fridder""",20120905,31,4.354838709677419,58.354838709677416,17,2,15
A2HPFRNPZZ405N,Fields,20080512,27,4.62962962962963,68.51851851851852,30,8,22
A2HPJKM7L4EOQB,"Michelle M. Ress ""safoocat""",20070817,33,4.181818181818182,87.12121212121212,58,11,47
A2HRHF83I3NDGT,WiseShopper,20120721,121,4.785123966942149,56.03305785123967,30,4,26
A2HS0HUHVLT9NG,JTL,20100614,26,4.076923076923077,113.34615384615384,46,13,33
A2HSCJ5XN882NJ,"Amazon Customer ""-EA""",20091010,21,4.285714285714286,68.28571428571429,18,8,10
A2HSMOBM5PCIF1,Michael A. Shoemaker,20050518,22,4.136363636363637,567.4545454545455,361,18,343
A2HSQM5KNHX9XL,"Luis G. Rodriguez ""Luigi Parigi""",20090720,32,4.46875,92.875,28,4,24
A2HTPS0JV3Q8ZD,"Michael D. Briggs ""Dark_Psion""",20091020,24,4.333333333333333,223.5,34,24,10
A2HUAYU4TH6GYJ,"MI Photographer ""Randy""",20111209,23,4.521739130434782,191.1304347826087,59,11,48
A2HV76MYH7UL3S,Dale T. Morse,20100920,53,4.622641509433962,288.8301886792453,426,56,370
A2HV7RYD2T30DD,HONEY BUN RUN,20090117,22,2.4545454545454546,69.4090909090909,7,15,-8
A2HW0XHWZO3O8J,"Gbcue ""Wally""",20100201,25,3.84,94.56,32,9,23
A2HWWCPZZVR6JE,"Pard ""&#34;Somewhere in the High Sierra&#34;""",20070518,24,3.5416666666666665,393.375,293,48,245
A2HX3D3MPPASNS,"Blanchard ""Dr. Carter""",20110512,36,4.611111111111111,57.55555555555556,23,14,9
A2HX5KDLIX1Q2I,C. J. Dorton,20080113,26,4.5,80.38461538461539,35,6,29
A2HXE29CU1I24Y,"R. Ocampo ""Artisan""",20030417,39,3.717948717948718,693.2307692307693,1813,161,1652
A2HXEJXEQQTM1D,E. Lorenzi,20110727,51,4.549019607843137,82.80392156862744,19,2,17
A2HY1IGOK2MX5G,Amazon Customer,20090917,25,4.28,321.36,231,31,200
A2HYU71TCIDXBR,akuaten,20120822,30,3.4,65.63333333333334,16,16,0
A2I0KVAGC6YIYZ,Mr Ken,20050224,21,4.0476190476190474,60.38095238095238,12,24,-12
A2I18AO597DSDI,"David Pearlman ""sound fanatic""",20040511,59,3.6610169491525424,555.6949152542373,3845,199,3646
A2I2DE1DJUVQOO,DarthRad,20040716,33,3.1818181818181817,419.45454545454544,891,79,812
A2I2KPNJDQ9SL0,XiMiX,20101014,58,4.4655172413793105,72.60344827586206,46,1,45
A2I357I10ZY7CI,M. Nguyen,20060308,89,4.314606741573034,113.1685393258427,156,31,125
A2I3XS9TO93Q0F,"Michael Meredith ""e-Mike""",20050915,32,3.9375,183.59375,98,11,87
A2I46P1RZY4TVP,"Douglas G. Lally ""DougNC""",20100520,28,4.0,181.0,121,21,100
A2I5LVVQ7WXEH6,"JEFF SMITH ""Jeff Smith""",20070709,43,4.27906976744186,62.23255813953488,34,21,13
A2I5QH4F5FDKK5,*rose*,20080218,27,4.7407407407407405,142.14814814814815,44,14,30
A2I60HCAVEF3RC,Tiger,20060504,32,4.34375,620.75,420,44,376
A2I6GN7OHB9JKF,ktr,20120128,68,4.029411764705882,27.75,24,20,4
A2I6KBFBFIORH7,"edcaroleg ""Ed & Carole G.""",20030220,21,4.428571428571429,132.71428571428572,302,24,278
A2I6SDJ3P3EUSO,"Tacitus ""Cyclist""",20060404,21,4.380952380952381,166.14285714285714,190,13,177
A2I6WVMSP85CYP,HikingInSierras,20110924,38,4.105263157894737,30.526315789473685,3,0,3
A2I6ZYR7WLA9IM,"ksd ""ksd""",20091227,29,3.9310344827586206,88.24137931034483,27,18,9
A2I7378BV33SWO,Dr. XYZ,20110531,23,4.521739130434782,67.17391304347827,112,13,99
A2I7955ZFHEGUB,Bejay in Spring,20100804,21,4.476190476190476,154.52380952380952,878,47,831
A2I8I9O542US9B,Jason,20121016,32,4.625,89.375,48,10,38
A2I8LFSN2IS5EO,Chris,20100401,25,4.44,217.24,55,28,27
A2I93OMO3ND10J,Murph,20110527,21,4.904761904761905,84.95238095238095,8,1,7
A2I98OOPNIJNYY,"Altar Boy ""Pax Vobis""",20070405,34,4.4411764705882355,242.7941176470588,135,28,107
A2I9960ULS3RG1,Robert W. Bremner,20110428,23,5.0,49.34782608695652,12,3,9
A2I9HGYUMH5H4Y,Michael,20110216,33,4.545454545454546,105.12121212121212,25,4,21
A2IAP43WJSU7LM,G-Man,20070726,29,3.7241379310344827,54.275862068965516,50,24,26
A2ICKE6A3MJMM5,E. L. Green,20040229,24,3.7916666666666665,297.1666666666667,57,14,43
A2IDCSC6NVONIZ,2Cents!,20090912,25,4.44,48.2,9,12,-3
A2IDRC0KFN4QQL,"Old Harley Guy ""OHG""",20140121,31,4.096774193548387,38.483870967741936,2,4,-2
A2IFC3PCZOHQ07,daveg,20130405,26,4.538461538461538,66.76923076923077,16,7,9
A2IFGGXG3YV3Y6,"Scott Anderson ""Sharpsburg""",20000721,101,4.405940594059406,181.8910891089109,538,66,472
A2IFKH3TJ10387,"Christopher Powell ""Christopher""",20071123,72,4.402777777777778,179.58333333333334,204,22,182
A2IFN1FBRHOK7R,,20130315,28,4.928571428571429,49.464285714285715,8,30,-22
A2IFZ00ICAERE4,M. D. Waters,20021214,28,4.607142857142857,132.28571428571428,101,15,86
A2II4B6CJ4O47Q,dikw,20070313,21,4.095238095238095,101.14285714285714,35,5,30
A2IIAQ7VVAHXTD,O. Guzman,20120620,49,4.63265306122449,92.3265306122449,42,13,29
A2IJ276VBT3V7S,Yvonne M. Bennett,20110630,25,4.64,25.16,6,7,-1
A2IKMRNKQ12ZPT,"Amazon.Buyer ""Never argue with an 1d10t...the...",20110516,33,4.363636363636363,226.0,319,30,289
A2ILEFMS2AIITR,Austin Guy 2005,20090208,28,4.285714285714286,61.57142857142857,11,8,3
A2IMGHMF0LO151,DACHokie,20110511,21,4.190476190476191,487.04761904761904,104,10,94
A2IMLOJ2Z2QEU2,Storm,20090530,67,4.044776119402985,399.2238805970149,661,91,570
A2IMT24918V7V7,"B. Kim ""Biodiesel Bob""",20100122,23,3.9565217391304346,100.17391304347827,86,2,84
A2IMZNPSJGB2HQ,Fernando Valenzuela,20060827,35,4.514285714285714,111.31428571428572,111,11,100
A2INGDHZFPDBFP,Karl Burrows,20090606,22,3.772727272727273,316.8636363636364,105,11,94
A2IOGHTCJ3QAHU,"Tall Timbers ""wbajm""",20120413,21,4.619047619047619,88.95238095238095,32,9,23
A2IPC51HL9UUYF,"Amy Y. ""Tell me, what is it you plan to do wi...",20000106,31,4.096774193548387,323.3225806451613,164,18,146
A2IPJU07ZEDQXR,"DWD ""DW""",20071128,32,4.40625,163.75,136,13,123
A2IQF161DYA68V,Terry L Rhea,20120815,22,4.2727272727272725,65.54545454545455,39,22,17
A2IQM22V0QM4I6,Doug Stevens,20060204,21,3.7142857142857144,180.38095238095238,90,3,87
A2IR2KN3XFMJXR,"Stephan Peter Konig ""Costa Rica Pro""",20080518,30,4.5,69.53333333333333,12,3,9
A2IT7S59GSASN7,"Mark Taylor ""markdtaylor""",20050901,72,3.4722222222222223,198.36111111111111,292,86,206
A2IU6J5HBGEUQ4,B. Campbell,20090405,22,4.2727272727272725,230.54545454545453,209,10,199
A2IUIOFOUUGA7E,W. Chow,20100403,33,4.454545454545454,128.84848484848484,43,19,24
A2IUXC55PAOY06,David in FL,20070208,37,4.324324324324325,76.67567567567568,27,16,11
A2IW0326MP3ZZZ,C. Prasojo,20041221,32,4.65625,112.125,49,10,39
A2IWPHVSMDQUT,Michael L Thompson,20130623,41,4.902439024390244,86.6829268292683,13,4,9
A2IX2PCXS5O2FK,Mike In San Diego,20130226,30,4.7,65.0,12,2,10
A2IX5MA38A7IAF,Joenathan,20130128,29,4.827586206896552,32.724137931034484,5,12,-7
A2IXAIARL0CDY7,"V. Price ""Vincent""",20110602,41,4.2926829268292686,137.5609756097561,94,14,80
A2IXK5LB4Y0NYV,G. Farney,20080324,52,4.346153846153846,117.17307692307692,34,8,26
A2IY383UW7991O,Mike Fratto,20060820,24,3.875,351.25,27,88,-61
A2IYTPZL3D7YZS,"D. Shaw ""Oh meow""",20100309,34,4.794117647058823,35.55882352941177,10,7,3
A2IZ9ZSFBW7JX8,"W. Hohenschuh ""Engineer On Two Wheels""",20121001,23,4.391304347826087,444.30434782608694,54,6,48
A2J0IBS4PFRO2C,Bakari Chavanu,20050721,53,3.69811320754717,177.77358490566039,332,94,238
A2J0KNW070N4LC,"Cebunderwater ""Driedmango""",20100820,22,4.909090909090909,39.27272727272727,29,7,22
A2J19U8H5SSFCJ,Linda Dalton,20070413,25,4.28,203.68,70,34,36
A2J1QMGQ432RAJ,Gregory P. Stewart,20080614,35,4.742857142857143,58.714285714285715,20,7,13
A2J22M1W2FG6P4,pinecanyon6,20140708,25,4.88,20.64,0,0,0
A2J29VKKOC4AFH,David Perez,20060805,21,4.619047619047619,193.47619047619048,125,15,110
A2J3HTDAG24MO6,"Michael Fielden ""thegeekchannel.com""",20071018,25,4.72,102.64,27,2,25
A2J3VCGBNDLAKF,Chrisinhouston,20120730,54,4.314814814814815,81.22222222222223,41,25,16
A2J4HCV3ANHTZQ,"Nathan Grammatico ""Nate""",20080122,26,4.153846153846154,195.57692307692307,61,77,-16
A2J4XMWKR8PPD0,Someone54,20121211,42,5.0,76.47619047619048,47,45,2
A2J557IQKW3GCP,Mrs. L,20110530,34,4.294117647058823,143.0,91,22,69
A2J591OLWPBEMQ,Skoobdo,20100711,32,4.625,170.5625,28,6,22
A2J6LVPWDFMIIZ,"Justaddwata ""Matt""",20080222,31,4.451612903225806,101.09677419354838,37,12,25
A2J6P9XUK9ID1A,"Steve G. ""Steve G.""",20130816,21,4.428571428571429,159.8095238095238,28,0,28
A2J7FHZFKOKGZ6,"Jeff Hoogmoed ""Jeff Hoogmoed""",20030411,77,3.7012987012987013,105.03896103896103,173,56,117
A2J7NOHEZ9BEID,"German Vasquez Jr. ""Love to Learn""",20070509,26,4.346153846153846,174.96153846153845,39,13,26
A2J8289OOT5DE4,C. Klaassen,20091031,24,3.875,342.4583333333333,112,25,87
A2J8DE8R94ZB02,Truth Teller,20050112,58,3.810344827586207,234.18965517241378,1229,74,1155
A2J8P71K1DWF6J,"Taterbug ""Tbug""",20090208,23,4.043478260869565,180.65217391304347,15,6,9
A2J8T58Z4X15IO,ScOObydoo,20071223,103,4.368932038834951,238.3009708737864,727,115,612
A2J96FILPQA01,VS2929,20101230,56,4.821428571428571,107.82142857142857,182,22,160
A2J9U2J3DYV4ZE,"JSS ""JSS""",20100211,24,3.4583333333333335,113.875,123,65,58
A2JA8EMRNT3ON,"Stow Fresh ""Stow Fresh So Fresh Review""",20131206,22,4.181818181818182,38.59090909090909,23,2,21
A2JAEZ0FMAMJVW,A. H.,20060324,74,4.405405405405405,302.4054054054054,410,87,323
A2JC55M4BFADBK,"J. L. Garrell ""JL Garrell""",20120911,33,4.696969696969697,68.21212121212122,5,8,-3
A2JCCJL47VVJ62,B. Wilson,20121020,21,4.285714285714286,446.3333333333333,145,37,108
A2JCFIZ1OIVJHK,R. Hopkins,20110216,36,4.444444444444445,44.166666666666664,22,16,6
A2JCJJNY43QQIV,Katy Lake,20071214,52,4.211538461538462,178.21153846153845,104,27,77
A2JE071UW97J2A,Kenneth Depree,20070214,90,4.655555555555556,336.1666666666667,909,67,842
A2JF13Z3H7009U,"K. Kurtz ""weary traveler""",20100806,21,4.190476190476191,73.04761904761905,45,9,36
A2JF94G7O0EV2K,N. Kline,20110503,24,4.208333333333333,174.16666666666666,111,8,103
A2JFMZEVGTZF3M,Teena,20080620,22,4.2727272727272725,241.04545454545453,60,8,52
A2JFPZ4IP7H8RW,blahblahblah,20110531,29,3.3793103448275863,160.89655172413794,94,36,58
A2JH8Y6MMKXJLO,David,20130606,22,4.863636363636363,35.31818181818182,6,1,5
A2JKM8KF3296CW,"Ninjaba ""Ninjaba""",20060629,57,4.017543859649122,241.0,63,18,45
A2JKY31R64UEAC,"S. Smith ""Quality counts""",20061116,22,4.590909090909091,216.45454545454547,268,30,238
A2JL1ZKJPU7OGR,"Ron A ""Ron Alden""",20120424,26,4.423076923076923,80.65384615384616,19,8,11
A2JM0NR1CH0RZ2,SCOTT A VIETH,20121224,23,4.0,187.43478260869566,36,1,35
A2JMJVNTBL7K7E,"K. Lin ""yesuaini99""",20061128,90,3.7333333333333334,229.23333333333332,432,133,299
A2JNI9V0X3YHK,"Man in the Middle ""strasma""",20030427,27,4.407407407407407,245.14814814814815,1384,39,1345
A2JNIVIFZNKF61,burd50,20111011,30,4.566666666666666,124.26666666666667,39,1,38
A2JNO9OR8FGNR4,"MusingCrow ""ZQuilts""",20060627,28,4.821428571428571,161.32142857142858,62,12,50
A2JOPUWVV0XQJ3,"J_Onyx ""I never let my schooling interfere wi...",20060509,57,3.719298245614035,280.2631578947368,3789,247,3542
A2JOVHS6HEEOOP,Aged Cheddar,20080223,25,4.76,94.28,204,6,198
A2JP0URFHXP6DO,Tim Janson,20041011,26,4.423076923076923,231.0,200,14,186
A2JP9E1H0SF392,TobycW,20040602,91,4.417582417582418,140.57142857142858,286,53,233
A2JPEX3KT3AB0T,John N. Doggett,20090222,22,4.363636363636363,91.27272727272727,33,12,21
A2JQ8IZWUZ18TK,TheRealDeal,20071030,36,2.4166666666666665,216.13888888888889,149,67,82
A2JR10TRIJXJ3R,Charles,20050218,22,3.090909090909091,479.54545454545456,1394,170,1224
A2JRDFIGWTX50J,"Ganesh Kumar Eswaran ""Ganesh Kumar Eswaran""",20050525,37,3.72972972972973,398.5135135135135,1475,156,1319
A2JRL57G6KIXF2,Ed,20110402,22,4.318181818181818,76.63636363636364,33,11,22
A2JRLFJ90C7EMN,"Jim Schmidt ""Jimmbbo""",20080511,22,4.545454545454546,178.04545454545453,183,6,177
A2JRR70R42FMWB,"stigabre ""LoveToCreate""",20090611,33,4.393939393939394,158.0,129,16,113
A2JS3Q4QBJYSNX,Nick,20130601,28,4.535714285714286,37.357142857142854,7,1,6
A2JU02EQY3RFEU,frank piedmont,20130213,22,4.2272727272727275,36.77272727272727,5,4,1
A2JUQ6H26RUEHA,Hyperiox,20121029,21,4.523809523809524,50.57142857142857,8,1,7
A2JV383UR7GGRJ,oldepossum,20100304,22,4.318181818181818,72.22727272727273,22,1,21
A2JVBJUU2DL0WA,Patrick,20091003,29,4.0,137.6551724137931,93,25,68
A2JW1MRA0W9YET,James Brady,20120418,28,4.25,235.39285714285714,70,10,60
A2JW269KB13V6V,Avid Reader,20100206,38,4.921052631578948,86.57894736842105,47,4,43
A2JWF9IG8PJAOA,Zen,20110709,64,4.6875,248.390625,277,53,224
A2JXCOUGYS5Y4J,anonymous,20100517,23,4.391304347826087,231.30434782608697,27,9,18
A2JXS1JII6SAUD,xeno,20071228,65,4.6461538461538465,151.27692307692308,340,24,316
A2JXVM40EIV9F6,James L. Davis,20070219,30,4.466666666666667,115.86666666666666,61,8,53
A2K12OJLEV1LB,"Thorstein Veblen ""Conspicuous Consumer""",20070816,24,4.25,128.70833333333334,43,6,37
A2K1M6ZS8BFELY,"Cowboy Blue ""Knowledge seeker""",20060316,31,4.612903225806452,42.0,6,3,3
A2K3J2X8KDY47N,"Jewelry Lover ""me""",20081022,31,4.32258064516129,89.7741935483871,19,7,12
A2K3W40WI49NQR,CHRISO6,20110217,24,4.541666666666667,137.16666666666666,17,2,15
A2K5ISAZOGA8WX,W. Mailman,20080221,32,4.65625,134.125,51,12,39
A2K5RRMPICZ606,Nathaniel Allen,20091027,37,4.351351351351352,542.0,1089,56,1033
A2K6CDQ9HZ359G,"J. Copeland ""JCinLV""",20080518,47,4.340425531914893,124.57446808510639,38,11,27
A2K6H0GJA067E4,"Sammy N. Mastroianni ""SNM""",20100610,22,4.090909090909091,105.0,28,9,19
A2K75QOCP9ZHSL,"A. John ""military mom""",20080323,22,3.3181818181818183,179.3181818181818,88,29,59
A2KALCHT9JZCT8,Neo Lee,20100906,21,4.523809523809524,144.0,72,10,62
A2KAOIY8M4D044,"Mac_Cat ""MacIntosh Man""",20080618,23,3.8260869565217392,188.82608695652175,25,27,-2
A2KBQ6ASGK3LDM,FearThePenguin,20100914,24,4.541666666666667,99.29166666666667,34,9,25
A2KCNRFE5NL5B6,SmurfsRiot,20110118,34,4.676470588235294,151.97058823529412,714,34,680
A2KCSXYY2DLKSI,James P. Malone,20100205,29,4.137931034482759,72.51724137931035,10,19,-9
A2KEPLTDFSUIDK,"gsmith ""Gary G Smith""",20121212,21,3.4761904761904763,41.95238095238095,11,11,0
A2KEQBB5NL2NZG,Neil Leisenheimer,20130217,24,4.166666666666667,121.25,31,3,28
A2KETRDA2QWM8M,SR,20110618,22,4.5,78.18181818181819,4,1,3
A2KF3H5304I4IA,Michael A. Israel,20031119,32,3.75,378.15625,601,65,536
A2KFAEOHLMLX0H,"G. Uhl ""Allons-y, ... and don't blink.""",20100711,34,4.176470588235294,155.61764705882354,88,20,68
A2KFCHSLBMU90Z,tadc,20120329,24,3.875,48.166666666666664,19,10,9
A2KFKEME4A9ATW,"C. Petra ""PETRAFYD""",20101102,27,3.5925925925925926,128.55555555555554,57,9,48
A2KFWHHUFVKFXZ,Laura B,20000929,37,3.972972972972973,288.13513513513516,306,17,289
A2KHG3JOFXQ4CE,"USMC Combat Vet ""Retired!""",20070713,70,3.6285714285714286,539.9571428571429,642,170,472
A2KI0LAYW1AM7R,Machina,20071219,22,3.0454545454545454,284.40909090909093,33,16,17
A2KICNU7EOBYE5,Zilla,20120415,24,4.5,48.291666666666664,6,5,1
A2KIIL3TIF89OB,HBSurferMan85,20110520,26,5.0,36.5,16,6,10
A2KIJBT9HRIOM8,,20120127,49,4.469387755102041,48.06122448979592,23,12,11
A2KILNYE6LV4Y2,MWJII,20080701,31,4.387096774193548,50.774193548387096,62,5,57
A2KIU9UIY5XTB2,"Member ""Spyder""",20081114,22,4.136363636363637,129.36363636363637,26,10,16
A2KJ2MLSFUFS1R,Tony Zhao,20120402,28,4.785714285714286,100.32142857142857,25,2,23
A2KJLOJ7HA1QFC,Aphonic,20110414,39,3.230769230769231,89.43589743589743,35,21,14
A2KJXBI3V1MZNM,QuietType,20110510,21,4.571428571428571,66.28571428571429,31,4,27
A2KJY8F5O1U5D6,A. Felson,20080108,28,3.5714285714285716,149.71428571428572,35,24,11
A2KMV056844YV2,"Book Lover ""CYN""",20100809,37,4.621621621621622,102.29729729729729,71,25,46
A2KMY4RVMJ1EP6,faeriemyst,20110106,22,4.181818181818182,302.22727272727275,48,13,35
A2KO62DCXXULDY,"UofM Tiger ""uofmtiger""",20030228,21,4.619047619047619,375.2857142857143,105,12,93
A2KOHFCY43BX98,David M,20110204,25,4.04,43.84,14,13,1
A2KOV8XWZOZ0FQ,Juniorverse1,20071023,137,4.145985401459854,255.03649635036496,1362,160,1202
A2KP65JS3YY5VL,"Michael A. Rowley ""Nick Danger""",20061109,38,4.2631578947368425,56.60526315789474,23,12,11
A2KQSLKDHGPRMK,"Erik Gordon Bainbridge ""Author, virtual world...",20100123,24,3.7083333333333335,380.8333333333333,89,8,81
A2KR1481ARVYNP,Brandon,20120607,24,4.583333333333333,45.125,15,1,14
A2KS0FVY2CNJ8M,Michael O.,20080109,21,3.857142857142857,647.047619047619,173,33,140
A2KTJ4JHYOCNRV,sehelfer,20121109,24,4.083333333333333,37.375,14,26,-12
A2KVU40TIPD5HF,Colin Keenan,20091117,28,4.821428571428571,146.78571428571428,124,12,112
A2KVUYPLEW4LXT,"Strategos ""The Guardian of Time""",20040303,34,4.264705882352941,508.55882352941177,196,41,155
A2KVZY5EMMNDOB,Evilstalkerhorne,20130618,25,4.28,64.24,4,4,0
A2KW039CDK63O3,David McKee,20080308,31,4.903225806451613,32.903225806451616,9,4,5
A2KW2LCO5QUWOI,"Jerrod Kowalski ""Jerrod Kowalski""",20050326,41,4.0,175.8780487804878,64,13,51
A2KWOC600DMC0W,"Bluesage ""Bluesage""",20120106,25,4.08,35.4,3,8,-5
A2KXT3ICEX2JE5,"T. Tran ""pickyguy""",20040604,27,4.185185185185185,275.44444444444446,146,34,112
A2KY76HK8DYRL3,A Book a Day,20110729,21,3.8095238095238093,208.0952380952381,25,24,1
A2KY8KQTR9AJTQ,"Jen ""Jen""",20090411,23,4.173913043478261,164.47826086956522,59,72,-13
A2KYRPDKVBI2R4,"Techy Owl ""Blaine Miller""",20110320,142,4.73943661971831,77.58450704225352,41,33,8
A2KZOIOFXXMC1H,"The Penguin ""Techno Geek""",20090226,63,3.9523809523809526,175.76190476190476,178,34,144
A2KZOUW7YLHN49,Richyyrich,20110318,30,3.966666666666667,62.833333333333336,12,3,9
A2KZQEKUS3G02I,G. GOELZ,20120417,26,4.730769230769231,53.73076923076923,6,3,3
A2L00YZBDOOM8N,J. Fuller,20090823,23,4.521739130434782,143.1304347826087,28,8,20
A2L0F2T1DLTNT8,"A. Abrams ""Vermonter""",20050615,59,4.406779661016949,724.5593220338983,395,74,321
A2L0MBN8AE9GE2,"Eugene I. Kim ""EK""",20060927,23,3.217391304347826,184.3913043478261,136,48,88
A2L1WNQY8J5WCN,Michael Sellers,20071125,33,4.363636363636363,148.45454545454547,202,22,180
A2L35P0VQE7LBN,wann,20090504,21,3.9523809523809526,256.6190476190476,66,8,58
A2L36AGL8CKY3D,"Tex ""Tex""",20081227,44,4.7727272727272725,96.18181818181819,40,14,26
A2L3OUGY7OTR3N,Dub32,20070726,29,4.0,87.41379310344827,71,65,6
A2L42QEWR77PKZ,Tex,20090201,69,4.420289855072464,88.21739130434783,199,28,171
A2L46U9X378VKP,G. Linn,20081003,22,4.409090909090909,349.45454545454544,44,6,38
A2L4W1M5YU5QX3,Njrg,20111217,49,3.795918367346939,136.83673469387756,84,48,36
A2L4XGVPR42KHL,"Therabbitssing ""on the rock that spews lava..""",20041216,27,4.148148148148148,227.5185185185185,106,19,87
A2L4ZGN7GZJ95T,Jed Shlackman,20100415,69,4.173913043478261,185.8985507246377,53,32,21
A2L58C3BRDWQMB,Sheetal,20090516,41,4.487804878048781,48.09756097560975,12,8,4
A2L6QS8SVHT9RG,"randomartco ""period film aficionado""",20091208,23,3.9565217391304346,106.26086956521739,87,11,76
A2L73KNIMIF3TY,AP,20071201,26,4.1923076923076925,248.65384615384616,602,36,566
A2L7KJGADRIILV,Frank J. Miller,20090106,24,4.333333333333333,73.5,30,6,24
A2L7WYA5OENV03,Reticuli,20000712,27,3.259259259259259,372.51851851851853,270,123,147
A2L8FUCG0CYD4H,vato,20110529,35,3.742857142857143,38.42857142857143,10,13,-3
A2L90RS4B7YLLS,J. Sundquist,20030316,25,4.76,267.64,639,39,600
A2L90SGUP36KGA,TRJ,20110410,58,4.068965517241379,74.17241379310344,132,68,64
A2L9OPJAAEK08Q,spin_nin,20061230,62,3.370967741935484,203.46774193548387,233,46,187
A2LAKH7K69VKK7,Thomas M. Mcdonnell,20100323,23,4.565217391304348,184.0,68,9,59
A2LAS014NSRW72,Amy Henry,20110526,24,3.7916666666666665,194.625,53,13,40
A2LB4FLRZG6CUV,Orlando Echeverria,20111130,99,4.303030303030303,215.68686868686868,191,113,78
A2LCE1D0TW2XY0,D. Alexander,20070703,86,4.174418604651163,804.6279069767442,6937,369,6568
A2LDL960FST9LW,John Guilbault,20070515,25,4.8,249.52,185,9,176
A2LDSFXAUOGBGL,Peter,20120216,22,4.590909090909091,325.09090909090907,11,4,7
A2LDT13YZCNI5N,Mark,20120119,23,4.826086956521739,68.56521739130434,21,8,13
A2LEIANN1UZTHP,brainout,20101206,42,4.071428571428571,644.452380952381,204,22,182
A2LEK0N9TKQUM2,rpac78,20100428,32,4.25,91.90625,29,4,25
A2LF07KCXDR70D,ILoveTheUSA,20070828,44,3.6363636363636362,118.54545454545455,91,25,66
A2LF16F0KX9L7P,John Keitz,20050921,62,4.467741935483871,297.9032258064516,317,64,253
A2LF9XIK912IUI,Tullio Fontana,20061103,28,4.25,109.14285714285714,374,45,329
A2LFWJ8X817QGX,Brett,20120202,45,4.333333333333333,60.71111111111111,88,31,57
A2LHANCVBGV36U,"Max Aperture ""The older I get, the faster I w...",20070721,30,4.266666666666667,191.63333333333333,69,14,55
A2LHL3RYUYLCN8,"Amazon Customer ""Marty B""",20050205,31,3.6129032258064515,358.4193548387097,144,24,120
A2LI8L6O4M0G1K,CuriousEggroll,20110309,22,3.727272727272727,172.5909090909091,12,6,6
A2LIGTSDHJY7U6,"IrixGuy ""IrixGuy's Adventure Channel""",20140106,23,4.782608695652174,139.6086956521739,23,3,20
A2LJ1M369ZQB7R,"Donald J. Koller ""smasher""",20120729,36,4.722222222222222,25.11111111111111,11,1,10
A2LJBBRLDNIMH0,Michal P. Todorovic,20091202,21,4.380952380952381,136.9047619047619,119,9,110
A2LK6BQNH967TO,K. Mosmen,20100524,33,4.878787878787879,51.60606060606061,16,4,12
A2LKHLBM9N89YE,TRice,20130923,26,4.5,39.5,1,0,1
A2LLDIFV0DLA82,RAGNAROK,20101123,21,4.809523809523809,159.1904761904762,15,1,14
A2LLSFQO8O8XNW,Ryan,20100721,66,4.454545454545454,249.8030303030303,336,45,291
A2LN3ZKNLTHQ2T,"S. Lewis ""JB""",20120817,36,3.4722222222222223,101.33333333333333,25,62,-37
A2LNQQ1N2DZBUJ,T. Dyrkacz,20081012,21,4.190476190476191,147.8095238095238,33,7,26
A2LNVVL2EJ057F,"Kevin Miguel ""Runs with scissors""",20101231,33,4.575757575757576,241.3939393939394,70,11,59
A2LOCNLCDMUKS0,Joe from LA,20051222,46,4.173913043478261,146.52173913043478,169,48,121
A2LPJY2QMEYTRA,"TMP ""Treasured Memories""",20120430,22,4.863636363636363,70.63636363636364,11,2,9
A2LQN25HW5IGSB,"E. Euell ""1""",20090106,24,4.541666666666667,64.16666666666667,13,1,12
A2LR3H7YEVV6CN,I Live in 91607,20060801,42,3.3333333333333335,164.5,258,303,-45
A2LR99VQFO6UNX,"Lance_big_daddy ""Lance""",20060315,21,4.095238095238095,63.38095238095238,118,17,101
A2LRK4OAPPZZWP,AKGeek,20111014,39,4.615384615384615,100.51282051282051,73,9,64
A2LRYPW6IC4VS,sancocho,20120817,25,4.24,73.68,27,5,22
A2LTYEYGKBYXRR,"Zachary S. *Tech Reviewer* ""zmanbaseball2@gma...",20130708,55,4.818181818181818,206.4181818181818,387,13,374
A2LW5AL0KQ9P1M,Dr. E,20070617,99,3.808080808080808,250.42424242424244,603,66,537
A2LW5RG2ISGZ5L,"Francis Fung ""JULIA DEVENDORF""",20120926,32,4.40625,154.09375,137,75,62
A2LWQLV37ZEP7P,David Y,20080915,21,4.0,180.1904761904762,72,14,58
A2LXX47A0KMJVX,M. Erb,20030728,79,3.949367088607595,527.2784810126582,2863,103,2760
A2LYK1AGZ4U9L8,tbyg,20090305,26,4.1923076923076925,185.46153846153845,119,7,112
A2LYU2OT25EIV3,"Billitteri ""Word...""",20070109,22,4.409090909090909,121.0909090909091,27,3,24
A2LYY264P2R493,Kelly Stum,20130112,25,4.4,75.92,14,3,11
A2LZ6AGWWLWNXP,Kyle,20040613,25,3.92,260.24,75,11,64
A2LZDPPCDRUBG6,"Bazajaytee ""Bazajaytee""",20120425,24,4.708333333333333,120.33333333333333,39,7,32
A2LZIE48D0VX49,Ezutguy,20090517,31,4.580645161290323,161.80645161290323,158,10,148
A2LZSPR192KEX6,"Kyle Otto ""Go Sabres!""",20110709,27,4.814814814814815,159.22222222222223,27,6,21
A2LZX3NDB6RFF2,Peter D. Mar,20090816,30,4.6,432.1,153,16,137
A2M14CFAMF8J7I,Techie,20110330,58,4.672413793103448,350.6896551724138,3040,160,2880
A2M1MNG7G40V85,Surface to Air Missle,20031106,45,3.911111111111111,153.93333333333334,96,54,42
A2M2522FFM497K,"FraterMus ""FraterMus""",20070530,24,4.125,170.58333333333334,48,4,44
A2M2LMZMDFI35Y,W. Teo,20110310,34,4.470588235294118,49.85294117647059,14,10,4
A2M2M6S44WOSUT,J. Abreu,20120722,22,4.045454545454546,47.27272727272727,3,0,3
A2M3HDLKL29GY,lindros,20010829,27,3.740740740740741,117.74074074074075,136,76,60
A2M459TAWSBBOB,E. Mitchell,20040402,21,4.428571428571429,185.28571428571428,43,3,40
A2M4BJK1LPB2OW,Kit Cat,20100608,35,4.542857142857143,107.28571428571429,39,4,35
A2M4PQPBV45U71,"Relentless ""skepticalbeliever""",20040108,42,3.7857142857142856,201.21428571428572,449,88,361
A2M4U0ZK4R3ZXW,R. Morris,20110929,22,4.409090909090909,357.04545454545456,37,1,36
A2M615YIYUCHES,mjaytee,20060503,23,4.130434782608695,190.8695652173913,202,14,188
A2M66B89MYA54B,BP,20120921,21,4.619047619047619,59.95238095238095,5,2,3
A2M6HYDTRRRULC,James TC-AZ,20110829,22,4.7272727272727275,111.68181818181819,26,4,22
A2M6J4CGEA29JI,Risa,20120803,23,4.434782608695652,214.82608695652175,31,17,14
A2M775WAM2DXTD,John,20130522,26,4.423076923076923,36.19230769230769,5,5,0
A2M7L6LMYU1DV9,kalip,20080119,21,5.0,90.76190476190476,24,3,21
A2M86U0B58SP06,"Joni ""J""",20121230,27,4.407407407407407,67.0,7,3,4
A2M9ME0N2S3R39,Steven G.,20051124,38,4.157894736842105,185.52631578947367,194,62,132
A2MA4XZRU0QHPA,"T. Wiz ""WZR""",20050113,21,4.380952380952381,113.47619047619048,51,10,41
A2MAJK49M3CBIY,"Score Event ""TimeTraveler""",20080525,31,3.6451612903225805,238.09677419354838,86,25,61
A2MAXHANV8EETT,"Andy ""Computer Enthusiast""",20010223,22,3.272727272727273,282.6363636363636,379,84,295
A2MBLVMVDLHK1L,Gen of North Coast Gardening,20080422,38,4.5,265.10526315789474,20,19,1
A2MBSC4S2PJNRD,Adam Smith,20071019,25,4.4,116.8,30,5,25
A2MBYDJV2VGHMO,"Andover Diver ""Andover Diver""",20070512,37,2.891891891891892,111.72972972972973,75,14,61
A2MC0N85KTN7ED,L11,20090408,25,4.28,142.08,9,2,7
A2MCP2MTSKON9O,Subject7,20100301,22,4.0,162.54545454545453,38,7,31
A2MCRCK1V61FWQ,Roland Mata,20080605,47,4.957446808510638,99.31914893617021,67,11,56
A2ME89MSWVG9NF,"donny ""don130""",20030531,71,3.7183098591549295,145.09859154929578,250,75,175
A2MF0N72JVXDAP,The Phantom,20090719,22,3.590909090909091,57.40909090909091,38,3,35
A2MFHJ08ZX3O61,Randomness,20110329,32,3.90625,343.5,155,32,123
A2MI9M5AM37SR3,J. McCloud,20050114,30,4.666666666666667,86.03333333333333,35,4,31
A2MIP3AQVSF2SS,"Teh Arbitrageur ""PM""",20090623,45,4.711111111111111,72.0,14,3,11
A2MJ8OL2FYN7CW,"Lynne E. ""Lynne E.""",20070714,72,4.347222222222222,362.09722222222223,482,47,435
A2MJXZGMRLW9JV,K. Faaborg,20100303,26,5.0,73.84615384615384,7,1,6
A2MJYMEYW3YWWH,Murray Eisner,20101001,27,3.6296296296296298,93.96296296296296,78,15,63
A2MKG8P7L2PPPB,"discodj ""dj man""",20080402,30,4.0,41.96666666666667,64,58,6
A2ML26LVL8N11X,Amazon Customer,20070223,24,4.375,75.75,15,6,9
A2ML3T9GRSNH14,Rory Truitt,20080913,23,4.608695652173913,71.04347826086956,23,2,21
A2ML5RT6D3QC50,Alive and Well,20110529,26,3.576923076923077,150.34615384615384,5,7,-2
A2MM30EFRMPL5Z,Kal,20100807,31,4.096774193548387,287.96774193548384,28,4,24
A2MMNJE4066X3X,Ryan McBride,20101116,24,4.416666666666667,67.58333333333333,11,11,0
A2MNGG6MODVLTG,Dan Durig,20090101,28,4.0,236.78571428571428,40,9,31
A2MO8QZTNYYB98,Sheri Fogarty,20060801,43,4.674418604651163,180.51162790697674,390,57,333
A2MOD50IHEDH3G,IAMSLICK,20060424,62,4.354838709677419,229.46774193548387,540,55,485
A2MOJANFPX353G,Ken M,20060325,42,4.5476190476190474,216.0952380952381,243,15,228
A2MOVLZ429BFLZ,"aglowucannotsee ""aglowucannotsee""",20101007,22,4.363636363636363,97.0909090909091,18,1,17
A2MPXAJK3K61IY,B. Anderson,20060626,21,4.476190476190476,215.47619047619048,55,7,48
A2MQ3L9TDFBZ8I,D. madden,20060515,21,4.428571428571429,80.28571428571429,107,54,53
A2MQYBL04OEG6B,R. S. Cooper,20110403,22,4.2727272727272725,78.18181818181819,17,3,14
A2MR696ZU17F12,"David ""Foxboy""",20060610,46,3.760869565217391,113.6304347826087,161,70,91
A2MSBIA18RXYQC,Frugal Bargain Hunter,20080611,29,3.2413793103448274,150.89655172413794,248,46,202
A2MUGFV2TDQ47K,"Lynrie ""Oh HELL no""",20100802,39,4.102564102564102,157.43589743589743,28,13,15
A2MVF3CEV2DZQL,"D. F. Watt ""dfwatt""",20090410,22,4.2727272727272725,733.6818181818181,779,56,723
A2MVJ1H9IC5IDC,Stephen Spitzer,20080517,31,3.903225806451613,108.29032258064517,42,4,38
A2MVPY9XVYST9H,"D_Strasse ""D_Strasse""",20070808,37,3.7567567567567566,302.9189189189189,228,64,164
A2MY1A0Q6E8RNP,Tek2000,20050301,24,4.25,231.125,82,25,57
A2MY9VXHZYAHUZ,"Kimba W. Lion ""kimbawlion.com""",20010801,27,3.925925925925926,255.0,189,20,169
A2MYM0XC5JNHBS,James Cothern,20090521,24,4.458333333333333,113.04166666666667,4,5,-1
A2MZZP3ZU9B5JS,"Ronald Epstein ""Ronald Epstein""",20051118,22,3.8636363636363638,502.40909090909093,2420,239,2181
A2N2FJ2WS0MWTV,"Michael W. Erb ""Amateur Photographer""",20050716,22,4.818181818181818,110.22727272727273,53,5,48
A2N2PPJZET1XTK,Geebee,20110104,25,2.96,102.68,49,33,16
A2N2XSX54EJQ7C,BP,20111219,24,4.75,61.125,19,4,15
A2N3DPMEBNP4PK,Photohombre,20091122,26,4.461538461538462,119.07692307692308,36,3,33
A2N3JSOIQ6ZNFL,Computer Dude,20110415,44,4.636363636363637,42.97727272727273,11,5,6
A2N47RFN7XIE6O,Death Metal Till Death,20110917,25,4.64,76.72,23,5,18
A2N67CK7G2TE5Q,"S. Baer ""Steve""",20050903,23,4.3478260869565215,306.4347826086956,95,18,77
A2N6850P9TDYFW,"Its ""Munchiniwa""",20051028,27,3.5925925925925926,146.85185185185185,167,45,122
A2N75ADJSRW0AH,Jeff Kraus,20080806,44,4.181818181818182,532.9772727272727,2149,100,2049
A2N866U5PC42K4,"Stephen Kalman ""techauthor""",20010920,21,3.5714285714285716,187.0,171,17,154
A2N89YVH2LB3PA,"Paul ""Paul in Boston""",20110513,40,3.85,89.825,58,19,39
A2N8P4Y65DJNTT,J2014G,20100201,22,4.636363636363637,107.72727272727273,41,9,32
A2N9ADDVQCMS42,"Wade ""Wade""",20050620,23,4.434782608695652,88.91304347826087,23,12,11
A2N9YI94O8TR8M,K. Samuels,20120514,24,4.625,87.33333333333333,10,5,5
A2NAVGRYYEW3DM,Stuntman Mike,20100612,37,4.756756756756757,103.5945945945946,113,5,108
A2NB2E5DXE319Z,S. Lionel,20050111,144,4.430555555555555,361.52777777777777,1793,172,1621
A2NBCCFDISGUQT,Mystery Lover,20080522,25,4.16,98.84,42,23,19
A2NBRVC8C9KG2F,Skiter,20100624,32,4.78125,53.0,18,5,13
A2NCO79BXDXVCQ,Sandy D. Scott,20100421,21,4.095238095238095,190.33333333333334,130,50,80
A2NCSPA53VB4OK,"Bob ""Bob""",20060601,25,3.84,296.68,289,44,245
A2NDM4CIJ4YGP5,"Adam G. Kirchmann ""Adam G. Kirchmann""",20090815,23,4.043478260869565,45.82608695652174,10,1,9
A2NDMKZIM7FOOB,P. Corson,20100321,28,4.107142857142857,164.71428571428572,61,13,48
A2NE7D8GC41UCL,"Karen Amrhein ""Karen A.""",20110822,37,4.4324324324324325,104.48648648648648,31,0,31
A2NF194CDXBICA,Mark Chan,20101107,26,4.230769230769231,80.23076923076923,8,21,-13
A2NFW5G96LN1RN,Joe,20121002,23,4.304347826086956,72.69565217391305,22,7,15
A2NHL1JPU0AW4U,Dan__,20100929,25,4.52,59.44,19,3,16
A2NHT63B5QOG10,PitDog,20110927,21,4.380952380952381,35.142857142857146,2,1,1
A2NIH8JB9AL786,"Donald Jones ""donmarjon""",20100423,40,4.425,73.75,96,9,87
A2NJ72QP6SU0MQ,"Suziesilverado ""Suziesilverado""",20041126,22,3.1363636363636362,92.77272727272727,17,9,8
A2NJOH0ESFZ1D6,BiBi,20111021,23,3.9565217391304346,74.47826086956522,29,1,28
A2NJQF2UI60VGT,ChicagoCPA,20071031,83,4.542168674698795,294.2289156626506,780,60,720
A2NKI99LU8CBMZ,K. Sterling,20081224,30,4.333333333333333,74.63333333333334,8,1,7
A2NLI1M5K2MQ5E,Patrick M. Racey,20091105,41,4.585365853658536,71.95121951219512,78,8,70
A2NMY5UF624JGE,"Diamond M. Dominguez ""diamon2x""",20080110,23,4.391304347826087,210.52173913043478,52,7,45
A2NMZ6WG5ZM1DJ,Manu,20110316,21,4.619047619047619,61.23809523809524,3,1,2
A2NN1KIYEM2SKS,AF,20111121,52,4.211538461538462,60.51923076923077,36,9,27
A2NNBXKXOGVNHK,J. Martinez,20061128,22,4.318181818181818,215.5909090909091,439,43,396
A2NOIWPJDD7WIQ,Amazon Customer,20060706,55,3.5636363636363635,234.6727272727273,612,89,523
A2NOJVQUPKPTEI,T. Paslay,20080805,26,4.038461538461538,432.0,81,8,73
A2NOW4U7W3F7RI,rpv,20060329,241,4.771784232365145,194.60165975103735,3718,445,3273
A2NP9CGUSFP22E,"BG ""Bob G""",20120610,68,4.602941176470588,50.48529411764706,22,4,18
A2NPN06SYI5VL3,Brian T. Clem,20091031,34,4.294117647058823,135.7058823529412,37,10,27
A2NPQM672LHELI,CLTGUY,20111111,25,4.24,80.64,32,9,23
A2NQMVTQ4PVLL,HighwayMan,20120902,49,4.653061224489796,144.55102040816325,32,5,27
A2NQUYSIJ3OB9S,Nicholas P. Sugleris,20120407,26,4.5,46.53846153846154,16,2,14
A2NRELDAF9V3G7,Gadget Freak,20120715,27,3.925925925925926,164.88888888888889,58,27,31
A2NSMJVQY0RV9S,J. Howell,20090812,82,4.548780487804878,316.0853658536585,1593,67,1526
A2NSXY5L42ZUGO,R Gibbons,20081208,63,4.634920634920635,97.17460317460318,118,7,111
A2NT274XP6RX09,v4vendetta,20101130,27,3.8518518518518516,214.03703703703704,18,2,16
A2NT3W1F1XYBFZ,"Kirk Tuck ""Kirk Tuck""",20090811,30,4.733333333333333,248.06666666666666,1980,77,1903
A2NTPZZ5FS19Q,Bic,20041107,23,4.304347826086956,183.6086956521739,251,52,199
A2NU9H8H5MJZSL,Telstar,20021108,56,2.6607142857142856,119.82142857142857,680,182,498
A2NUBL2UYWPBWR,C,20090619,43,3.604651162790698,215.74418604651163,161,21,140
A2NUHWMHA9XNKV,Lady Raven RAVE!,20100716,30,3.7666666666666666,73.5,25,50,-25
A2NUWASJTPN7RO,eire1274,20110330,36,4.611111111111111,277.55555555555554,38,3,35
A2NVNMLC0AFL08,Environmentally Conscious Bargain Shopper,20070221,28,4.321428571428571,124.07142857142857,40,20,20
A2NVNYAXAU1BS6,"JFN south ""beach nut""",20111201,24,3.2916666666666665,65.25,48,66,-18
A2NVQZ4Y7Y0J1R,Traveler,20031208,60,3.7333333333333334,340.8666666666667,1524,122,1402
A2NW4GICXSLUVZ,"David H. Hanneman ""Dave H""",20100925,24,4.166666666666667,156.33333333333334,23,2,21
A2NW5UDW32JSV2,"Scott Sherman ""Scott Sherman, Lambda Literary...",20080518,35,3.6857142857142855,407.25714285714287,282,70,212
A2NWG9WAAJ5YF5,"B. Fishman ""big B""",20060815,23,3.9565217391304346,47.08695652173913,3,0,3
A2NX6MFZP8TM6S,Deanokat,20041202,60,4.383333333333334,227.5,623,80,543
A2NX6PABLIJLP1,"joetagaz ""joetagaz""",20070810,59,4.559322033898305,220.57627118644066,233,26,207
A2NXAV1SNXWA9H,S. R.,20090704,21,4.238095238095238,303.8095238095238,64,20,44
A2NXI2A033QZZH,Geek Hillbilly,20110920,26,4.846153846153846,51.07692307692308,7,2,5
A2NXRD80LWHUOP,"Mojave Mike ""Mike""",20081008,44,3.090909090909091,155.0909090909091,62,32,30
A2NXWKOQ3EVKJC,Allen,20110714,32,4.40625,168.0,44,6,38
A2NYK9KWFMJV4Y,"Mike Tarrani ""Jazz Drummer""",20021006,159,4.7924528301886795,326.54716981132077,984,67,917
A2NYOY6H42SORF,"D. Hardingham ""Magnusfl""",20060926,43,3.9302325581395348,59.16279069767442,43,130,-87
A2O09OEIOKYZGQ,Brandon Spiller,20121120,32,4.84375,51.8125,11,17,-6
A2O0V7VKB9OH11,Buyer,20120812,26,4.576923076923077,143.76923076923077,31,6,25
A2O168CJIAEGL5,Pete In Illinois,20121020,27,4.37037037037037,73.62962962962963,10,4,6
A2O1OCGUR6V1K,Engineering Geek,20061104,26,4.076923076923077,128.3846153846154,35,11,24
A2O2D7JV0QU630,"Amazon Customer ""The Mojo""",20050808,34,4.852941176470588,57.911764705882355,159,14,145
A2O2JVGC9I87H9,Trevis Thomas,20090723,25,3.88,204.36,90,23,67
A2O421DTA8J0RW,"Dogs & Horses ""Spanish Norman Horses""",20070117,23,4.260869565217392,210.56521739130434,35,7,28
A2O45NYKDQCVOD,"Amazon Customer ""Tech is Good!""",20110130,35,4.714285714285714,148.5142857142857,36,5,31
A2O5V1WMIXX0NO,MetalCharlie,20120917,23,3.782608695652174,307.95652173913044,94,29,65
A2O6HZ2B9YSRXR,Indiana Customer,20100721,53,4.490566037735849,49.509433962264154,72,121,-49
A2O6IC9KWY8TQR,"SassySavi ""VioLetskieZ""",20110726,21,4.095238095238095,100.66666666666667,139,44,95
A2O8LMXTUV715H,Young NYer 10,20131012,26,4.653846153846154,67.84615384615384,5,1,4
A2O8NZSY5H5BB2,Zzzzz,20091108,25,4.72,107.28,27,15,12
A2O8OE08KQ234C,L. Topper,20070527,30,4.5,415.8,509,61,448
A2O8W12ETN43M9,Tirra,20110820,25,4.36,122.72,44,0,44
A2O9NU8P1PHZMY,"Nancy J. Boyle ""Nancy J. Boyle""",20111228,21,4.523809523809524,299.5238095238095,46,3,43
A2O9ZGE4NN9XP1,"Haze Blackmon ""NinjaMagicianRollinOnDubs""",20080304,32,4.5,342.96875,160,49,111
A2OBBNQ6O4JIJ4,Loadnabox,20110518,23,3.6956521739130435,99.73913043478261,8,1,7
A2OBDNQ5ZYU1L8,"Diana De Avila ""MS Gkygrl""",20071026,94,4.297872340425532,263.4148936170213,358,113,245
A2OBG64SMNSGFW,chiflatin,20110302,23,4.260869565217392,227.08695652173913,44,5,39
A2OCDK0BOW6UCY,Antigone Walsh,20100623,28,4.0,141.14285714285714,6,4,2
A2OCKYZ68UE4AC,Mrs. Mary M. Peterson,20110708,24,4.5,70.58333333333333,5,3,2
A2OEOZZFSSCDZW,DL,20100614,42,4.833333333333333,85.38095238095238,85,89,-4
A2OEPMLEWAF9A4,Ryan123,20111118,21,4.857142857142857,41.333333333333336,16,0,16
A2OESAJV3U3I1V,"R. J. Benson ""bjornsen""",20011014,25,4.28,143.56,29,11,18
A2OETOGU3YETB7,Skitty,20081206,25,4.28,98.6,64,18,46
A2OFOUA4N2WW1L,Jon,20051224,37,4.324324324324325,64.54054054054055,71,6,65
A2OGHYF3EW3XQD,D. Jacobsen,20111007,30,4.633333333333334,80.86666666666666,10,3,7
A2OIIRC3TY5QFZ,John Photo,20100919,21,4.761904761904762,73.57142857142857,39,4,35
A2OKRGHIYTBQ6P,"Lewis A. Edge Jr. ""Happy Traveler""",20060129,87,4.459770114942529,261.0919540229885,1167,72,1095
A2OL5WLCNZVD9K,nonpareil,20100726,41,4.7317073170731705,206.09756097560975,93,4,89
A2OLTRWQKKDD5E,"K. O'Meara ""keVuVa""",20081210,27,4.333333333333333,75.85185185185185,8,2,6
A2OMQEK9OW2FY6,Brad B,20070222,35,4.628571428571429,143.6,169,43,126
A2OMSTQSR37Q6S,"drpret ""Preetham""",20091011,22,4.7272727272727275,47.09090909090909,12,1,11
A2ON97OHTZFNWC,Les,20120425,37,4.837837837837838,227.51351351351352,102,13,89
A2ONVMBM8Y3NHM,Chad,20090816,25,4.72,314.28,132,18,114
A2OOHJ3EJTSUIB,dm,20110209,22,4.136363636363637,85.18181818181819,46,4,42
A2OOLI2WFY4L2,Matthew W. Whitmore,20110824,59,3.8135593220338984,42.74576271186441,9,15,-6
A2OOXVZ6B1VZ9A,"Thomas Simmons ""Big Ugly Guy""",20100723,36,4.666666666666667,76.13888888888889,20,2,18
A2OQG48HWD6L75,"Inventor ""InventorNC""",20071110,30,2.7,132.96666666666667,72,83,-11
A2OR4QUQSUMOW7,"A. Brinskele ""Ang""",20110519,35,4.285714285714286,150.31428571428572,26,12,14
A2OR94VN7XQCUO,"Edward Scott ""ewscott""",20071221,27,4.481481481481482,181.4814814814815,22,3,19
A2OS3TIVAKUAHG,J. York,20060709,66,4.090909090909091,476.3181818181818,2018,171,1847
A2OT3PDH1AWLTG,Timewarpone,20080601,42,4.809523809523809,167.73809523809524,79,9,70
A2OTFNASZFDVFT,D. Griffin,20050215,21,4.0,78.80952380952381,26,3,23
A2OTLOW1BSB90M,Ricochet,20091227,27,3.8518518518518516,271.7037037037037,82,27,55
A2OTQMC69J8MUI,Emileigh,20110317,48,4.083333333333333,89.77083333333333,32,6,26
A2OTSPWEFJURH8,Wolfy,20090517,26,4.423076923076923,350.03846153846155,763,72,691
A2OTT4J4JLCL1G,"C. Gregory ""C. Gregory""",20100228,25,4.4,171.92,17,6,11
A2OUC9HMZEFI1L,P. Cassidy,20070508,25,4.6,113.96,102,29,73
A2OUOTJQ1W8L25,BIO TREK,20100718,21,4.142857142857143,125.04761904761905,24,16,8
A2OV0EKZK35VC1,Jorge's Amazon,20121026,25,4.12,60.88,9,0,9
A2OW1FKQFPIA5D,DMD,20100218,29,3.5517241379310347,143.13793103448276,23,12,11
A2OWR5G2OAQF7C,Sincerely Yours,20080220,89,4.49438202247191,146.56179775280899,743,76,667
A2OX0OABBPEJDA,Junlei Li,20040423,33,3.212121212121212,165.63636363636363,37,11,26
A2OY5YNT2040OT,cruzer,20110727,28,4.5,81.71428571428571,2,3,-1
A2OYPRPEGG9UYB,JUD,20101221,24,4.583333333333333,32.958333333333336,2,13,-11
A2OZ18OTQL61EP,Village Idiot Savant,20101010,22,3.1363636363636362,130.13636363636363,46,34,12
A2OZ5ERO1D2YOX,Jeffrey F Knakal,20130828,26,4.653846153846154,98.15384615384616,13,2,11
A2OZ6PW2W5FQTP,Kathy,20080730,30,4.5,194.2,27,14,13
A2P07C09N1Z2GX,Rex Kullmann,20061019,30,4.2,500.06666666666666,935,90,845
A2P0N9VQK6EXPS,"Charles Scott PA ""Air America""",20110125,23,4.304347826086956,138.04347826086956,19,3,16
A2P21X0R9STU7T,"Britton30 ""Grouch""",20110208,42,4.071428571428571,47.76190476190476,18,23,-5
A2P2EJ6SG8PAK8,Craig Barker,20100106,24,4.375,64.83333333333333,13,2,11
A2P2QJXEQU5BIM,"Lynchphile ""LYNCHPHILE""",20130702,27,3.7037037037037037,57.370370370370374,7,2,5
A2P3V1BG6FMUS5,Z Io,20100423,42,4.404761904761905,92.73809523809524,31,4,27
A2P6EPQ906M3AJ,"Thomas E. Hudson ""THudPHud""",20031203,30,4.566666666666666,192.96666666666667,78,11,67
A2P6QCZWW3H1X6,"Londonnoise ""Robby""",20081030,35,4.285714285714286,88.0,84,34,50
A2P6U7HBYZ3QQO,"Neil J. Katz ""blegs38552""",20060703,27,4.37037037037037,122.77777777777777,56,11,45
A2P7N9VW82JOKE,Charles M.,20100822,22,4.7272727272727275,157.3181818181818,53,1,52
A2P8384ORUDZJ7,"D. Lye ""DL""",20130329,29,4.551724137931035,47.172413793103445,5,5,0
A2P8JK1L1WHDOV,Waslost1,20111017,25,4.2,137.12,13,1,12
A2P8SOTYJJYIC0,Jocelyn Carpenter,20121102,29,4.620689655172414,48.58620689655172,18,3,15
A2P9DB888ORN66,TriTroy,20070120,46,4.565217391304348,104.08695652173913,23,7,16
A2P9JAFUZBBVGH,Mark,20041217,23,4.3478260869565215,169.56521739130434,120,23,97
A2P9KNX5JRKPKH,Kenneth Osherow,20060529,30,4.6,113.33333333333333,47,17,30
A2PATWWZAXHQYA,Farnoosh Brock,20060609,40,4.4,95.45,31,16,15
A2PB325LKXYDOL,Mike Kelley,20121126,38,5.0,32.78947368421053,8,6,2
A2PBLCGKZLKYK7,Max M.,20070721,31,4.645161290322581,74.93548387096774,72,65,7
A2PBMCBT1R8TTL,Sam I Am,20080620,25,4.76,63.6,31,16,15
A2PC6KJ50P32KE,Va Trail Rider,20120129,25,4.64,85.24,59,10,49
A2PC9ZZIFV31B1,bk,20080902,49,4.1020408163265305,155.73469387755102,93,22,71
A2PD27UKAD3Q00,"Wilhelmina Zeitgeist ""coolartsybabe""",20050127,33,4.575757575757576,192.06060606060606,23,19,4
A2PED5QNFA6T64,bhayes,20120223,22,4.318181818181818,122.9090909090909,3,0,3
A2PFVDGU5JZN13,tela,20071117,37,2.5675675675675675,240.13513513513513,201,16,185
A2PHRC1HCFR8A1,T. Copeland,20130302,24,4.208333333333333,58.708333333333336,2,1,1
A2PHW6BGDXA7S6,Susan Teq,20070621,21,4.380952380952381,110.33333333333333,35,5,30
A2PICNZWHEINQC,Larry,20110622,53,4.547169811320755,128.73584905660377,187,16,171
A2PJH18W4XHTZW,J. Karol,20070104,62,4.419354838709677,74.03225806451613,46,12,34
A2PK64OVZA1U8Z,Jakester,20020208,75,4.306666666666667,187.53333333333333,456,78,378
A2PL06HW6KZH2,"Mike B 122061 ""Want only the best; Take only ...",20130208,52,4.384615384615385,100.90384615384616,14,12,2
A2PL0US7RN67G,"Jennifer ""Jennifer""",20080805,28,4.357142857142857,134.67857142857142,86,18,68
A2PL4KZQJ0VFOB,"D. Dell ""Dell""",20060101,28,3.6785714285714284,216.21428571428572,418,65,353
A2PLFPDNN1IL36,D. Auffret,20130129,30,3.466666666666667,52.733333333333334,9,5,4
A2PM1K1MNB0328,NYer,20121025,22,4.636363636363637,66.22727272727273,14,4,10
A2PMIMM3U3THM7,vqworks,20080130,23,4.6521739130434785,381.30434782608694,546,47,499
A2PMR2PIGWKCQ9,Ms. T,20080219,72,4.263888888888889,226.06944444444446,179,33,146
A2PN3GY7I3EKC1,"N. McArthur ""MyTech""",20130721,21,4.857142857142857,42.333333333333336,2,0,2
A2PN65B6BSTIYZ,B. A. Chaney,20071211,23,4.304347826086956,198.7391304347826,86,8,78
A2PNBEVAMV28R8,"Dealzguy ""Dealzguy""",20081111,37,4.243243243243243,145.48648648648648,57,22,35
A2POXR5VS3PHKR,Macondray J. Steiger,20060728,44,4.7272727272727275,58.43181818181818,143,18,125
A2PQ1IZY7T6QXY,"GamePlayer ""Game player""",20070828,26,4.8076923076923075,54.11538461538461,28,1,27
A2PQ3WXMKCT4NX,MariaSmiles,20100519,22,3.9545454545454546,576.8636363636364,923,53,870
A2PQ9RZVB9D1OO,"Steven W. Neighbors ""RootsFinder""",20070517,22,4.954545454545454,62.13636363636363,14,10,4
A2PQUL8TI4P4HV,Nakkiel,20110702,29,4.0,118.89655172413794,21,19,2
A2PQZ5WHZ6W841,"T.Chance ""Travis Chance Photography""",20090628,29,4.758620689655173,63.758620689655174,27,2,25
A2PR4CK7LT29EV,"DeenaS ""Love to fish""",20040809,27,4.481481481481482,72.11111111111111,12,3,9
A2PR5G1680ISEY,David Arnstein,20050822,34,3.5294117647058822,269.1470588235294,1194,98,1096
A2PREU4LOFQRB1,Fishing Fool,20080806,81,4.481481481481482,255.90123456790124,1535,122,1413
A2PRIQ2EA5GYML,William M. Gibson,20050313,30,4.433333333333334,342.1333333333333,752,44,708
A2PSC7LUNIDEAH,Dmitry Kristal,20031216,64,4.53125,178.21875,108,43,65
A2PSD2R9A1CXG7,"L. T. Beasimer ""www.LBphoto.net""",20050928,120,4.083333333333333,429.05833333333334,3250,232,3018
A2PT20HWKO2IQ5,Aiden,20100105,27,4.37037037037037,266.44444444444446,220,4,216
A2PT8MAH3G2I6Q,K. Willms,20050629,28,3.857142857142857,95.78571428571429,42,4,38
A2PTFW5G285RHT,Jobarda,20100927,24,4.0,109.29166666666667,30,5,25
A2PUSR7ROG0Z6T,"Terry Bisgrove ""Mr.E.Man""",20090717,26,3.730769230769231,94.38461538461539,31,9,22
A2PVPV435P05SX,David Jashi,20110125,25,4.24,65.52,21,11,10
A2PVWWQFE3SRF8,"Dustin Face ""Mr. Face""",20091202,24,4.458333333333333,110.83333333333333,18,6,12
A2PW29SY7QZ6YM,Maine,20091211,21,4.285714285714286,60.38095238095238,26,4,22
A2PY5ED630H0QJ,reluctant techie,20060124,49,3.8979591836734695,168.46938775510205,460,86,374
A2PYS280Q1UH7V,"C. Allen ""C A""",20010620,23,4.869565217391305,91.52173913043478,165,5,160
A2PZJYHC2342W,"Nikon131 ""Nikon131""",20011026,40,4.65,249.35,249,16,233
A2PZKHQ3CDLU8Y,Alex Daniels,20100615,23,4.217391304347826,193.08695652173913,67,15,52
A2PZO2V0HWG7IF,Albert Lee,20110406,28,4.285714285714286,72.82142857142857,14,1,13
A2PZXXPGLXXKZU,AK529,20061001,86,3.755813953488372,364.36046511627904,235,39,196
A2Q0453VEQDU3E,Rebecca,20080730,24,4.708333333333333,92.04166666666667,15,4,11
A2Q1046M09398P,"Cynthia E. Downes ""Cindy Downes""",20110114,28,3.857142857142857,256.0,114,32,82
A2Q204DY2L7YRP,P. Hartung,20100302,53,4.60377358490566,127.18867924528301,868,41,827
A2Q2A6JKY95RTP,R. Garrelts,20080602,56,3.9642857142857144,515.375,535,40,495
A2Q2E376N7Q1YY,"wickeddr ""MR-HeMpY""",20110911,42,4.904761904761905,69.78571428571429,15,9,6
A2Q2T2SCXTY4LY,OrangeMonkie,20110322,28,3.857142857142857,91.89285714285714,55,12,43
A2Q2VUSLNM0MUP,PJDSR,20121214,30,3.6,47.86666666666667,12,34,-22
A2Q3EQ7YPKQDLP,"Albrecht Family ""Albrecht""",20121112,31,4.225806451612903,292.2258064516129,8,1,7
A2Q3P65H0I5QNS,"B. A. BANISTER ""Killer_B""",20120602,30,4.1,194.9,59,13,46
A2Q3W6WA59IKA,Michael J. Troutner,20080106,21,3.761904761904762,113.57142857142857,46,29,17
A2Q42HSJ7Z27SL,Rick Rasor,20111128,23,3.6956521739130435,86.8695652173913,17,4,13
A2Q6H92WBKH0QB,Michael Goodman,20020430,21,3.3333333333333335,167.57142857142858,74,20,54
A2Q6KC2KU2T0OL,A. Tapia,20120216,23,4.739130434782608,65.04347826086956,3,0,3
A2Q7OJTVPIO2XH,Kenneth J. Hudak,20121104,51,4.176470588235294,113.41176470588235,89,71,18
A2Q8F1MFF5742M,SpaceCowboy369,20121013,28,4.392857142857143,72.39285714285714,5,10,-5
A2Q8F1TIFWY83C,Brute44,20131227,25,4.2,44.12,5,1,4
A2Q8GFSEUSGJ51,S. WIlliams,20020729,34,3.1176470588235294,259.11764705882354,146,36,110
A2Q8J8IL6V9M5T,"K. Lechliter ""Walker Boh""",20010319,43,4.767441860465116,62.0,12,2,10
A2Q8Y9D4KOI2HX,Steven L.,20071224,21,4.142857142857143,57.19047619047619,10,3,7
A2Q987OD3HVZJM,John,20060613,23,3.391304347826087,362.04347826086956,210,58,152
A2Q99N7P0XCV26,John T. Desantis,20081231,26,3.230769230769231,130.73076923076923,28,46,-18
A2Q9JKXADL7J87,rigurat,20110222,23,4.608695652173913,41.47826086956522,7,2,5
A2QAN27NWI581E,Margaret J. Lynne,20090208,23,4.6521739130434785,62.65217391304348,10,1,9
A2QAOP52OEB5EV,"dasn0wman ""dasn0wman""",20021103,44,4.045454545454546,251.22727272727272,223,203,20
A2QAZW64EZDJ7Q,"Jeff T. Klipp ""Jeff K""",20030126,34,4.735294117647059,86.67647058823529,48,5,43
A2QDA2XJ1X27N6,"Dariushd ""sirlee""",20110607,41,3.8780487804878048,109.29268292682927,58,11,47
A2QDM4CRXTAOCK,Amazon Customer,20100721,21,4.523809523809524,267.42857142857144,112,11,101
A2QDOJFFLFGF18,"Mr and Mrs Michael Alexander ""greenacres""",20091014,82,4.670731707317073,79.0609756097561,51,26,25
A2QEZU2SHYBHM5,"Tom Carpenter ""Techie and Bible Believer""",20060331,23,4.6521739130434785,128.95652173913044,592,75,517
A2QGLZST7ZYEOJ,Mary Lou Cochrane,20110817,21,4.666666666666667,94.0952380952381,41,6,35
A2QH51T8VKXFMB,CW. Scogin,20080916,23,4.304347826086956,105.52173913043478,12,7,5
A2QI1GE82K0PMH,JB,20080827,29,3.3448275862068964,145.0344827586207,147,32,115
A2QI2JHSIQ3SN3,Drake Johnson,20070326,59,4.627118644067797,99.20338983050847,108,23,85
A2QI2NTDTMK2FV,Jerry Palmerino Jr,20010406,96,4.21875,202.20833333333334,467,60,407
A2QIC4G483SQQA,Jacob M,20110118,37,4.297297297297297,83.67567567567568,34,17,17
A2QJ1O5FGSX8LV,"J. Nash ""Techie""",20120527,22,3.8636363636363638,141.72727272727272,38,13,25
A2QK3M98622I8P,Cherie J. Hepburn,20110904,21,4.809523809523809,70.04761904761905,20,3,17
A2QKSRK4JYWKOS,greendayrules,20110707,29,4.448275862068965,42.3448275862069,126,27,99
A2QL3AISOKZCX3,"Michele ""Michele""",20040408,21,3.6666666666666665,169.1904761904762,55,14,41
A2QL4DCXUC3P69,B. Brooks,20111016,28,4.571428571428571,69.57142857142857,32,11,21
A2QNJARWTF9H89,"William D. Colburn ""buys things on amazon far...",20041201,22,4.0,221.0909090909091,683,138,545
A2QNMPNXW1QAQ5,"Darren He ""in Boston""",20061108,36,3.888888888888889,206.16666666666666,650,45,605
A2QNN4KCJ7KV6,"Tom Servo ""Zach""",20090830,23,3.5217391304347827,234.34782608695653,13,7,6
A2QNODR542GZTA,"IMHOGYLD ""John""",20130414,24,4.708333333333333,89.91666666666667,5,4,1
A2QNS95WGN35G9,Jason,20061219,53,4.622641509433962,392.0566037735849,1089,75,1014
A2QOEIO4EF26UF,Gadget Girl,20060217,28,4.464285714285714,127.89285714285714,25,2,23
A2QQ06GUU1APAY,John Adams,20050826,26,3.1923076923076925,171.07692307692307,289,44,245
A2QQ0UP16AWCRH,Nusaram,20130317,31,3.6451612903225805,81.12903225806451,36,17,19
A2QRW6IQ7CSK5G,Jon Gerow,20100422,30,3.6666666666666665,86.76666666666667,52,20,32
A2QRXQPHDMFCQV,"SanjeevP ""Bottom Line""",20061112,123,3.3821138211382116,253.29268292682926,2060,216,1844
A2QSE570MZRKTU,Billy Waldrop,20130215,26,4.038461538461538,49.23076923076923,4,2,2
A2QSKVQU34BVIP,mccoytactical,20110426,26,4.769230769230769,143.07692307692307,48,6,42
A2QSLO51UFKCBO,Sandy Eggo,20080511,34,4.588235294117647,35.64705882352941,16,10,6
A2QT3TUZKVW5ML,"Kasanwidjojo Romeo ""rom""",20081017,27,4.518518518518518,76.33333333333333,28,8,20
A2QTXAQ7FV5H80,Theodore L. Wirth,20111229,22,4.590909090909091,175.8181818181818,31,10,21
A2QU97Q6TUSN6D,"J. Smith ""ProPhoto""",20040123,21,4.476190476190476,147.61904761904762,140,21,119
A2QVPKYSEBO172,"Herb Lippe ""Indi""",20130305,21,4.380952380952381,73.28571428571429,14,5,9
A2QW4HHHC6XWH4,Mathlete,20140108,30,4.1,329.1,40,8,32
A2QY0WD2JLWUKS,101TRUK,20101103,26,4.038461538461538,88.15384615384616,15,5,10
A2QY9V7Y0IGTDX,Cognizant,20100412,21,4.428571428571429,35.95238095238095,6,3,3
A2QZL70QQRT2EN,"R. Billie Hawkins ""Billie Hawkins""",20110404,23,4.608695652173913,50.73913043478261,6,1,5
A2R0FHBR9OBFGM,JTroth,20121116,24,4.125,115.625,1,0,1
A2R0MYROYFQIXY,Donna,20070328,23,4.782608695652174,34.69565217391305,12,6,6
A2R0NV8K4QP2XH,James F,20110623,23,3.8260869565217392,216.2608695652174,38,11,27
A2R1HAXRNU0QX7,RMurray847,20030409,23,3.8260869565217392,305.6521739130435,137,10,127
A2R1HUYHXV7H18,Kristi Gilleland,20091128,56,4.589285714285714,276.69642857142856,108,48,60
A2R1LE5SFJ1GXP,B. Moore,20090505,29,4.724137931034483,101.72413793103448,28,3,25
A2R200XWDIMY9M,damianicus,20110406,24,4.083333333333333,75.79166666666667,22,6,16
A2R27MAG4MAQN4,"Donald ""COBOL guru""",20081219,31,4.709677419354839,45.483870967741936,25,2,23
A2R2EOXV5UXHGH,Joyce of Sibu,20110622,23,2.391304347826087,114.73913043478261,159,652,-493
A2R38DKWTNO6TB,Jan Hasik,20130213,25,5.0,22.28,4,1,3
A2R3EBL63KHUUZ,Dave,20110111,23,4.217391304347826,92.56521739130434,18,12,6
A2R5FNKBK3C8ZP,Robert Martinez,20090915,21,4.523809523809524,72.38095238095238,18,4,14
A2R5TGI1ZJETUA,"Campmaster Tom ""There's no place like 127.0.0.1""",20070121,33,4.909090909090909,48.42424242424242,20,9,11
A2R6F8XP2DL6RC,William W. Smith,20010722,39,3.8461538461538463,141.0,273,26,247
A2R6RA8FRBS608,Matthew G. Sherwin,20060304,96,4.5625,285.46875,1384,120,1264
A2R7YV17RBJDX5,"Brett Smith ""smitbret""",20110314,27,4.296296296296297,159.77777777777777,122,9,113
A2R80172BBNSTA,"J. Miller ""multi-user""",20021114,31,4.32258064516129,80.87096774193549,58,30,28
A2R95Z7PTF5ZRO,AmazonFan,20080226,21,4.428571428571429,205.23809523809524,19,7,12
A2RAEL8388JNN,C. W.,20110716,26,4.538461538461538,69.5,34,8,26
A2RAZD36HY2ALI,B. Horne,20090316,30,4.933333333333334,87.43333333333334,20,9,11
A2RDR5G65D9H84,Sebastian Fernandez,20071006,23,3.9565217391304346,246.1304347826087,453,50,403
A2REOP8I34E9S9,"Anthony ""ANT""",20061207,28,4.357142857142857,106.92857142857143,21,6,15
A2RFF5J7GMDIX,Skippy @ Ole Miss,20111031,27,4.777777777777778,42.888888888888886,57,16,41
A2RG1B0K8YBJ4A,Mac Coder,20011110,48,4.4375,106.97916666666667,258,20,238
A2RG6V2HH02U0M,Stephen Pellerine,20101217,21,4.571428571428571,152.66666666666666,36,16,20
A2RGA7UGAN3UL7,"Eric ""-Eric""",20100512,47,4.638297872340425,53.04255319148936,13,9,4
A2RGWCT6K2C3EZ,"Tim Kimzey ""fstop""",20090916,43,4.465116279069767,545.7674418604652,404,42,362
A2RH40BEAX3V8P,RJC,20081203,35,4.314285714285714,83.48571428571428,90,18,72
A2RHV42BTJSVON,"Liolania ""In2Jesus""",20070921,27,4.111111111111111,268.55555555555554,64,23,41
A2RI4QE6EO29CA,J. F. Hindy,20090811,44,4.840909090909091,318.72727272727275,103,6,97
A2RIL2NXHE00AQ,Don't Stop Banana,20070116,83,4.590361445783133,216.18072289156626,384,37,347
A2RITNUUBSVU1W,shadez82,20121128,28,4.142857142857143,98.10714285714286,5,2,3
A2RIXSMGE9VIBG,The Count,20050526,53,3.849056603773585,136.52830188679246,150,88,62
A2RJ3M1MPO3YGM,Brian Guinitaran,20110410,29,4.275862068965517,204.86206896551724,45,4,41
A2RJE018IGW0K1,"CarGuy ""BOBL273""",20050819,42,4.285714285714286,68.42857142857143,81,13,68
A2RJKVBUNZCSXI,Michael P. Holahan,20090202,29,4.413793103448276,39.62068965517241,11,6,5
A2RJOSXT2OQONA,Standoffish Dan,20130207,23,4.304347826086956,48.91304347826087,11,3,8
A2RK3CB7LX9ZL8,"Journey ""Journey""",20100326,30,4.266666666666667,108.96666666666667,25,7,18
A2RK4PFV1GGL4V,ThatGuy !,20131208,23,4.913043478260869,39.65217391304348,2,2,0
A2RKI7RPP5CJMG,"K. Fontenot ""Prairie Cajun Regenerated!""",20041004,30,4.166666666666667,281.3666666666667,215,15,200
A2RLFKKO2U1KRY,Paul Ruff,20120427,35,4.114285714285714,40.68571428571428,5,6,-1
A2RLPYOQDA46LZ,J.Levins,20080326,38,4.421052631578948,157.0,286,13,273
A2RLQKE9NHSSZB,Ghost,20080216,22,4.863636363636363,78.04545454545455,2,4,-2
A2RN2AO4BE6F4K,"Scott Bright ""scottypotty""",20071125,79,4.379746835443038,260.253164556962,319,70,249
A2RNYW2HIQBGSM,Carlos Alvarez,20090330,33,4.393939393939394,83.3030303030303,50,7,43
A2RO3VB5MDP13B,R. Knowlton,20080119,31,4.548387096774194,241.7741935483871,300,21,279
A2ROZACRW31PC2,Tom Servo,20090514,51,3.5686274509803924,425.27450980392155,1310,80,1230
A2RQOO8VYAEZZG,Cupcake,20071210,30,3.966666666666667,226.1,103,16,87
A2RR5Y6DY5YN3N,silverwolf,20120530,31,4.709677419354839,59.935483870967744,11,4,7
A2RS66Y79Q8X0W,"Rexomus ""One man with courage makes a majority.""",20090605,46,4.543478260869565,164.2826086956522,193,14,179
A2RTBVFBVJYRF7,"Ariel Fisher ""Mermaid in the Shade""",20100622,21,4.523809523809524,370.14285714285717,51,8,43
A2RTGJ0ZR93ECB,donosan,20120401,23,4.739130434782608,80.82608695652173,11,4,7
A2RTV22KYSOSV1,Mike,20110913,41,4.487804878048781,62.24390243902439,16,12,4
A2RTVGR9B1M600,Johannes Luijten,20051005,43,4.186046511627907,134.97674418604652,188,23,165
A2RU4U1JZ3DMP5,"Omega Man ""Technoanalyst""",20090707,82,4.219512195121951,437.6585365853659,1638,99,1539
A2RUUTTFJQ7CBH,Anton Tobias,20061015,30,3.6,445.93333333333334,3103,416,2687
A2RV56C21T320Y,Sam,20040517,24,3.3333333333333335,165.83333333333334,157,47,110
A2RVC3V2OS1V3S,"DP ""mundodelguy""",20080226,30,3.2,59.93333333333333,35,36,-1
A2RVER4CFGXQZF,"mars ""Americanshores""",20091012,22,4.363636363636363,181.13636363636363,295,33,262
A2RW587355CMVA,almosthappy,20041019,71,4.098591549295775,183.92957746478874,482,141,341
A2RW7HRPOIXNDN,Rico,20111010,22,4.7272727272727275,55.81818181818182,14,1,13
A2RWHTNM5P3I8Y,Sheryl Katz,20010708,78,3.9743589743589745,214.67948717948718,560,163,397
A2RWQ4D204NGWJ,H.L.,20100813,21,3.6666666666666665,70.19047619047619,37,8,29
A2RX62V4E2BF5Z,"Celeste ""Vodka, Apple Pucker & Sweet 'n' Sour""",20080629,47,4.0638297872340425,200.08510638297872,150,56,94
A2RYJQPMNVOWK6,Jack,20130402,30,4.0,42.266666666666666,11,5,6
A2RYRRTUZW9ZSC,"Italo La Posta ""Roman One""",20090409,23,4.173913043478261,51.04347826086956,13,9,4
A2RZESQH3U5LJQ,"chop66 ""chop66""",20110414,21,4.476190476190476,127.38095238095238,24,4,20
A2RZK8D5H6Q711,Todd,20140508,24,4.458333333333333,82.45833333333333,6,3,3
A2RZU0LLUFWU0R,Amazon Customer,20120424,25,3.92,107.44,31,13,18
A2S0J0M5DNW5,Hayden,20121231,32,4.6875,35.375,8,5,3
A2S11NS16SO2BJ,Amazon Customer,20120529,22,4.409090909090909,129.1818181818182,30,1,29
A2S13NSRLNW59V,Amazon Customer,20081008,34,4.323529411764706,277.94117647058823,247,55,192
A2S26YGSVXBCFL,"Morley Dotes ""morleydotes""",20041105,104,3.9615384615384617,333.5192307692308,713,141,572
A2S2EVLLDUTQX9,TTALLY,20130318,32,4.96875,67.15625,20,13,7
A2S37P50AYCUYV,"J. Minatel ""jimmin""",20041210,26,4.269230769230769,261.9230769230769,185,17,168
A2S3BQR57RDW2V,David Hutchinson,20080519,28,4.857142857142857,60.142857142857146,48,21,27
A2S46SZ8UAI3DT,Richard,20101130,30,4.4,53.86666666666667,12,1,11
A2S4UJPROMTGMT,SHEiK124,20080819,28,4.464285714285714,186.85714285714286,17,5,12
A2S549B4743R0S,"Michael P. Kukielka ""BORG""",20060314,25,4.16,286.88,89,17,72
A2S6QCNNN8AK91,Denyse Roberts,20120816,28,4.571428571428571,139.46428571428572,58,9,49
A2S6T0AUW40S28,gprez,20110416,30,5.0,116.6,21,6,15
A2S76R8E0KP5LL,"Daniel Lenzmeier ""psykohed""",20040927,26,3.3461538461538463,114.03846153846153,113,156,-43
A2SA6LR78V49UV,"OrangeCrush ""Still shooting with Film!""",20090216,23,4.304347826086956,594.6521739130435,974,45,929
A2SATO5BNKWY3Y,B.A.M.,20100726,63,4.571428571428571,47.666666666666664,3,3,0
A2SAW87BJ0XVK1,"ALEXA ""ALEXA OAKS""",20120717,22,3.9545454545454546,24.045454545454547,15,13,2
A2SBFXPN5V6A6X,"L. A. Dye ""700hpAMG""",20070813,26,3.230769230769231,419.65384615384613,153,33,120
A2SCEWWILKJM0H,NiW,20120326,26,4.6923076923076925,59.5,9,1,8
A2SCLUSIIR1CXT,"H. Copelin ""TREY""",20110419,29,4.517241379310345,77.72413793103448,18,5,13
A2SCWL7CTMKZTX,"James S. Yelverton ""Getagrip15""",20050919,34,4.294117647058823,87.76470588235294,84,41,43
A2SDA5LOD7577T,Kon Peki,20100419,32,4.5,197.53125,321,36,285
A2SDRCBPIAXVDW,J. Plummer,20091221,33,4.181818181818182,123.45454545454545,21,8,13
A2SEJZ4E8N675N,Araxiel,20020927,23,5.0,128.30434782608697,18,1,17
A2SEQUFN8W7D07,Michael,20100921,26,4.384615384615385,82.26923076923077,33,10,23
A2SEXSXMMH4VYX,C. Gahagan,20110110,32,4.5625,109.3125,58,9,49
A2SFN1ZTPFDQVU,Kodachrome man,20050104,40,4.45,151.325,353,34,319
A2SGAJWXG65464,Anthony,20100323,55,4.054545454545455,169.96363636363637,269,65,204
A2SH6A32BE6NEV,"Comp Expert ""Comp""",20060926,90,4.277777777777778,232.9,224,45,179
A2SH7OWE8QJYNC,Kaleidocherry,20021103,41,4.170731707317073,141.21951219512195,158,67,91
A2SID5XRX582QL,Duke012,20101027,22,4.5,122.5909090909091,56,10,46
A2SJ3UV3NVZKG5,Rockwell,20090106,31,4.354838709677419,96.80645161290323,48,7,41
A2SJ7ZVEB9O0KW,"B. D. Ogues ""DonLee""",20090801,27,4.851851851851852,87.33333333333333,42,5,37
A2SKEQT0WTB954,Big-Z,20020912,98,4.581632653061225,116.70408163265306,731,116,615
A2SKZZZBV1XYWP,Sledman,20081212,22,4.318181818181818,255.95454545454547,133,7,126
A2SL5IW096Z2BL,"Eric B. Wolf ""Geek of Many Trades""",20010704,55,4.418181818181818,229.0909090909091,172,16,156
A2SLM5PQCKFC0Z,"Kenneth McKenzie ""hotjazz2b""",20120702,28,4.0,134.07142857142858,20,20,0
A2SLTO5Q1MWWRB,Steve A.,20081216,40,4.45,47.95,12,5,7
A2SLX6UHHYCMCV,"M. Cordoba ""mxc""",20030922,29,3.2413793103448274,291.0344827586207,109,30,79
A2SM4OZXOEMTV1,"Powell Family ""Superman""",20090204,23,4.739130434782608,115.69565217391305,21,8,13
A2SNE4QQGVP13U,J. Marsh,20120122,50,4.38,100.18,60,14,46
A2SNHNNHXZRMAC,Robert,20121124,26,3.5,35.11538461538461,4,5,-1
A2SNID1IYR1TBU,The Grinch,20110427,25,4.72,67.88,24,2,22
A2SP52NH44LRDS,Happy r/c,20070904,44,3.2954545454545454,241.36363636363637,304,132,172
A2SPV96SGOEO2,The Travelin' Hrncirs,20060410,58,4.275862068965517,375.51724137931035,160,38,122
A2SQ4D1YGGAQ5T,"Chicago John ""Rirelguvat vf rinarfprag.""",20100319,29,4.827586206896552,248.3793103448276,635,77,558
A2SQOPLGBR7OI3,Sergei,20110510,27,4.148148148148148,185.85185185185185,38,5,33
A2SR7S6ZJJDGNB,lily,20130527,40,4.4,110.575,162,30,132
A2SR85GOWPMNMN,Nosferatu,20110620,25,3.6,99.16,30,23,7
A2SRVDDDOQ8QJL,MJ23447,20031020,44,3.8863636363636362,164.36363636363637,361,58,303
A2STI6QRXQR2A9,Iggy,20090730,21,4.190476190476191,65.42857142857143,40,3,37
A2SU13RQ4NWHRR,"Henry G. ""Gumbydammit""",20111106,25,4.76,121.4,36,4,32
A2SU3YH0H2SHRR,willwgp,20111101,21,4.619047619047619,110.04761904761905,6,3,3
A2SU79J0E61TDE,Michael R. Then,20020301,24,4.458333333333333,164.54166666666666,134,17,117
A2SUSMSKDK6JL0,B. Brent,20071023,34,4.323529411764706,55.88235294117647,15,15,0
A2SVD5ACQT24WP,"GT Man ""GTMAN""",20100626,24,3.5,50.791666666666664,52,45,7
A2SWZEBOQ5PXK,"The Q ""Q""",20110318,22,4.409090909090909,131.27272727272728,22,8,14
A2SX82K4CYWA2B,KG,20100826,22,4.590909090909091,94.0,10,1,9
A2SXL0NDPTP9X9,Andrew Clausen,20100619,24,3.875,99.91666666666667,22,5,17
A2SYAQXJGRY3XE,aznpoet,20101201,76,4.105263157894737,144.19736842105263,151,6,145
A2SYCKV9A2SE0F,"Abhinav Agarwal ""AA""",20030915,37,4.081081081081081,280.6216216216216,133,23,110
A2SYLJAZO4SPA0,Pathguy,20060822,28,2.9285714285714284,65.96428571428571,130,104,26
A2SZLNSI5KOQJT,Carrie,20081209,55,4.236363636363636,243.1818181818182,659,79,580
A2SZWMS0CRJ0T2,"Eugene Lisansky ""mrnews""",20040922,21,4.0,260.2857142857143,89,1,88
A2T04VAIXSKJH2,"Stefan ""Stefan""",20000205,28,4.178571428571429,212.82142857142858,242,19,223
A2T24Z5QP2OMXU,Francisco Ortiz,20100722,46,4.282608695652174,73.1304347826087,18,4,14
A2T3S3VTW65VO5,"Tony ""SergeantPope""",20100624,69,4.6231884057971016,146.2753623188406,73,24,49
A2T463WX091RTX,Bruce Philpott,20070512,21,4.428571428571429,91.66666666666667,28,9,19
A2T4CV13XH6OJZ,"jhonatandt ""JADT""",20121202,26,4.269230769230769,45.88461538461539,4,6,-2
A2T4OX8NH9LIIC,"J. Hornback ""twister""",20070905,26,4.5,54.26923076923077,14,8,6
A2T4XPDLZBP7XN,Jakethesnake,20111104,28,4.285714285714286,54.857142857142854,29,6,23
A2T689YVOAYGGD,"Acontius ""Acontius""",20050309,70,4.185714285714286,252.88571428571427,347,55,292
A2T6A1P581H1R9,Pedro A. Vera,20070601,35,4.8,305.9428571428571,134,23,111
A2T7GZ74MZI0MN,"J. Nusz ""Author, reviewer & graphic designer""",20081204,29,4.275862068965517,153.68965517241378,20,13,7
A2T8YH950PQVEG,bvande,20130811,25,4.36,52.0,24,6,18
A2T9EHCUD7CNEB,"Karie Hoskins ""karieh""",20100531,33,4.151515151515151,164.33333333333334,44,19,25
A2T9EMIFA72AM6,Dannyboy,20110123,23,4.3478260869565215,165.7391304347826,22,8,14
A2TA40MV2H4O6F,"P. Repage ""FT Dad, Doctor & PT photographer""",20090605,62,4.725806451612903,88.61290322580645,232,11,221
A2TA5TMGUTPVQ2,"J. Ambriz ""Mr  J""",20050419,32,4.40625,133.25,67,144,-77
A2TBAUW2W7J538,Psychic Cypher,20080503,43,3.6744186046511627,109.3953488372093,67,119,-52
A2TBLWQX0EQHGV,Eric,20130117,36,4.638888888888889,24.52777777777778,8,4,4
A2TCHXH4SIN2OF,"Severian ""Severian""",20040810,40,3.375,1222.475,2162,172,1990
A2TFIMF502KHZJ,"Monica M. ""Monica""",20110726,23,4.608695652173913,131.0,26,6,20
A2TFRNUZOE5OLQ,Jayhan,20120626,26,4.615384615384615,193.46153846153845,861,63,798
A2TGF3A2Q5JYN8,"Oded Shopen ""odedia""",20080305,22,3.5454545454545454,65.77272727272727,50,31,19
A2TGMGZ116G6AW,Howard W.,20070626,47,3.872340425531915,268.6170212765957,179,57,122
A2THK4LTZ1EMCJ,biglove,20121218,33,4.787878787878788,54.15151515151515,16,8,8
A2THQCHKR89E16,D. Bryan,20100123,46,4.717391304347826,99.52173913043478,28,1,27
A2TI5R93FF69UN,"Jennifer D. Rhames ""Love cloths""",20130616,39,4.743589743589744,150.28205128205127,64,4,60
A2TI79NM4NCEUI,"smartydog904 ""bluedog""",20060819,24,4.416666666666667,294.5,19,16,3
A2TICS1YPCDLKA,Harry Lipson,20131112,22,4.636363636363637,43.0,4,4,0
A2TIGUXKJXBX2V,T. Nathe,20110112,24,4.375,63.708333333333336,30,11,19
A2TIP4NEY64PLK,"Fun Times Mom ""Hayley""",20120103,29,4.379310344827586,176.27586206896552,51,17,34
A2TJ6HK81DDVDT,"Sean Flanagan ""seanf""",20061219,22,3.6818181818181817,111.81818181818181,112,9,103
A2TKMA52AMCB31,William Hall,20091104,30,4.766666666666667,82.16666666666667,17,5,12
A2TKPYUXYXT5PN,Ronald J. Labellarte,20100930,26,3.9615384615384617,70.73076923076923,32,9,23
A2TKWMX4563NR6,"thenightfly ""dee""",20070824,59,3.864406779661017,83.20338983050847,43,47,-4
A2TKY9SEJOHZG6,Dave,20120502,28,4.642857142857143,30.357142857142858,7,7,0
A2TM97N0X3DM7D,Matt G,20100228,24,4.0,48.833333333333336,18,5,13
A2TMFC9O3ZCNKE,,20130412,53,3.830188679245283,51.35849056603774,15,6,9
A2TMIG9ZVHXUQ6,"Coamex ""JL""",20101012,23,4.608695652173913,167.34782608695653,62,7,55
A2TMWYPPOHS5GT,Robert.,20090802,23,3.4347826086956523,188.2173913043478,15,6,9
A2TN0U8173HM7A,acanal,20120202,55,5.0,39.54545454545455,11,10,1
A2TNDVUGHRJPA4,alter,20101104,21,4.190476190476191,125.28571428571429,22,4,18
A2TNTY0JVQGGBJ,Peter R.,20070224,21,3.5714285714285716,206.42857142857142,47,13,34
A2TP1VKHSG7X75,Unavailable,20110622,26,4.076923076923077,97.6923076923077,259,30,229
A2TPE6TCFEHY2W,M. Merritt,20080513,21,4.333333333333333,87.61904761904762,5,2,3
A2TPOBM6LNGH7L,C. Judd,20080607,24,4.625,133.5,79,2,77
A2TPZS7J2HN4RQ,Nomad77,20030307,27,4.074074074074074,183.03703703703704,539,56,483
A2TRXEZYU9GYY8,Robert F Gentry,20121230,52,4.6923076923076925,39.86538461538461,12,3,9
A2TS040W2FW5O,Heidi Anne Heiner,20081126,33,4.0606060606060606,215.3939393939394,159,39,120
A2TTHN1UMO82VY,Elle  Pece,20060111,30,4.5,64.73333333333333,46,20,26
A2TUD0VXUTNO7N,Timothy W. Long,20111104,29,3.7241379310344827,243.86206896551724,63,19,44
A2TUXUOKJHAYCI,86,20110727,32,4.09375,228.1875,34,21,13
A2TVAG2XX0LWIO,A. Fierro,20060315,21,4.285714285714286,356.23809523809524,112,6,106
A2TVH2OBNXYXHV,Evan Jacobs,20070205,71,4.028169014084507,112.21126760563381,104,68,36
A2TVJ0YDW3QO63,Dan McKinnon,20050622,48,4.604166666666667,160.20833333333334,154,57,97
A2TWI1I7ZYXQJV,netman,20121019,23,4.913043478260869,32.30434782608695,7,1,6
A2TWOOZ8IDLMQT,Valentin,20130307,21,5.0,26.333333333333332,10,7,3
A2TWW9LDI1Z1BQ,Andrew thelongdivider,20110608,23,4.956521739130435,143.82608695652175,35,3,32
A2TX6WYG005FG5,"Serge Kavetsky ""Mr. Fix-it""",20050121,22,2.772727272727273,129.0909090909091,109,11,98
A2TXIYMIN78I1V,B. Karnofsky,20070309,21,4.190476190476191,87.42857142857143,20,5,15
A2TXJMOBILMW09,"Lover Boy ""A. Font""",20080504,22,4.590909090909091,45.68181818181818,9,15,-6
A2TY271P4XSFB9,Amazon Customer,20121120,30,3.7666666666666666,34.63333333333333,12,4,8
A2TZXI0SCHBGD8,"P. Lee ""PML4""",20110314,36,4.638888888888889,89.94444444444444,12,5,7
A2TZYC3TD9RIGQ,Glenn Carpenter,20081231,23,4.173913043478261,1340.3478260869565,4005,240,3765
A2TZZKMREC92BU,rinney,20110118,23,4.434782608695652,138.91304347826087,72,15,57
A2U0LY01LK9C3E,EddieE,20110517,40,4.3,85.225,32,39,-7
A2U1UGONKQNLZO,michael qi,20110712,42,4.904761904761905,95.16666666666667,17,10,7
A2U2J7MDEF572G,"J. schmid ""blueapples""",20101111,24,3.9166666666666665,90.0,58,5,53
A2U3OEIK1CUPIK,Carbonlord,20080707,32,4.21875,73.46875,4,15,-11
A2U4107AK2O2GN,Stephen Kovac Jr.,20030219,30,4.933333333333334,127.63333333333334,114,12,102
A2U4AV00V0U6VV,"R. Yu ""RY""",20070927,28,4.25,103.46428571428571,70,25,45
A2U4Z76U7DF68,"Sujit Kumar Mahapatra ""Sujit""",20071126,37,4.081081081081081,101.37837837837837,39,8,31
A2U5SI4WJ02FIC,"jeremy ""jeremynative com""",20101029,45,3.111111111111111,169.04444444444445,90,95,-5
A2U60JTV511Q9P,Songhai,20060629,33,4.333333333333333,292.6969696969697,279,43,236
A2U6E6SHH99GGO,Mr AMZ,20110314,22,4.0,83.22727272727273,90,55,35
A2U6GHU2EMC5M5,Rawim,20081024,36,4.111111111111111,324.47222222222223,149,41,108
A2U6X0GHPCODVV,Dylan Ginsburg,19991127,40,3.8,199.9,1109,55,1054
A2U7C3979YNQV2,Alex,20120712,30,4.333333333333333,86.7,33,10,23
A2U7CZX5IEUI0Y,"Daniel Limbach ""Reader, writer, gadget guy""",20031216,22,4.636363636363637,254.72727272727272,186,17,169
A2U83VDVJMAB2U,Brian Baker,20060206,24,4.416666666666667,304.9166666666667,331,29,302
A2U8QA856AC193,Judy L.,20081111,45,4.466666666666667,268.1111111111111,95,16,79
A2UBQA85NIGLHA,"Tim  Isenhour ""Timbo""",20110403,32,4.28125,277.8125,120,21,99
A2UBS120XE605X,Frank Paris,20010713,21,4.095238095238095,516.047619047619,183,26,157
A2UBSGFCP2QFNV,"Greg Ehrbar ""'MouseTracksOnline'""",20080626,24,4.375,99.95833333333333,30,18,12
A2UCDLO7V7DG6,Rusty Spoons,20100810,32,4.8125,124.53125,101,4,97
A2UCZAWAN5QMJQ,Tom,20060410,40,3.8,321.525,194,20,174
A2UE0QBDSPVE6O,S. Skolout,20111030,23,4.434782608695652,56.04347826086956,7,3,4
A2UE7IZWQWC1JA,Louis Rogers,20121221,26,3.769230769230769,26.73076923076923,3,10,-7
A2UEB48LAWFUCW,"Joseph ""jck09""",20020112,63,3.984126984126984,274.1111111111111,247,24,223
A2UF0Y5LKUO08W,"kc_keg ""Casey""",20060112,22,4.681818181818182,126.95454545454545,40,4,36
A2UF34QX6DJJCV,Patricia,20110305,39,3.6923076923076925,102.87179487179488,25,2,23
A2UF3NLORSWUI3,Amazon Customer,20061227,28,4.928571428571429,134.32142857142858,52,13,39
A2UFAKH7Y8VH5N,WilliWu,20070405,36,4.055555555555555,178.08333333333334,939,87,852
A2UFJUXRBBZ8UU,"David Sandbeck ""hallgrd""",20120831,31,4.741935483870968,81.58064516129032,8,4,4
A2UJGR6IOIUOJA,AnotherWindowsBlog,20090320,24,4.291666666666667,281.1666666666667,33,4,29
A2UK57X5OCMKJD,Jack W,20130116,27,3.7777777777777777,112.5925925925926,19,15,4
A2UK5HQS62ESQP,"A. Ferreira ""64-year old baby boomer""",20091206,30,4.8,198.53333333333333,109,13,96
A2UKE7GIVC7XFW,T. Kunikov,20070619,72,4.097222222222222,221.29166666666666,250,82,168
A2ULZRSHXS3HL7,DaMacGuy,20060704,49,4.163265306122449,167.79591836734693,129,9,120
A2UN4NLBBF4YRN,"Once a geek, ...",20050423,28,4.25,76.92857142857143,34,3,31
A2UO2SEINLVTXE,J. C. Ellett,20050928,23,4.695652173913044,93.47826086956522,63,4,59
A2UOHALGF2X77Q,D. Hentze,20050825,211,4.355450236966824,202.07582938388626,3263,272,2991
A2UP15DSUPT6YD,A. Richardson,20120206,27,4.592592592592593,85.81481481481481,33,3,30
A2UQIQUOAB47OT,"DB ""aspiring part time free lance consultant""",20060112,37,4.351351351351352,206.35135135135135,121,25,96
A2UQK3DAZ8NO2T,"Hiram Grant ""just call me Sam""",20060122,65,4.323076923076923,281.66153846153844,6099,370,5729
A2UR44HF5K9FE5,"A. Berger """"",20060620,22,4.318181818181818,181.86363636363637,98,47,51
A2US0QBGZ6BIMB,W. Hohauser,20060707,34,3.9411764705882355,187.55882352941177,114,5,109
A2USY5SXCPEAMY,"jedi008 ""jedi_008""",20080105,23,4.3478260869565215,112.47826086956522,102,8,94
A2UTU1T0P7YTSG,Amazon Addict,20060819,39,4.435897435897436,83.8974358974359,123,14,109
A2UTZ4O5E2W4DK,"Ellie ""Eilean Siar""",20060726,74,4.702702702702703,286.9864864864865,1055,85,970
A2UU3ZOWZLA2SP,"HPD202 ""L. Natelborg""",20121130,30,4.866666666666666,35.03333333333333,5,0,5
A2UW9WI22QKMZE,"Car Guy ""desertgrj""",20070101,34,4.470588235294118,144.0,41,27,14
A2UWPFYTMPW6S5,,20120711,21,4.0,110.0952380952381,8,5,3
A2UWPPU5GZLMQZ,"Michael McKee ""mystic cowboy""",20070702,113,4.336283185840708,255.8495575221239,2093,151,1942
A2UWXLLEE0UOI8,"Metal Gimp ""MetalGimp""",20080219,25,2.96,140.68,14,5,9
A2UY0IV0SKZP8M,Kamemaster,20110301,35,4.314285714285714,67.51428571428572,33,14,19
A2UYGOYMV73826,Rushmore,20091105,22,3.9545454545454546,200.4090909090909,30,19,11
A2UZ4PV7XYN016,Linh Nguyen,20081130,25,4.6,301.48,290,32,258
A2V026TK7H80V3,Carl Cheng,20101104,29,3.6206896551724137,203.9655172413793,28,10,18
A2V0I904FH7ABY,XNOR,20050917,78,4.423076923076923,246.32051282051282,462,71,391
A2V0U7FH1J8P3G,Amazon Customer,20071120,26,4.769230769230769,128.07692307692307,28,3,25
A2V0YH86NKTGX1,Anna O,20100524,21,3.857142857142857,265.04761904761904,327,38,289
A2V1J3JT5OOZFO,Dragonwort Castle,20050506,92,4.130434782608695,124.6086956521739,223,45,178
A2V2GETQO6IZUN,NicG,20111020,21,4.9523809523809526,110.23809523809524,9,1,8
A2V2URLB31HG59,JT,20061118,54,4.111111111111111,217.35185185185185,121,26,95
A2V4MGPIBW4M8V,JonZ,20130815,29,4.655172413793103,44.89655172413793,46,5,41
A2V5M5EJPOD2IU,David Bradshaw,20090925,115,4.678260869565217,501.1304347826087,446,98,348
A2V5OS0QGHIUDS,"Robert Field ""leofric1""",20010621,25,4.8,130.48,49,7,42
A2V5R832QCSOMX,Leanne,20091011,24,4.375,189.625,23,22,1
A2V7EO331SFUF6,D.B. Spalding,20050510,62,4.096774193548387,217.66129032258064,742,90,652
A2V92F5R7MLCVI,wogan,20080404,24,4.041666666666667,233.29166666666666,564,43,521
A2V99RXY8L0HL7,Ricardo,20050617,26,3.8461538461538463,259.2307692307692,667,37,630
A2V9DTXTQ5YIMK,"A. Hudson ""bisou bisou""",20090715,74,4.405405405405405,364.43243243243245,348,29,319
A2VAD79S4A06DD,Bookenator,20080120,59,4.661016949152542,165.77966101694915,58,28,30
A2VALCFTOWFYXZ,Em,20120821,51,3.4901960784313726,100.54901960784314,73,198,-125
A2VAUN3R0OV1MB,"William T. Cole Jr. ""wcole67""",20060408,21,4.190476190476191,162.1904761904762,64,3,61
A2VBLTEI9H0F9K,Cr0m,20100303,27,4.37037037037037,99.85185185185185,32,21,11
A2VBTN6ZR67YOF,Mike Jacobs,20110517,27,4.777777777777778,135.77777777777777,100,17,83
A2VC48WIMY6L6E,"Bruce Murray On Travel ""Murray On Travel""",20091126,50,4.38,77.12,76,14,62
A2VCOIPPA48ICC,"Miyo Kitano ""Kitten""",20121210,21,4.761904761904762,93.04761904761905,13,2,11
A2VCXIAWCPQ13P,Renbutsu,20100601,48,3.7291666666666665,195.45833333333334,310,30,280
A2VDG6UXZI3ZN6,K. Lockwood-Fleming,20050623,21,4.809523809523809,85.33333333333333,60,10,50
A2VDZUT282F0SH,"M. Snyder ""ElectronGeek""",20100918,21,4.857142857142857,82.42857142857143,17,12,5
A2VEM6DZK8SEQ9,"David Bitting ""Ding Dong Daddy""",20070926,27,4.111111111111111,36.925925925925924,5,6,-1
A2VFN33XFSDW9C,"Kevin J. Post ""KJP""",20071211,41,4.219512195121951,54.53658536585366,28,14,14
A2VG6OG6SUIOSU,"Katydid ""value shopper""",20100126,21,4.619047619047619,119.80952380952381,6,1,5
A2VGG8JP5BCMH5,J. Banks,20070108,26,4.538461538461538,109.1923076923077,28,3,25
A2VGXB6X0L90S6,"SUDS ""SS""",20090329,42,4.404761904761905,151.02380952380952,40,11,29
A2VH0UT5EQFB6P,Loveguitar,20060831,69,4.057971014492754,338.18840579710144,194,64,130
A2VHNK9KG4FN9F,J.R.,20081113,26,4.230769230769231,74.3076923076923,15,5,10
A2VI45SXKJHPZU,J. Gwinn,20090914,33,4.090909090909091,124.0909090909091,89,108,-19
A2VIDPI1ZB5ZHM,M. S. Kubota,20080809,32,4.125,230.65625,145,21,124
A2VIHVGLGRMZIN,MEJazz,20021125,28,4.071428571428571,289.60714285714283,120,27,93
A2VIYTWXANL343,"SGBaker ""sgb22741""",20080625,44,4.795454545454546,50.84090909090909,20,20,0
A2VJ5ALN1BIV3B,"terster ""Terster""",20100130,54,4.518518518518518,158.0185185185185,118,23,95
A2VJJ2POCLMED7,"Marshall W. Carter ""Ornery Gamer, Fiend Club ...",20080629,26,4.076923076923077,230.73076923076923,100,15,85
A2VKBENU2H4VN,deb,20120710,26,4.923076923076923,47.88461538461539,2,4,-2
A2VKH0FDSTMK2A,"Paul D Farber ""PDF""",20101005,21,4.0476190476190474,129.28571428571428,12,11,1
A2VKZCJXKQF1VN,"Ftec ""RjD""",20071208,32,4.59375,60.0625,26,8,18
A2VNAGUP6GD6ZW,Scott (Technogeek),20110108,40,4.6,118.2,128,16,112
A2VO78JQQ87JCI,"Daniel Rivero "".:DRH:.""",20100612,30,4.766666666666667,64.16666666666667,33,9,24
A2VOCTOP0O4O6G,bob,20100107,31,4.483870967741935,147.90322580645162,268,29,239
A2VODABWSVHV8E,"Ray ""A Reader""",20070403,79,4.8354430379746836,515.253164556962,1520,68,1452
A2VP03LFQMRIF8,Sherpa Jimmy,20110909,23,4.3478260869565215,38.34782608695652,6,12,-6
A2VPLMOY0HS8CT,Greg,20130329,21,4.238095238095238,67.14285714285714,1,1,0
A2VPSHOKIKSLJY,P N,20101107,32,3.875,102.6875,15,11,4
A2VQLV2GUC4H8J,"Hal in Augusta ""hrosser""",20060307,24,4.25,60.208333333333336,17,6,11
A2VRAT69JDAD3W,"Jason Whitt ""Whittmeister""",20061201,38,4.447368421052632,123.89473684210526,301,66,235
A2VRYQBXSTA424,"Joshua T. Ebert ""Ebes""",20110724,31,4.870967741935484,184.25806451612902,17,0,17
A2VS3QSEQZLVST,metsons,20111126,35,4.542857142857143,122.71428571428571,301,19,282
A2VSI9JA8Q1OPM,Frank S,20120320,21,4.095238095238095,51.904761904761905,9,4,5
A2VSKUR61RYPYH,kelly,20130218,26,4.8076923076923075,37.80769230769231,2,1,1
A2VSNUK7YLRKRE,"F. Sasso ""Stupidity Should Hurt""",20120118,36,4.166666666666667,87.25,19,12,7
A2VTUV7ITLS8IK,Jeff C.,20110720,28,4.785714285714286,86.28571428571429,39,5,34
A2VV0TJNJT9D3O,"Matt ""mattfl1""",20010729,32,3.6875,222.34375,1202,96,1106
A2VVNR9LDER2HB,"J. Battocletti ""Ellsswhere""",20070426,22,4.7272727272727275,187.45454545454547,39,8,31
A2VW3E1N678RC2,J. Mckeown,20091024,25,4.16,130.04,18,6,12
A2VW4FYZILSXF2,"Jojoleb ""jojoleb""",20010916,45,3.8222222222222224,799.4666666666667,430,47,383
A2VWE5SGNDS8HW,"tachi1 ""tachi1""",20090225,45,4.444444444444445,424.2,482,55,427
A2VWHEZTQQU1U9,sad sack,20120225,31,4.645161290322581,40.225806451612904,8,0,8
A2VWTLASFNFSE5,Mr. Digital,20100521,23,4.521739130434782,162.82608695652175,109,14,95
A2VYB07TMKONDB,"Sunny ""Sunny Wu (Naturetastic Photography)""",20110227,34,4.147058823529412,268.2647058823529,121,20,101
A2VYRRDJN2UKWB,"April kid ""aprilkid""",20070722,27,4.851851851851852,40.03703703703704,40,0,40
A2VYSW6T63JF2W,M. Brandon Eley,20070607,38,3.9210526315789473,180.94736842105263,47,11,36
A2VZ43530IHTJU,"dickb ""RTB""",20080208,36,4.194444444444445,105.36111111111111,76,24,52
A2VZ79EQGTNC0X,Arnell,20110317,24,4.416666666666667,132.375,3,3,0
A2VZHT3WH73GTB,Mark J. Minasi,20010609,21,3.6666666666666665,211.33333333333334,433,74,359
A2VZP50FSYD6CO,drebbles,20071014,27,3.888888888888889,322.2962962962963,121,18,103
A2W0GY64CJSV5D,FreeSpirit,20110401,43,4.186046511627907,395.69767441860466,4689,432,4257
A2W0LMPC72GGTJ,"Brian Klein ""zarzak""",20071013,27,4.185185185185185,317.6296296296296,353,50,303
A2W0XCWOK3MW6F,"K. Roman ""Happy Librarian""",20080418,56,4.821428571428571,127.08928571428571,38,20,18
A2W1J67OS0VIAO,J. Paulsonn,20050313,26,4.076923076923077,160.34615384615384,175,43,132
A2W1MMTI4BNJKD,"Eric D ""gps geek""",20060815,25,4.08,216.64,240,16,224
A2W2ODLRQ2L8LE,G. Max Gooding,20100922,59,4.305084745762712,148.42372881355934,272,18,254
A2W362SNNS6O6,Jeannie,20121009,32,4.71875,73.6875,15,5,10
A2W3MXDBG96VM7,"Ozamandiz ""None""",20080324,22,4.454545454545454,59.09090909090909,21,7,14
A2W3WLQ1KRO0Q8,"J. G ""Johnniee""",20090610,25,4.8,60.56,19,5,14
A2W3WWVETOMJBS,Andrew,20111231,24,4.291666666666667,37.833333333333336,1,1,0
A2W4014S06NAIT,"Fathom ""Fathom""",20081201,27,3.925925925925926,84.48148148148148,30,21,9
A2W46EMB97SSAJ,"NLWPS ""Computer User""",20091031,30,3.9,218.56666666666666,126,6,120
A2W51GKIG66IWF,dca74,20140209,30,4.433333333333334,26.933333333333334,10,8,2
A2W5D69UC07I02,B. Arnold,20071020,25,4.96,99.8,129,6,123
A2W63DPIW9WQML,YsLadyMN,20110428,22,4.409090909090909,108.22727272727273,6,4,2
A2W73JAQ4AVCNJ,Jim Hart,20060704,39,4.846153846153846,432.35897435897436,211,14,197
A2W86PTH6LX1N4,"Black Eyes ""Frosed""",20100414,27,4.592592592592593,32.18518518518518,19,8,11
A2W99QEPL45Z7D,"John A ""Jack""",20100308,23,3.869565217391304,54.43478260869565,20,47,-27
A2W9GX82SLKROQ,Lenny,20050114,122,4.0,412.4590163934426,875,105,770
A2W9I628I6SE1U,"Kort ""Art, Music, Book & Movie Enthusiast""",20060223,80,4.2,406.1875,822,108,714
A2WA8TDCTGUADI,TheTerrorBeyond,20080724,48,4.166666666666667,276.4791666666667,249,48,201
A2WAQ2W3QJL5IM,M. Deschaine,20090205,33,4.333333333333333,109.33333333333333,8,2,6
A2WB4OWBUH2VQX,"HardyBoy64 ""RLC""",20081229,41,3.951219512195122,110.63414634146342,53,20,33
A2WB7LZ595CR50,J. Harley,20030922,147,3.8299319727891157,491.2925170068027,1746,161,1585
A2WBB8QN9S617,Paul C,20090417,24,4.583333333333333,77.375,7,0,7
A2WBEJH71SND3T,Amazon Customer,20070124,23,3.608695652173913,763.2608695652174,112,11,101
A2WBVO6X3KPMDT,Joe Lopez,20100127,45,4.844444444444444,27.977777777777778,10,10,0
A2WC9NFLG57W4H,"Momma Mary ""Expert Mom!""",20080924,93,4.344086021505376,221.93548387096774,260,101,159
A2WCFDOCS73PNB,Gadgetman,20011225,73,4.328767123287672,184.32876712328766,431,66,365
A2WDCAMKCCP1UR,Damian Harouff,20130101,38,3.973684210526316,78.0,17,10,7
A2WDCDU02FC2T3,"AM ""am amazon""",20041202,21,3.5238095238095237,119.76190476190476,50,4,46
A2WE4JPZIFA4K9,"Amazon Customer ""Koheleth""",20100204,24,3.9583333333333335,101.54166666666667,10,3,7
A2WEZ2BSZWQBBQ,Joe Caldwell,20070620,44,4.4772727272727275,83.56818181818181,68,15,53
A2WF58BAWLVI95,M. Dembski,20051006,43,3.046511627906977,75.11627906976744,113,66,47
A2WGD5GNQME5O5,Frank,20080826,22,4.318181818181818,70.68181818181819,16,3,13
A2WGIO96GU5F9F,KDH4,20081102,32,4.375,194.96875,33,4,29
A2WHQZXGP0DOYS,Buddy S,20060919,23,4.043478260869565,328.0,169,21,148
A2WHV0YLBOK0I0,Inspiring Insomnia,20110202,25,3.8,160.24,14,0,14
A2WHVEFYI431UI,"C. Burke ""CCrocker""",20120503,21,4.333333333333333,102.47619047619048,4,0,4
A2WJ5XSE4I9F55,Rocket Scientist,20091023,53,3.188679245283019,129.73584905660377,419,55,364
A2WJB8ERIHCILH,"Frank ""Frank in Bensalem""",20121117,32,4.4375,40.0625,5,6,-1
A2WJFVGN7CTOS9,Grady Nelson,20110412,22,3.3181818181818183,206.95454545454547,29,19,10
A2WKU6GBCADMOP,johnnyb588,20110222,24,4.875,182.70833333333334,16,1,15
A2WL2ZWWGHM2J1,dktt,20080102,29,4.586206896551724,64.34482758620689,31,7,24
A2WLDEORTNRY0D,"SBJ400 ""SBJ400""",20050702,23,4.260869565217392,210.08695652173913,101,30,71
A2WLNSZ9U0T1S3,"Tarun Chachra ""Tarun Chachra""",20071231,182,4.324175824175824,307.04395604395603,2576,223,2353
A2WM1KL9DQSQ18,"Jeffrey Heaton ""Jeff Heaton""",20030412,39,4.410256410256411,98.2051282051282,471,19,452
A2WM4FSA6ARHGJ,gllags,20110718,23,4.913043478260869,77.0,13,2,11
A2WNDYN99IOG54,Jerry,20121206,33,4.696969696969697,40.21212121212121,9,5,4
A2WNSCLFPTWW7K,Harry Puncec,20070308,31,4.32258064516129,85.54838709677419,36,14,22
A2WO1AMGXON0QH,D. Vaughan,20060906,36,4.861111111111111,82.0,72,9,63
A2WO3RGJHZIKHX,Luis,20140710,24,5.0,5.125,0,1,-1
A2WO7CURD15SXG,Glen Whiltey,20140425,22,4.681818181818182,34.68181818181818,3,0,3
A2WOJM8W1Z2JMP,"Wally Asti ""amazon""",20070624,27,4.0,138.4814814814815,82,15,67
A2WPL6Y08K6ZQH,"Narut Ujnat ""Enthusiasm is contagious.""",20021115,70,4.271428571428571,526.4285714285714,412,50,362
A2WQPBT1JGLAMV,T. Jacobson,20090129,23,4.260869565217392,125.56521739130434,120,14,106
A2WRQ8H0HZ79FY,P. Braun,20070211,25,5.0,44.8,46,22,24
A2WSGDNW9LBL25,William,20121121,22,4.681818181818182,194.6818181818182,28,2,26
A2WTPZ00M8LSMY,,20101020,25,4.52,37.36,6,4,2
A2WTSL1VCKF04V,ACAT,20081003,22,4.2727272727272725,118.5,32,3,29
A2WU7IKAQINJAY,garyznola,20110406,27,4.444444444444445,93.4074074074074,46,13,33
A2WUGQKN584PCJ,rsdno,20121204,22,3.6818181818181817,81.13636363636364,18,14,4
A2WUGZ3W7EUW3,Kevin R.,20110530,22,4.363636363636363,60.40909090909091,7,1,6
A2WUL4TA8JPU97,Rando,20130515,25,4.64,81.96,13,2,11
A2WUOZN2O3HEFK,Brandon,20100124,38,4.131578947368421,84.36842105263158,117,9,108
A2WUYJJ7NPQ5H4,R. Schneider,20040120,22,2.090909090909091,132.27272727272728,253,59,194
A2WV816Z0MR2ZL,RiverWayne,20111220,21,4.9523809523809526,47.42857142857143,6,1,5
A2WV8QZP58R1AP,Madadh,20090713,30,3.7666666666666666,199.23333333333332,22,23,-1
A2WW57XX2UVLM6,Talvi,20060602,85,4.2823529411764705,295.6588235294118,968,90,878
A2WXLCO6E6T1Q6,G. Troutman,20071119,23,4.565217391304348,109.52173913043478,72,7,65
A2WXURU33RBGQS,"Julio C. Montiel ""Julio Montiel Silva""",20090119,50,4.02,79.16,31,22,9
A2WYCJOJY6QSJI,thomasterrible,20110610,29,4.586206896551724,670.3793103448276,92,11,81
A2WYF4POBUXL2O,TriggerHappy,20090105,44,4.2727272727272725,170.45454545454547,197,32,165
A2WZNM833CJH82,Grandma,20090225,45,4.155555555555556,254.42222222222222,54,10,44
A2WZRBFLJESCSH,Brian Lange.,20070514,40,4.225,211.675,305,63,242
A2WZX2MXMMNYBA,KE0AUZ,20110724,22,4.681818181818182,122.72727272727273,39,6,33
A2X06FP2PQ6EK0,"S. A. ROBBINS ""shirley_rw""",20021003,62,3.2096774193548385,185.38709677419354,320,89,231
A2X0GHAHQVXO4F,blekenbleu,20060804,28,3.642857142857143,89.14285714285714,96,66,30
A2X11CHNOPES2V,Tom Lewis,20080410,21,4.809523809523809,75.71428571428571,10,0,10
A2X1V06ADIP8HY,BioMechanicalWeapons,20120731,27,4.888888888888889,74.11111111111111,25,6,19
A2X29Q2OV8D6PZ,W. Begoyan,20100128,24,3.7083333333333335,149.25,79,14,65
A2X34LIRHZ7OIN,J. Tsai,20080924,28,4.535714285714286,125.32142857142857,54,28,26
A2X396SN5F0H0S,A Central Illinoisian in Chicago,20100325,25,4.32,238.68,28,8,20
A2X3L31KCXBHCL,"R. Song ""R. Song""",20060722,74,4.283783783783784,159.97297297297297,292,31,261
A2X4DR51M32FYX,Candace Strickler,20111018,31,4.290322580645161,141.80645161290323,221,15,206
A2X4IDASPMOM3S,goofydelin,20050629,24,3.8333333333333335,81.20833333333333,21,6,15
A2X4UAUKJWO26O,"J. Campbell ""Gmia""",20061209,22,3.9545454545454546,78.4090909090909,77,36,41
A2X61KKXXR6WNP,"Sean P. Logue ""If you can't win, change the r...",20040603,45,4.266666666666667,207.93333333333334,217,27,190
A2X64QYO9ZKFHR,Ron Gonzalez,20080103,22,3.8181818181818183,143.95454545454547,106,35,71
A2X695AM08AIN1,Saul Nathanson,20090124,54,4.148148148148148,79.96296296296296,48,20,28
A2X698OHEBB03P,Evelyn A. Cummings,20071220,30,4.866666666666666,280.73333333333335,121,8,113
A2X6J6AFLLYVXH,Michael Hilton,20040625,28,3.857142857142857,114.85714285714286,79,24,55
A2X78O6G89CB30,Irish mike,20101001,73,4.6438356164383565,117.75342465753425,169,16,153
A2X7NBUETXC19E,Justin G.,20080130,21,3.9523809523809526,219.23809523809524,245,33,212
A2X8HAVUHS97NZ,J. Ludwick,20060427,25,4.68,146.44,96,27,69
A2X8KN82L07RSK,C. Johnson,20020416,54,3.8333333333333335,552.2962962962963,457,59,398
A2X9RJOSIBVHKS,Amazon Customer,20090915,29,4.551724137931035,180.0344827586207,137,8,129
A2XA6JM1SKBSHV,LearnMore,20110819,33,4.909090909090909,64.9090909090909,7,1,6
A2XA8CW5DF4MNZ,"Iron Man ""JON""",20041208,70,4.514285714285714,307.0571428571429,712,71,641
A2XAKGRUHIE2ZA,"P. Stein ""Bengals Fan""",20081112,49,4.020408163265306,205.91836734693877,150,34,116
A2XB9ZAJKW7QNL,GrumpyBTC,20120115,26,4.0,34.30769230769231,8,5,3
A2XBLMW3MJF9NC,Michael L Hensley,20121202,21,3.9523809523809526,47.285714285714285,4,0,4
A2XCCN239AR1XK,"Kilgore Gagarin ""Those who believe in telekin...",20070925,95,4.557894736842106,365.2736842105263,1419,143,1276
A2XDJAEWOYWEYA,"MP ""MP""",20100126,37,3.7027027027027026,69.97297297297297,41,30,11
A2XHK9Q42MOX77,Mike,20100715,24,4.208333333333333,135.875,314,30,284
A2XHOLOLKGV1FE,Skyhawk,20061002,57,3.1228070175438596,125.03508771929825,397,554,-157
A2XI7UD9MWPC0Z,Taylor Hively,20090121,25,4.56,385.04,200,10,190
A2XIM0IMONP1FX,"daGoofinator ""daGoofinator""",20100323,23,3.9130434782608696,85.82608695652173,12,5,7
A2XIOXRRYX0KZY,B.L.,20070310,79,4.215189873417722,364.37974683544303,178,34,144
A2XJCAQNOLXDZA,wackezoid,20090107,22,3.8636363636363638,66.77272727272727,50,16,34
A2XJMQ2COPGWJH,Sajid G. Mulla,20061110,52,4.134615384615385,199.3846153846154,23,15,8
A2XK8WOE7ZP52G,"D. Jenkins ""Jinkx""",20080302,22,4.636363636363637,241.6818181818182,136,31,105
A2XMQU9JIPF2B,Celeste,20101205,21,3.6666666666666665,53.61904761904762,26,17,9
A2XN7FWZMHR8YS,"Brian Campbell ""Brian""",20101006,24,3.875,141.25,53,44,9
A2XOGLJ3V3X7DR,H. Oliver,20110821,31,4.903225806451613,92.41935483870968,10,1,9
A2XOS0D485JSMM,webhawk50,20110417,39,4.230769230769231,432.87179487179486,691,53,638
A2XOV3ZKGDK55G,"RBSProds ""rbsprods""",20070125,23,4.608695652173913,296.7826086956522,52,5,47
A2XPJ5FLVMFJAY,"David ""here.david""",20081027,43,4.116279069767442,72.83720930232558,90,42,48
A2XPK6XCL0UH1S,"Paul Christensen ""gadget geek""",20030502,50,3.96,480.7,5005,140,4865
A2XQHPKTD5MRJA,D. Johnson,20071125,28,3.9642857142857144,271.17857142857144,91,30,61
A2XQYE6TJYROHQ,"Mark ""Mark""",20080120,31,4.451612903225806,130.96774193548387,35,4,31
A2XRIU3SOYZ0ZC,"Bob Whitley ""Bob""",20070506,38,4.473684210526316,166.0,82,22,60
A2XRMQA6PJ5ZJ8,Roger J. Buffington,20031006,227,4.594713656387666,246.44052863436124,3731,199,3532
A2XRZV63X79YSJ,"Movie Mania ""DVD Collector""",20081203,35,3.5428571428571427,211.31428571428572,44,50,-6
A2XSY4L7GDHV4W,"Robert T. Brennan ""Rob_1970""",20081123,48,4.4375,111.625,28,14,14
A2XT8C2ASRLF2M,TT,20041226,36,3.5277777777777777,204.47222222222223,257,61,196
A2XTEZQASWZLJA,"Michael J. Eckman ""Mike""",20120423,25,4.84,238.0,33,3,30
A2XTR0MSQ0275D,Echosyn,20080210,22,4.454545454545454,43.40909090909091,8,6,2
A2XU6J41ZQOJ2V,"Gary in Sun City, AZ",20050124,78,4.423076923076923,107.43589743589743,229,55,174
A2XX2A4OJCDNLZ,RatherLiveInKeyWest,20060504,39,4.487179487179487,363.9230769230769,100,3,97
A2XXBZPQT5EXHV,Darren O'Neill,20040609,55,4.818181818181818,172.2,60,9,51
A2XXCCT0TBVDIE,"Michael J. Blais ""MJB""",20091121,30,3.6333333333333333,25.466666666666665,3,13,-10
A2XXVNTN0ZIRZH,"metzmatt ""metzmatt""",20071116,35,4.542857142857143,141.94285714285715,63,6,57
A2XYH8IHILWW7X,"C. Ang ""cliff_ang""",20070408,32,4.125,208.15625,80,12,68
A2XYS6U8Q5B87U,Bill Macy,20091118,38,4.157894736842105,209.78947368421052,134,26,108
A2XZ17U949T053,"James Marker ""1goodeye""",20070208,21,4.285714285714286,142.76190476190476,45,11,34
A2XZEJTY5EJ64K,Guy S. Junior,20110326,25,4.32,54.12,14,16,-2
A2XZSVLQMMDJ89,T. Streiff,20111102,45,4.488888888888889,338.1111111111111,137,21,116
A2Y08KFEHZO280,Kyle D. Gendron,20020505,23,4.739130434782608,165.95652173913044,176,9,167
A2Y0RKGX9G5BIU,Tuan,20100930,22,4.454545454545454,107.5,49,3,46
A2Y0TX9P5GIHRY,Darrel,20060227,24,4.708333333333333,124.41666666666667,15,6,9
A2Y1WNETD9AYHO,John Hillestad,20050402,63,4.222222222222222,133.03174603174602,541,95,446
A2Y29IRSI08F0I,Frank,20110802,60,4.666666666666667,47.766666666666666,65,14,51
A2Y2ABB8QZMWAB,Edgar Kuck,20100113,22,2.909090909090909,216.22727272727272,45,23,22
A2Y3A341VDK37H,"John Pozadzides ""John P.""",20090905,25,4.12,121.24,264,43,221
A2Y3WWPUKIJ59I,Veil_Lord,20070211,77,4.0,505.4935064935065,399,40,359
A2Y4H3PXB07WQI,Richard S. Sims,20100422,41,4.365853658536586,97.97560975609755,76,9,67
A2Y4HC5Q84GVYP,"Benny B. Imbert ""Benny""",20080606,25,4.84,44.64,12,11,1
A2Y4HPQD4Z3KU,dom,20130307,25,4.36,54.36,8,4,4
A2Y4QQTCIP2E0E,"Mr. Hai V. Nguyen ""haingu""",20060723,22,4.7272727272727275,78.5909090909091,44,10,34
A2Y5Q0LK1OGHET,"moonlighteye ""moonlighteye""",20050611,27,4.2592592592592595,275.7037037037037,158,9,149
A2Y5T1O43P14RP,"Eliezer Kolatch ""Ez""",20070717,35,3.4285714285714284,405.9142857142857,1525,211,1314
A2Y6MUBCZIWGEJ,"Wizzard ""gwitte2""",20100912,27,4.555555555555555,56.925925925925924,44,4,40
A2Y6MZHG0MPCTN,Robert Klaproth,20070211,21,3.5238095238095237,392.6666666666667,130,28,102
A2Y6U3BZSVPLGZ,"Joseph Massimino ""Gadgeteer""",20060716,34,4.235294117647059,334.11764705882354,123,21,102
A2Y739CRM15WDL,"Sires ""I like mysteries (particularly British...",20000921,77,4.025974025974026,216.92207792207793,204,50,154
A2Y7D6A2W3GY6V,Vu Tran,20091027,29,4.0,105.48275862068965,46,31,15
A2YA8HT95FIXB8,W. Ragsdill,20071121,21,3.619047619047619,199.76190476190476,40,6,34
A2YAUX8C73PN43,"RSM61 ""Randy""",20120710,24,4.375,124.79166666666667,11,4,7
A2YB20P73KWE07,Gene Fowler,20110924,23,2.739130434782609,168.69565217391303,62,9,53
A2YB7DLC3FOR7W,"Pamela V ""&#34;MS V&#34;""",20090617,24,4.458333333333333,187.25,147,32,115
A2YBS4XD66UL28,Doit2it,20070110,30,4.5,148.53333333333333,35,8,27
A2YBYKUXJM5LW4,Amazon electronics buyer,20060223,26,4.3076923076923075,116.73076923076923,157,28,129
A2YCEKVUN1W5F1,"K. Salinger, MSN, FNP, RN AHN-BC",20080102,35,3.8857142857142857,470.57142857142856,332,71,261
A2YCUCEYXT9VHX,"Donnica Carter ""AKA DCSquared""",20100615,27,4.222222222222222,54.148148148148145,13,7,6
A2YD0HT67FZVUS,D. V.,20070903,21,4.190476190476191,68.38095238095238,10,8,2
A2YE2GLUQUVLYA,mh,20110810,28,4.571428571428571,87.25,14,8,6
A2YEOR4XJ8N3QE,wbentrim,20100917,67,4.17910447761194,197.8507462686567,204,52,152
A2YEZ8Z3BW2SKG,eric melzer,20070920,62,4.580645161290323,201.01612903225808,724,50,674
A2YFJ7B70DQM26,Mike,20110215,25,4.36,44.16,8,3,5
A2YFS3AYX720ZX,RJ from PH,20100512,30,4.3,121.13333333333334,36,24,12
A2YGEJTOPY4DV9,Eye Forget,20060114,31,3.4193548387096775,169.80645161290323,100,66,34
A2YGKC7L2T7DHA,DZ,20111224,22,3.409090909090909,73.36363636363636,25,14,11
A2YHXGPCTENZY3,"gadgetmaster ""gadgetmaster""",20020204,56,2.3392857142857144,86.98214285714286,333,693,-360
A2YI4WRHX5F74S,Gagsmokefs32,20140121,30,4.866666666666666,29.833333333333332,4,1,3
A2YIBBPK6JFVQC,"@Mead57 ""mediomonti""",20050418,32,4.3125,104.90625,37,8,29
A2YIO225BTKVPU,"Amazon Customer ""Treat the people around you ...",20081018,23,3.6956521739130435,96.17391304347827,64,20,44
A2YJ1K8M0KPHMF,"techmannn ""techmannn""",20041003,37,3.4324324324324325,132.35135135135135,341,76,265
A2YJE1LWDVOZ52,"MoosePond ""home theater maven, amateur woodwo...",20080229,21,4.333333333333333,113.33333333333333,31,12,19
A2YJHYABEY4WTM,Ian,20130329,26,4.615384615384615,64.38461538461539,6,0,6
A2YKWYC3WQJX5J,"Shannon Lastowski ""Queen of Caffeine""",20100602,46,4.3478260869565215,126.47826086956522,59,18,41
A2YMA1O4Y3E1QB,"The Key Master ""SFG""",20051206,25,3.72,231.76,127,61,66
A2YMP0GYNVPLNT,"John Leonard ""disneydriver""",20080817,29,3.6551724137931036,55.06896551724138,9,5,4
A2YMUWJM04EWUL,humam,20120319,37,4.72972972972973,39.4054054054054,6,1,5
A2YND5M9WCFXID,AlJohn P.,20130404,29,4.793103448275862,87.62068965517241,9,6,3
A2YNF8D4ADUPD9,Robert M,20060615,46,3.5217391304347827,127.78260869565217,434,65,369
A2YOI67EI4N4D,DT,20010917,47,4.446808510638298,55.276595744680854,78,13,65
A2YONGV9OTUG36,"Jamie Horton ""Jamie""",20121213,24,4.541666666666667,40.541666666666664,6,8,-2
A2YOQUX0E0BE7E,glresearch,20060901,23,4.173913043478261,246.7391304347826,112,24,88
A2YQ2ZI65F37N8,T. Gaston,20091221,35,4.4,70.2,12,15,-3
A2YQICWD7C1F9U,Robert B,20131125,21,4.285714285714286,66.61904761904762,3,5,-2
A2YRPZERLLTFK5,FLDonna,20090123,26,5.0,59.0,17,2,15
A2YRX8J4WM5BRX,"Adam Petrone ""Adam""",20040726,55,4.909090909090909,139.1090909090909,942,177,765
A2YSB0NIFLLEMB,"R. L. Carr ""Wonder Why""",20081106,24,3.0833333333333335,120.0,114,51,63
A2YT5IO3DKN3AN,"C. Miller ""IdoNotes""",20061212,30,4.3,276.8333333333333,154,22,132
A2YW1MG1GKU8XD,SweetPea,20110623,21,4.476190476190476,143.52380952380952,13,6,7
A2YW2DVVYTZV2U,Palani,20121126,30,4.533333333333333,83.96666666666667,2,1,1
A2YW6XOID7GV6G,"Amazon Stockholder ""Prime Member""",20080615,50,3.78,81.0,76,24,52
A2YXKWRDT3J2C8,"Amazon Customer ""Recent graduate New York Ins...",20060630,30,4.766666666666667,89.0,114,8,106
A2YYFPKOLTQ11H,"Mr Mac ""Caller""",20091213,26,4.384615384615385,99.96153846153847,19,2,17
A2YYHSORXIHZCS,E,20030806,54,4.444444444444445,193.4814814814815,277,37,240
A2YZCDQIAZIX1Q,"Dale ""DaleDJ""",20121020,22,3.8181818181818183,78.27272727272727,30,5,25
A2YZEZ1ZQCFRTA,Richard M. Zimmerman,20100423,38,4.157894736842105,89.84210526315789,68,91,-23
A2YZVO7HB60BO3,"Thomasj106 ""Thomasj106""",20070306,38,4.473684210526316,135.60526315789474,60,12,48
A2Z14EFCA3IZHX,"Revo ""EternalFracture""",20100321,26,4.538461538461538,209.53846153846155,136,19,117
A2Z1K2I2EYSKFA,FrontPage,20031206,26,4.038461538461538,404.88461538461536,411,92,319
A2Z1NCJN5ATMJ7,"Hesham Talat Hegazy ""Hesho The Man""",20060222,23,4.086956521739131,111.52173913043478,46,54,-8
A2Z1R98M2XOCEJ,"Harold G. Meeks Jr. ""hal2k""",20070111,52,4.211538461538462,380.7692307692308,269,28,241
A2Z2FATA8JNL54,Steven James,20091006,21,4.809523809523809,179.85714285714286,42,29,13
A2Z2MUP8JRJXEU,Jay Mittener,20120508,44,4.659090909090909,153.97727272727272,264,38,226
A2Z380TCT1KU1D,Luis Rebolledo,20071031,28,4.5,62.82142857142857,13,4,9
A2Z48RHQCMH0XC,"Melvey ""Rick F""",20050130,23,4.6521739130434785,55.73913043478261,84,24,60
A2Z548GT5948WH,"J. Perry ""Zak""",20130216,29,3.9655172413793105,29.96551724137931,3,4,-1
A2Z57FNSZVJCSO,Mark,20110523,27,4.62962962962963,34.55555555555556,12,15,-3
A2Z5C2MD0XL1QB,"btchfem06 ""btchfem06""",20120903,22,4.045454545454546,145.72727272727272,50,12,38
A2Z5H0A2L7CCCI,Bryan L. Smith,20130119,24,4.5,88.08333333333333,9,3,6
A2Z60PVKWFO3SW,"Learning All The Time ""It's Never Too Late to...",20071007,29,4.758620689655173,128.75862068965517,100,12,88
A2Z63M867JULS,Timothy D. Ulmen,20100307,39,4.743589743589744,51.35897435897436,13,15,-2
A2Z88UVRKMB50Q,insoc,20040812,33,4.393939393939394,150.96969696969697,158,80,78
A2Z8DACQ8BTUCN,My Cat's Name Is Bernie,20070310,25,4.28,216.88,82,5,77
A2Z9S2RQD542CP,Irineo Placido-Lopez,20120521,51,4.352941176470588,322.2156862745098,78,13,65
A2ZA6DRL0A1LNZ,Sean U,20040815,41,4.414634146341464,169.29268292682926,147,11,136
A2ZAWPWLLTOHNK,Daddy X3,20110202,30,4.533333333333333,61.96666666666667,19,15,4
A2ZB7YIIT1KRTQ,Steven T. Elayda,20100605,23,4.043478260869565,342.4782608695652,45,11,34
A2ZCG424VQZFSP,Ryan Dye,20121228,24,4.166666666666667,82.375,35,10,25
A2ZDY0V4Q1SZD7,"Joseph R ""Joe""",20120316,54,4.444444444444445,179.2962962962963,17,20,-3
A2ZEV9DYN0E63D,"Manhattan Dweller ""C""",20090419,25,4.4,118.84,81,15,66
A2ZFBTGPDP6PH6,C Fox,20080509,59,4.271186440677966,116.84745762711864,63,5,58
A2ZFFSJ0VM6KSJ,"Sandy S ""Sandy S""",20130226,48,4.5,88.8125,40,7,33
A2ZG8OIEB6W3CF,Amazon Customer,20070721,37,4.1891891891891895,154.8108108108108,57,12,45
A2ZGDHLJ85T6AD,Fryfat,20060705,49,4.428571428571429,120.63265306122449,144,45,99
A2ZIXNYGNZBDYS,Ron,20110115,23,4.6521739130434785,94.95652173913044,47,27,20
A2ZJMLZ1IA2YA9,d bucci,20081111,27,4.074074074074074,238.74074074074073,86,13,73
A2ZKQC0XCIIAEM,Pampered Prepper,20110321,45,4.5777777777777775,163.15555555555557,68,34,34
A2ZLMZOS5ERKZ8,Kristopher Rattansingh,20130915,23,5.0,31.304347826086957,5,1,4
A2ZMI5UAMCTQHA,"tbuyer ""tbuyer""",20110404,24,3.125,357.8333333333333,159,98,61
A2ZMIPZCWKO16D,John M. Leggett,20090616,21,4.761904761904762,64.19047619047619,11,0,11
A2ZMOCCPJWCIV5,"R. Adams ""RSA""",20081022,23,4.478260869565218,160.43478260869566,47,5,42
A2ZNDM5U1QWHZ2,Peter U,20130827,28,4.714285714285714,169.32142857142858,13,0,13
A2ZOMM1UA59B11,Rommel,20070122,22,3.6363636363636362,102.0,38,16,22
A2ZQ5G6HZKUEV0,J. MICHEL,20100320,22,4.7727272727272725,126.63636363636364,85,11,74
A2ZQ89KUDY9XKO,Ai Wintermute,20091206,22,4.045454545454546,127.13636363636364,21,10,11
A2ZQUFBBN00S1V,Mathwiz,20110318,26,3.769230769230769,284.88461538461536,57,4,53
A2ZR3YTMEEIIZ4,"Christopher Wanko ""-C""",20030720,39,4.0,282.79487179487177,1900,123,1777
A2ZR5RLHI1INB1,Califrisco,20080320,23,4.173913043478261,294.9130434782609,59,10,49
A2ZRC61GOLTZ16,Sarah Felty,20120611,21,4.428571428571429,36.714285714285715,3,2,1
A2ZRG5NOFZ47RK,"Richard H. ""Huggy""",20120117,49,4.653061224489796,116.28571428571429,162,3,159
A2ZRMCRLDSUX6R,"Tom ""ontrac1""",20090126,37,4.486486486486487,112.32432432432432,199,26,173
A2ZSU1O7QSIH10,Paul,20100223,34,3.8823529411764706,393.55882352941177,301,28,273
A2ZT0SX3ZJAPJ9,T. Kendall,20080331,41,4.048780487804878,87.14634146341463,31,10,21
A2ZT1CSHU62UOL,SAH,20100731,23,3.608695652173913,68.17391304347827,33,5,28
A2ZT3BMQFMBGIP,"Amazon Customer ""photohound""",20081123,25,4.4,82.4,22,9,13
A2ZT5LYQVJQJAU,"Amazon Customer ""handspun knitter""",20100713,36,4.388888888888889,176.80555555555554,14,15,-1
A2ZT9UP11DGS0O,"Dr. Richard H. Knee ""Docknee""",20121208,31,4.903225806451613,33.70967741935484,2,0,2
A2ZTCOTFKALJFW,francisco,20130227,21,4.0476190476190474,37.95238095238095,3,1,2
A2ZU63ODH7YBAO,Ryan Barnhart,20080106,25,4.28,137.04,64,11,53
A2ZVLCPEILZ4B4,Bill Esposito,20091018,29,4.379310344827586,204.3448275862069,61,4,57
A2ZVNM8J2Q4HQT,H. Sachan,20010115,23,4.260869565217392,412.0,1203,101,1102
A2ZW4Q5B43JOFP,Pablo,20111028,32,4.78125,55.21875,9,7,2
A2ZW7U0J0B6U3R,MarkyMark,20120901,26,4.538461538461538,30.73076923076923,5,7,-2
A2ZWJVKITA32OV,"S. Goldstein ""toys for big boys junky""",20061025,49,4.040816326530612,303.3673469387755,204,58,146
A2ZXBFBA7EKYNR,Mysti,20060530,22,4.318181818181818,226.0,48,16,32
A2ZY3S7SD3QO8Z,Anonymous,20100906,48,3.3125,359.5625,476,73,403
A2ZY49IDE6TY5I,"Crabigail Cassidy ""Crabby Abby""",20100514,110,4.027272727272727,218.52727272727273,636,87,549
A2ZY4QXRPCSRFI,"A. Tay ""Private Tay""",20120118,23,3.0434782608695654,204.56521739130434,54,97,-43
A3006WHOAYJRLI,Poogy,20090827,28,3.892857142857143,272.7857142857143,43,18,25
A300GUSDAHJL9P,tekwiz47,20130124,32,5.0,50.1875,8,3,5
A300M5BZZ1FWRX,J. Hall,20080413,24,4.458333333333333,104.5,43,14,29
A300O9HLPSZNVS,HGW,20080410,26,3.923076923076923,246.15384615384616,26,16,10
A301B6L3TCD7WL,Tanya McHenry,20080824,42,4.071428571428571,387.9761904761905,121,28,93
A301PQYE8BCBZ,"Andrew ""ANDY""",20080315,26,4.576923076923077,198.07692307692307,36,14,22
A301Z8IOK3T238,"Zak ""Diva""",20130117,21,4.523809523809524,65.19047619047619,9,4,5
A303DNKYGXV64K,J. Ard,20081026,29,4.482758620689655,243.93103448275863,88,13,75
A303SNZ4AR7TDQ,SirStinky,20080116,41,4.317073170731708,742.780487804878,160,15,145
A303YO1B5DKTHT,"Arun ""Techie""",20070113,24,4.458333333333333,105.95833333333333,235,28,207
A304AY9M0FAI3Y,Philip J. Bohlken,20020703,24,4.458333333333333,238.875,107,14,93
A304B8P50JOE3O,billvwi,20110808,23,5.0,54.17391304347826,5,2,3
A306153FTKS9PL,Turtle502,20050126,33,3.5757575757575757,534.4848484848485,360,43,317
A30638B9S2GOM8,apples2apples,20090219,32,4.4375,329.9375,123,26,97
A306LNS6H0P1W,"ProPhotographer1 ""kaisphotographycom""",20120601,39,4.102564102564102,128.6153846153846,78,33,45
A306NASGVUDFKF,"Jeffrey E ""jeffinaustintx""",20030809,33,4.363636363636363,221.87878787878788,167,33,134
A3077MQTAKOVFZ,Stuff Lover,20071201,77,4.402597402597403,161.28571428571428,187,65,122
A307Y3LMCVEZS1,"PainMaestro ""WinoFino""",20070410,44,3.25,122.29545454545455,96,77,19
A3087CFZHYSERZ,"JAS32 ""jas32""",20080326,44,4.5,218.25,175,9,166
A308G00PAX6QJ4,"Amazon Customer ""Engineer""",20080423,26,4.461538461538462,240.26923076923077,606,54,552
A3091RP0SPZLMN,BB,20110802,35,4.085714285714285,132.88571428571427,62,16,46
A3094EPI56GKZ6,"Kristen E. Bogren ""Kristen Bogren""",20080326,68,4.926470588235294,91.52941176470588,68,23,45
A309OOC2PTQOG4,Christopher Nelson,20110227,33,4.757575757575758,127.6969696969697,32,11,21
A30AAQB9N65WFX,MaDuke,20100903,31,4.193548387096774,81.74193548387096,57,4,53
A30ADSBTWCORYC,"mnetarver ""etarver""",20130530,50,4.68,28.86,20,7,13
A30AH4DU1TR8Y4,"exhausted_homeowner ""exhausted_homeowner""",20020410,27,4.333333333333333,93.74074074074075,84,9,75
A30C8WHQ2CYFO4,David Siegfried,20070514,41,4.0,640.9268292682926,1314,158,1156
A30CV4T4I9Y89P,,20110725,21,4.142857142857143,70.52380952380952,8,10,-2
A30DY717PFFN68,Manuel D. Benitez,20070516,29,4.448275862068965,44.03448275862069,2,3,-1
A30E8NVUP4UQ9M,swenpaylay,20130612,21,4.380952380952381,137.42857142857142,62,39,23
A30ELDPP5TCQ8J,Bernard Farrell,20070530,24,4.166666666666667,166.70833333333334,55,12,43
A30FAJKUJ7BW2X,average joe,20120710,24,4.375,74.66666666666667,6,2,4
A30GWXSWA6QCD7,Steve,20130807,22,4.409090909090909,63.95454545454545,5,3,2
A30H2335OM7RD6,"apoem ""apoem""",20020223,26,4.884615384615385,170.96153846153845,42,5,37
A30I0LXKTAP4F,DN,20050226,32,3.8125,51.6875,45,23,22
A30IP3E4MDQ36,J. Brooks,20060522,42,4.190476190476191,265.9047619047619,717,114,603
A30IP5D5DLHRPA,Kyle Slayzar,20080728,28,4.285714285714286,418.32142857142856,208,30,178
A30IXG7LETFRS3,Alex Dourov,20110411,30,4.8,115.86666666666666,29,5,24
A30J7WQV0ZNRXG,"D. Reinstein ""marindavid""",20020129,54,4.277777777777778,331.962962962963,1005,100,905
A30JPZ9TZ7I61U,"Christopher Barrett ""Evil Corgi""",20080404,67,4.358208955223881,224.65671641791045,102,14,88
A30K1B4HZ6HQ47,shopinful,20110113,24,4.583333333333333,92.70833333333333,12,4,8
A30KPB2ILF6K6J,Steve R,20081024,59,4.4576271186440675,242.4406779661017,113,28,85
A30L3WWGVE0M4Q,Prime is awesome,20120725,22,4.2727272727272725,67.86363636363636,8,2,6
A30LRE6HWCNIJF,"Javascript Junkie ""JavaScript Junkie""",20120716,29,4.0344827586206895,114.51724137931035,16,19,-3
A30LX4D9DBIM1W,"eclectic reader ""wanderer""",20101205,35,4.542857142857143,51.34285714285714,18,11,7
A30M1IFIQ8AAWX,D. Banici,20110906,21,4.809523809523809,193.42857142857142,106,6,100
A30NNLD0AT6J8T,"Paul G. Atkinson ""DadofTwoGirls""",20090203,23,4.173913043478261,122.1304347826087,173,48,125
A30O3IPR46PS44,"JL ""Nikonian""",20111130,41,4.609756097560975,253.0487804878049,92,35,57
A30O7HIJXK19SC,S. S. Malhotra,20090506,24,4.958333333333333,170.58333333333334,171,14,157
A30OFW96VX5YHV,"D. Mark Waldoch ""Mark the Guitar Teacher""",20080704,27,4.814814814814815,66.85185185185185,20,4,16
A30OP1U7O5GLX0,Rafshan Caesar,20121211,33,4.575757575757576,48.333333333333336,6,6,0
A30OVZRXE4KKRP,Drew,20100124,22,4.090909090909091,81.95454545454545,6,4,2
A30R8VFR16RE32,Kristin,20070515,59,3.8813559322033897,259.45762711864404,2498,192,2306
A30TK64NTD1M30,"V Ember ""V""",20100119,21,3.8095238095238093,118.85714285714286,41,4,37
A30U2QQN2FFHE9,J. Amicucci,20070620,25,3.48,147.56,59,19,40
A30UHM6OOPVHNA,"A. C. Doyle ""Sniperbait1966""",20130409,26,4.461538461538462,86.42307692307692,8,16,-8
A30UIZJMFL9PLT,Jish M.,20070602,24,4.541666666666667,153.66666666666666,230,19,211
A30UP2KKD5IQEP,Soar,20060529,68,4.397058823529412,241.27941176470588,122,35,87
A30VX6KH8RZS4R,gilbert,20080109,24,3.3333333333333335,129.79166666666666,82,44,38
A30X4BLUOH44CI,kandoro,20080404,27,4.37037037037037,280.74074074074076,509,33,476
A30X750M8V1XXW,Scott,20060427,130,3.9692307692307693,287.44615384615383,1112,135,977
A30XB1HWSTW45G,C. F. Jung,20110616,33,4.575757575757576,50.72727272727273,5,2,3
A30XZK10EZN9V4,dwarf,20110722,103,4.543689320388349,62.077669902912625,130,45,85
A30YP1B6XWP3S4,"Retired ""Retired, and enjoying my free time. ...",20020909,36,4.722222222222222,239.33333333333334,23,1,22
A30YZ99OYHKVKT,"R. Harvey ""Rick Harvey""",20100323,21,4.238095238095238,56.61904761904762,10,4,6
A30Z0GG96D11EO,Wisdom Twin,20040814,37,4.027027027027027,342.7027027027027,124,21,103
A30Z47HY0H62J1,G. Mesick,20070614,24,4.5,212.29166666666666,50,7,43
A30Z9EWE8VY95B,Love Technology,20060413,28,3.392857142857143,317.82142857142856,234,67,167
A310661Z2XKHQK,Ravi Iyer,20130105,25,3.6,90.56,8,3,5
A3112D9P7HXV0E,The real Amazon fan,20120724,45,4.355555555555555,73.66666666666667,29,4,25
A3119E8HWUNIR6,Steve Conslaw,20070112,21,4.0,321.3809523809524,647,25,622
A311A2S8T0SR55,"J. DALE ""J. DALE""",20110215,33,4.2727272727272725,311.3030303030303,232,36,196
A312AADW1ZEZ8H,Calif Guy,20090329,24,4.208333333333333,157.75,46,4,42
A3137J8R82HOM0,Mark_42,20080303,29,3.413793103448276,201.17241379310346,183,29,154
A313DADVI76HKM,Micah Klatt,20130616,39,4.076923076923077,53.717948717948715,6,1,5
A313H6238N589,"Jaewoo Kim ""OB-Wan""",20061228,47,3.9574468085106385,227.51063829787233,209,37,172
A314GYAJRTK8Y7,"fredlusk ""Frederick J. Lusk III""",20130102,31,4.516129032258065,28.06451612903226,8,3,5
A314J152FC3VT6,"Stan Wayne ""Poochai""",20080124,21,4.142857142857143,101.19047619047619,58,16,42
A314KKDIJWCNMV,bmac32,20120127,61,4.39344262295082,103.67213114754098,63,27,36
A314SSFZKE4FVN,J. Skilton,20051127,22,4.681818181818182,149.9090909090909,268,13,255
A3154RZHJMP24,Douglas Henderson,20050703,26,4.384615384615385,375.0,447,29,418
A316RLHHO9Y24T,myoho guy,20080312,31,4.225806451612903,178.41935483870967,187,23,164
A316XO4RWX21YN,onestopnyc,20080103,82,3.9878048780487805,110.01219512195122,502,185,317
A316ZNXB1MN99J,JaimeH,20120303,29,4.862068965517241,41.58620689655172,14,13,1
A317G6H6Q0EPNK,Chris Underwood,20100210,21,4.666666666666667,49.38095238095238,5,7,-2
A317L56T9Q55C2,"William Webster ""disgusted""",20050520,21,4.523809523809524,100.80952380952381,108,39,69
A317RWPY08I5QX,King Nguyen,20131103,26,4.884615384615385,40.26923076923077,4,0,4
A317X0I2ORNX3P,DSeverance,20130402,31,4.838709677419355,87.51612903225806,16,6,10
A318I2ZHE52N62,Rusted Nut Garage,20051112,27,3.6666666666666665,213.55555555555554,57,9,48
A318XV56UYB6R6,Daniel Brockman,20030819,25,3.76,169.8,58,11,47
A319SV3KWR9G3I,Ed,20120924,33,4.242424242424242,53.333333333333336,14,4,10
A319UCRTOK0V9P,Spoon,20100521,26,4.730769230769231,121.92307692307692,22,12,10
A319Y83RT0MRVR,AIROLF,20070907,49,4.346938775510204,128.51020408163265,40,25,15
A31A96J8W51G05,Randy B,20140203,21,4.571428571428571,51.095238095238095,3,2,1
A31AVXMESQRQAC,Kathy O'Gorman,20100516,24,4.541666666666667,142.0,45,10,35
A31B2ALCYC240O,"Darwin Sayo ""Liquidmachine""",20080329,30,4.666666666666667,91.96666666666667,36,7,29
A31BD4RXCON7QO,Michael A. Duvernois,20071119,66,4.136363636363637,123.01515151515152,803,104,699
A31BLJ7PD6AQVD,"bigblur ""bigblur""",20110220,24,3.5416666666666665,48.583333333333336,8,14,-6
A31BTPHCQCE8WB,BK,20121130,25,4.84,42.24,1,0,1
A31COKWABW2WH2,"Johnny K. Young ""JohnnyK""",20090625,26,4.538461538461538,117.73076923076923,22,12,10
A31D9371RIFEDY,Paulina,20131009,32,4.71875,44.09375,19,5,14
A31F1XT1KL7F3C,"Edgardo Pichardo ""Boomz""",20071215,36,4.833333333333333,98.13888888888889,203,14,189
A31F722DD3E761,Daddy V,20100112,27,4.444444444444445,303.2962962962963,302,9,293
A31FZ4PMHCZRG0,"R. F. W ""veiko""",20100816,26,4.269230769230769,39.69230769230769,19,3,16
A31GHUVQ0N2NXH,"BirdOPrey5 ""JUOTnet""",20080101,27,3.259259259259259,173.03703703703704,49,28,21
A31HE83MU98GBV,Gadget Girl,20051129,69,4.594202898550725,183.3768115942029,168,49,119
A31HOWJKEIY037,David W. Irwin,20090525,45,4.4222222222222225,78.08888888888889,12,4,8
A31I44ESG7UPR,G. Ratcheson,20050331,29,3.3793103448275863,447.2068965517241,130,53,77
A31ICLWQ9CSHRS,Al Swanson,20051020,72,4.277777777777778,161.68055555555554,702,119,583
A31IDGEGJXGOPD,B. Metzger,20080315,24,4.5,143.75,199,32,167
A31J6NEZGC6GJ2,Nick Puleo,20061019,22,4.409090909090909,62.86363636363637,41,11,30
A31J9510MMFH7W,Multi-Media Man,20101101,24,4.458333333333333,72.70833333333333,12,12,0
A31JJ826HPP05W,"Austin Haynes ""Sinitron""",20090107,31,4.903225806451613,64.03225806451613,7,2,5
A31K5IS5MY4KCO,"Matthew Carruth ""Matt Carruth""",20020308,30,4.233333333333333,129.4,99,14,85
A31K6XBC9DQWN,mbw,20061111,25,4.8,202.28,202,15,187
A31M69WDXIIX8J,"Couch Potato ""TV Addict!""",20070616,22,3.9545454545454546,119.27272727272727,80,17,63
A31N0XY2UTB25C,Stephanie Sullivan,20070118,200,4.745,240.77,1318,99,1219
A31PP1LB2A8WR4,Jim Chou,20021108,26,3.9615384615384617,168.3846153846154,224,35,189
A31Q7NE0NP3IH4,"Richard ""The Lion Heart""",20040407,22,3.6818181818181817,144.27272727272728,83,153,-70
A31QWIVYZ7XU53,"N. Erath ""nerath""",20040720,30,3.6666666666666665,175.73333333333332,75,8,67
A31R3ZYX2OT7FI,B H,20031103,27,4.444444444444445,237.4814814814815,176,17,159
A31RA1FOIXTSKI,AlohaDawn,20101110,22,4.818181818181818,47.45454545454545,11,2,9
A31RULW0KNYJ5H,LA,20081224,59,3.983050847457627,161.35593220338984,105,62,43
A31RZMVAFMLB8B,SharpFocus Photo,20110209,38,3.973684210526316,66.89473684210526,31,19,12
A31SFWPRTFTC8M,Mark,20101217,22,4.545454545454546,192.72727272727272,33,4,29
A31T5S3FA0GCD2,John Tanaka,20070412,21,4.761904761904762,100.33333333333333,17,2,15
A31V563Q4BHQ1Q,A. Arra,20120618,21,4.904761904761905,24.904761904761905,10,2,8
A31VDZOEJACIHH,M. Morim,20080408,33,3.787878787878788,202.45454545454547,182,35,147
A31X5U9OZSOCOA,Bob's Computer Service,20121005,30,4.733333333333333,27.533333333333335,6,3,3
A31Y28UEDXQ0HB,Jack W. Wolfe,20070902,34,4.764705882352941,45.970588235294116,44,36,8
A31Y39MKPDCAY8,K. Brown,20070524,34,4.470588235294118,67.58823529411765,82,10,72
A31YYDDZNM6NAG,"Roger James ""Doc""",20100912,37,4.378378378378378,491.0810810810811,165,13,152
A31ZO2G7KA11AR,Poppies_rule,20130309,25,4.52,139.0,18,2,16
A3202C86H3AD1V,Citris1,20050518,29,2.586206896551724,65.79310344827586,36,30,6
A320NYVVIZSZGY,Skeletor-Vixen,20100326,27,4.777777777777778,102.29629629629629,29,46,-17
A321F27MLVDUAG,MikeyFresh,20120124,25,4.56,77.2,15,3,12
A321W4SSC0F6AP,Joseph Dewey,20091016,23,4.434782608695652,231.1304347826087,145,24,121
A3223W5IROMYTY,MOAR COARS,20111102,57,4.7368421052631575,858.4736842105264,1760,232,1528
A32482Z7XIKDQX,Christopher Beaugrand,20070201,47,4.680851063829787,81.76595744680851,67,9,58
A324X7RVDAV3FT,J. Au,20091203,54,4.388888888888889,116.64814814814815,32,9,23
A3263D7FBDJACU,Cass,20130702,23,4.0,44.869565217391305,1,2,-1
A32658HY8IU6UV,"L. Reeves ""A Life Bound By Books""",20120501,22,3.727272727272727,154.95454545454547,17,12,5
A3284KYDZ00BZA,Erich Maria Remarque,20090419,107,4.018691588785047,196.9158878504673,366,114,252
A328GLDSDNFYII,"Raul E. Fernandez ""-RFP""",20120308,38,4.2894736842105265,50.89473684210526,12,3,9
A328R49X473H2W,Mark Genovese,20130805,25,3.84,132.64,23,5,18
A328S9RN3U5M68,Grady Harp,20110614,65,4.953846153846154,182.98461538461538,238,51,187
A329P043ENCM1R,Dr Moreau,20101231,35,4.4,112.57142857142857,106,9,97
A329Z94PQ8SZSK,Gadget Hound,20080228,22,4.818181818181818,216.86363636363637,137,10,127
A32AFX2PUJ82HG,"walstib11 ""walstib11""",20080510,44,4.454545454545454,76.61363636363636,47,15,32
A32AK8FOAZEPE2,"JustAReader ""NoNeed2Comment""",20061220,38,2.973684210526316,252.18421052631578,39,48,-9
A32B6A532454UD,"D. Taylor ""Tech Gadget User""",20081123,30,4.7,261.26666666666665,112,6,106
A32BART9O61O3E,Geezer 67,20110615,34,4.352941176470588,79.94117647058823,18,3,15
A32BYKL19FCSWP,screamingloach,20120117,21,4.476190476190476,37.38095238095238,9,0,9
A32C3DE7APUDKY,Jay Man,20101124,38,4.473684210526316,101.44736842105263,104,23,81
A32CQ23727FKOI,Limar,20120314,38,4.842105263157895,50.0,4,4,0
A32CT8O271OBMJ,Maximilian,20110108,21,4.428571428571429,73.66666666666667,27,6,21
A32D3SIQGJX2SV,Kimmy11,20050713,32,4.0625,244.5,469,76,393
A32DUKGO59EAHH,Pet Natividad,20121011,28,4.25,53.42857142857143,4,2,2
A32EO0Z06GJZ8,saltydawg,20120521,21,4.619047619047619,98.28571428571429,10,3,7
A32EOHLFZYXJEP,Jaylia3,20100708,23,4.695652173913044,294.95652173913044,127,11,116
A32FL8K77UAEN8,E. Tucker,20130220,32,4.53125,174.53125,1119,200,919
A32G4SORK2AE30,"GeekHelpingHand ""Louis Smith""",20120613,38,4.2368421052631575,418.3157894736842,14,21,-7
A32G54YHK6OGO4,J. Whiddon,20070323,32,4.6875,100.46875,61,39,22
A32GCOTGFJ9XC3,"Alex Honda ""onyx575""",20080725,22,4.454545454545454,487.6363636363636,954,30,924
A32GVA2VANF89W,siempresuamor,20091117,31,4.548387096774194,113.12903225806451,39,11,28
A32HSNCNPRUMTR,"S King ""S King""",20081221,59,3.8135593220338984,116.2542372881356,110,151,-41
A32IG4MF6UFC2I,"Chris R. Field ""christoph281""",20081204,35,4.942857142857143,321.3142857142857,1052,73,979
A32JCI4AK2JTTG,"Darryl Bennett ""Fuzzy342""",20081030,40,4.85,38.75,32,4,28
A32K6WN17LBZHO,freddy,20090826,28,3.8214285714285716,82.5,20,32,-12
A32LR27V9CW2IA,J. Hicks,20080220,35,3.857142857142857,261.9714285714286,131,17,114
A32LX4XJ2LU740,"PositiveLogic ""Looking for Positive, Not Fear...",20100207,75,4.253333333333333,350.12,1268,97,1171
A32M7HKY7SQ602,J. mcnalley,20070626,29,4.275862068965517,133.68965517241378,191,17,174
A32MZZ6LEZCGRL,"Dwranny ""Dwranny""",20101030,29,4.896551724137931,98.24137931034483,50,6,44
A32NEDX6UVV8DE,"John G. Svinos ""Harleydude""",20071209,65,4.492307692307692,58.707692307692305,63,19,44
A32O5FZH994CNY,"G. Ware Cornell Jr. ""anotherlawyer""",20020802,139,4.366906474820144,247.72661870503597,2413,488,1925
A32O98PFC3OP7K,A Gamer at Heart,20051209,51,4.254901960784314,284.5686274509804,299,54,245
A32OJUBUBSTJ7S,DB from NC,20060925,25,4.08,135.84,94,14,80
A32ORGD6KLKM9N,BlinkDog,20070513,26,4.6923076923076925,86.15384615384616,34,3,31
A32PXHL6BE7YA7,Stanley P. Miller,20080731,24,4.583333333333333,70.08333333333333,11,3,8
A32QOZWIKQDNZX,Alex Vox,20030807,61,4.442622950819672,162.0983606557377,720,216,504
A32R5R84WPQW3Y,Lagenorhincus,20110728,23,4.565217391304348,53.130434782608695,19,6,13
A32R9X6MNUK9NS,twitterisfortwits,20100317,31,4.290322580645161,52.0,5,4,1
A32RUSNXS6E7BB,"S. Cea ""726""",20070409,21,4.523809523809524,105.0,21,5,16
A32T2H8150OJLU,ARH,20051229,65,4.492307692307692,369.33846153846156,226,41,185
A32T3LGQGWGJYE,Myself,20120209,35,4.228571428571429,59.885714285714286,50,38,12
A32T4Y9FHUBH4T,Dao Vang,20081009,26,4.923076923076923,59.96153846153846,18,5,13
A32UJOTFMGTIX9,Amazon Customer,20080622,25,4.52,191.64,17,5,12
A32UTJS67YEIHM,Chris,20110718,39,4.641025641025641,139.02564102564102,186,24,162
A32V1A0ER6VKTX,Kyle Albanese,20130121,28,3.857142857142857,49.607142857142854,11,12,-1
A32V4TT1ZJVY2G,Sam,20110710,31,4.387096774193548,177.2258064516129,20,3,17
A32VL4ONUB9UBE,tony,20100902,24,4.75,51.958333333333336,6,6,0
A32WAYM4YZGKW2,"Bill Hansen ""Bill Hansen""",20110820,24,4.541666666666667,168.91666666666666,36,11,25
A32WS1SQTDYYO,"G. Roberti ""Ironpeddler""",20041107,23,4.3478260869565215,235.2173913043478,62,2,60
A32XGYDA14KT13,"A book lover in Azle Texas ""BookLoverAzleTexas""",20111213,25,4.48,93.0,36,33,3
A32XMT8ULJ5CDV,dontwannabeageek,20041124,21,4.0476190476190474,203.42857142857142,44,3,41
A32XQF33A9310C,Amazon Customer,20050321,25,4.52,371.56,528,25,503
A32Y3K1IR8VRPA,Norris G.,20120708,37,4.702702702702703,166.16216216216216,263,40,223
A32Y5L6MQ62KM8,Amazon Customer,20121017,24,4.75,261.9166666666667,42,11,31
A32YYYVKP59DGV,"TomG ""CW Junkie""",20060808,25,4.84,25.8,11,2,9
A3300ZHK4SPWC3,"TABco ""TABco""",20120817,27,4.666666666666667,63.44444444444444,14,2,12
A33152QEGO2MZN,Leonard Bernstein,20101204,57,4.666666666666667,85.43859649122807,48,5,43
A332PFV02HENHO,Jeff Chandler,20111001,21,4.809523809523809,29.571428571428573,4,0,4
A332W1GRILS1QR,,20130201,23,4.782608695652174,41.82608695652174,8,1,7
A333636QFPT073,Wanderer,20070512,27,4.037037037037037,253.55555555555554,182,21,161
A334QQ8DK14SW1,Donald Filbert,20090920,23,4.913043478260869,85.1304347826087,25,3,22
A3353A5G99R9QI,C. Bakhos,20130730,25,4.48,30.04,3,1,2
A335QXPTV1RIV1,"Art M. ""Art""",19991011,49,4.244897959183674,153.14285714285714,416,61,355
A336FCPK8ZVMYT,"Gerald Williams ""booklistener""",20051101,29,4.862068965517241,80.48275862068965,21,3,18
A336OCR8QA0H36,Brian Z,20130110,30,4.2,84.03333333333333,6,2,4
A33775AIB1A664,"Mark Colan ""duke-of-url""",20021110,68,3.8970588235294117,664.6470588235294,1537,105,1432
A338NPNTCXRHW9,,20131230,21,4.571428571428571,42.04761904761905,3,1,2
A339D0QQYH0ZRG,"D. Dahlbeck ""Tappah""",20100121,32,3.71875,109.3125,23,10,13
A33AEK6T00UR4X,FunCouple,20120109,37,4.918918918918919,51.37837837837838,12,3,9
A33AQPJYH7UUXR,"Desert Gypsy ""A Brooklyn Girl Out West""",20110929,41,4.317073170731708,202.4878048780488,88,7,81
A33C54SGWSUHJ5,"Allen ""Allen""",20091202,31,4.225806451612903,95.3225806451613,23,6,17
A33CNFK776MTWR,David M. Reed,20060103,50,4.34,164.14,194,23,171
A33DH7DJ0HIDB3,Paul Avery,20120223,22,3.909090909090909,36.40909090909091,15,8,7
A33DUVUIC7G553,Ryan D,20121218,25,4.68,221.16,51,8,43
A33EEX2DOYPLSV,Duff123,20110104,35,4.714285714285714,182.14285714285714,38,7,31
A33FE8NR17Y1AE,Caralucy,20121102,23,4.608695652173913,75.73913043478261,12,4,8
A33FS5H3CPDR6D,"Miguel Ali ""Film Director & Political Pundit""",20030830,34,4.352941176470588,246.35294117647058,1339,150,1189
A33FZNPF0TRLYN,Coyote,20120418,25,4.72,399.08,195,34,161
A33GNK4YENACDJ,John McQuitty,20051211,36,4.611111111111111,247.66666666666666,1011,26,985
A33HIV8RXRDM88,"Kanishk Rastogi ""Freelenser""",20040305,110,4.209090909090909,182.94545454545454,429,78,351
A33IJGLTVS5MDS,Trailman,20051128,34,3.4705882352941178,225.11764705882354,279,52,227
A33JABAIRL4XOO,L-Con,20120926,21,4.428571428571429,70.47619047619048,63,5,58
A33JGP7NR4BV8W,"Tracie ""tracieknits""",20020228,30,3.8666666666666667,133.6,26,13,13
A33K4EXKFBZW28,kdoug,20081111,38,4.157894736842105,95.39473684210526,181,40,141
A33K75N54AW4DC,Christopher M. Judge,20100528,21,4.190476190476191,114.9047619047619,15,5,10
A33K8EOQH55J62,"PinnacleStudioPro ""AMAZEME""",20100725,27,4.518518518518518,100.81481481481481,9,1,8
A33KJZ6GCAUKOV,Ronald K. Goodenow,20020130,26,4.038461538461538,385.1923076923077,426,41,385
A33LBTRTH6XOLE,Daniel Allen,20110412,35,4.685714285714286,62.542857142857144,7,1,6
A33NUVKG22QKRE,"Frank G. ""Once More, With Feeling!""",20081010,21,3.9523809523809526,227.71428571428572,118,5,113
A33OF5NLPRZ5YT,"M. Bishopski ""Lost in the Woods""",20070107,23,3.6956521739130435,99.6086956521739,34,12,22
A33PBU9EHZ28PC,C. Park,20081124,39,4.282051282051282,76.23076923076923,21,40,-19
A33PHV84OHDJMN,Steve,20060611,24,4.166666666666667,338.0,86,16,70
A33PVCHCQ2BTN0,SuzieB,20110810,50,4.66,202.18,118,28,90
A33QCH9A5TS4R1,cdelr334,20120119,21,4.714285714285714,132.33333333333334,19,1,18
A33QOSYADK6BWK,QZ,20121213,21,4.904761904761905,74.9047619047619,33,6,27
A33QUFNY4E5D0,Pikmin,20050816,38,3.5789473684210527,172.1578947368421,225,67,158
A33SDWQL0LLBS6,"bill1228 ""Myersw""",20070904,22,5.0,138.04545454545453,61,6,55
A33SFSEVHL5SHK,Pileated,20060110,28,4.0,275.7142857142857,317,43,274
A33SG2UA24DJ9P,tomjonesrocks,20040830,28,2.9642857142857144,222.92857142857142,427,93,334
A33SX0AD5PYD9B,Kortick,20110805,53,4.113207547169812,213.0754716981132,66,19,47
A33UOIP7UFFURZ,J. Preece,20070502,39,4.641025641025641,164.23076923076923,92,13,79
A33V6UG1RDIRG3,John O,20110710,30,4.766666666666667,158.33333333333334,23,4,19
A33VRJI740P8IA,JimboPA1,20110818,24,4.0,75.45833333333333,9,6,3
A33WBYCTL1UDPG,Peter Singh,20070830,23,3.9565217391304346,206.52173913043478,1077,46,1031
A33WDEUQ9AII6S,K.C.,20070513,34,4.4411764705882355,121.52941176470588,46,2,44
A33X80DIINN48Y,"J. Dugas ""signature""",20080403,29,4.379310344827586,211.68965517241378,325,44,281
A33XAGW43Y7XH3,Ron,20111017,21,3.857142857142857,101.33333333333333,25,9,16
A33XMCG1UFDSY2,Natale A. Fruci,20080504,55,4.5636363636363635,24.87272727272727,8,9,-1
A33XVXRBE39SAP,"Gary A. Creighton ""Gary A. Creighton""",20081211,33,4.848484848484849,101.6969696969697,237,44,193
A33Y8C4818EJL0,"Live, Laugh, Love...",20110524,31,4.516129032258065,78.35483870967742,107,44,63
A33YZNZIRA3H97,l2,20070422,118,4.0423728813559325,146.23728813559322,644,93,551
A33Z318TMDAFDM,Shinebox,20110108,24,4.25,355.9166666666667,117,44,73
A33ZD42EE62AFR,J. R. Sheehy,20090205,27,4.037037037037037,63.44444444444444,22,17,5
A33ZYFE8XMKKR1,"P. Scott Pope ""Scott Pope""",20050311,47,3.702127659574468,274.7659574468085,341,51,290
A34188AG8SK70T,"Crash and Burn ""Resident Curmudgeon""",20080405,32,4.15625,277.90625,79,15,64
A341HCMGNZCBIT,Ordinary guy,20050818,47,4.829787234042553,109.25531914893617,172,20,152
A342PAZ5NSQRM3,Amazon Customer,20110710,25,4.6,187.4,5,4,1
A342QC1XUT1Z5S,"Ryan B ""Byrd""",20130112,29,4.379310344827586,133.79310344827587,11,1,10
A343ENF730UN71,CameraLady,20081102,34,4.588235294117647,68.05882352941177,8,4,4
A344GA15FSBNSD,"J. Cart ""packrat201""",20061106,26,4.884615384615385,76.03846153846153,42,8,34
A344HKYO36KSMS,The Irish Patient,20050221,22,3.727272727272727,368.8181818181818,192,20,172
A344VEWRU3SLRP,Michael Andersen,20100227,22,4.409090909090909,39.63636363636363,3,1,2
A345BXR9RAZPQL,"Legal Eagle ""working gal""",20130520,25,4.44,41.28,4,18,-14
A345H94F23ACMH,Dogmatik,20121208,21,4.714285714285714,103.04761904761905,9,3,6
A3466OP6D0UL3B,Navandi,20120129,23,4.521739130434782,48.47826086956522,18,2,16
A346X6HLC1ERK0,"Clay Shooter ""Breakin' clay makes my day""",20081219,31,4.387096774193548,126.6774193548387,17,5,12
A347LTN4RU2FL1,Yeoman Johnson,20130110,25,4.68,26.28,3,0,3
A3488WC5YC68CG,Spencer Pitcher,20100817,21,4.095238095238095,53.19047619047619,14,4,10
A34A1UP40713F8,Amelia D. Backus,20110227,31,4.580645161290323,35.58064516129032,7,4,3
A34BZM6S9L7QI4,"Candy Cane ""Is it just me?""",20100324,154,4.558441558441558,137.58441558441558,768,37,731
A34C98SJU4M7DD,PhAzEr DaZeR,20100917,28,4.214285714285714,130.17857142857142,122,39,83
A34C9AFFZOI45T,T. Sessoms,20100601,97,4.793814432989691,216.51546391752578,830,85,745
A34CE623TDL7LU,Spicy Mamma,20090305,21,4.571428571428571,83.47619047619048,4,1,3
A34CKIMZ969UW7,ritewinger,20081102,43,4.069767441860465,78.55813953488372,70,42,28
A34CSXOGVYF94S,"Joel Avrunin ""Electrical Engineer who loves S...",20081231,73,4.287671232876712,458.1506849315069,1377,140,1237
A34D5MR1R8IC7E,Go Bruins,20110114,26,4.230769230769231,93.07692307692308,52,14,38
A34DQINHT6NYJU,"Kathi Miller ""Kisserman""",20091227,59,4.0,260.06779661016947,87,35,52
A34F0HOVDIG7EU,nusun23m,20110930,21,4.428571428571429,46.666666666666664,7,1,6
A34FBZLFAU88UG,NCHammer,20111027,30,4.833333333333333,111.43333333333334,77,36,41
A34GB2ZA1JLGND,NEWKINDLEUSER,20101214,33,4.515151515151516,92.54545454545455,37,6,31
A34GM17T6WTJDK,D. MCKICHAN,20070122,36,4.555555555555555,336.8611111111111,167,21,146
A34HYH25VI5DX3,"Amazon Customer ""pnutter""",20120104,38,4.7631578947368425,67.57894736842105,30,23,7
A34IBXM7E8CPWE,David Girod,20050429,26,4.1923076923076925,239.76923076923077,130,29,101
A34IJACMU8C3IM,"Rob W. ""Sounddude""",20080502,22,4.2272727272727275,380.3181818181818,127,11,116
A34IWBVNW1JHUO,Glynne,20121125,34,3.7941176470588234,64.32352941176471,14,8,6
A34IYW7VLUKTOM,Matthew Franzel,20120421,44,4.681818181818182,61.61363636363637,35,16,19
A34JKODTSKCGEN,"Omni Presence ""TK421 Modified""",20070929,46,4.565217391304348,335.8478260869565,156,45,111
A34KBI5VOYXG9U,Tom (Just one Tom),20090706,21,3.761904761904762,118.23809523809524,30,17,13
A34LJ62YXXVAOG,neonsport,20131031,21,4.9523809523809526,54.61904761904762,1,0,1
A34LQ791ACZ0JC,"karaoke ""music lover""",20070115,61,4.770491803278689,90.24590163934427,55,17,38
A34NI8DC5AAE2W,JTown,20120425,23,4.695652173913044,104.34782608695652,2,0,2
A34O0KQV4QXWNQ,"Dako ""Dako""",20110707,32,3.6875,130.71875,34,6,28
A34OD5GD02R6KN,R. Merck,20090209,33,4.0606060606060606,30.666666666666668,5,1,4
A34OXK9SP7TNCT,mr_et2,20130117,21,4.190476190476191,78.14285714285714,5,3,2
A34PLG8NWY4IBZ,"JJ ""DIY""",20050113,21,4.523809523809524,96.42857142857143,34,15,19
A34PRWLV61Y355,Pseudonym,20080125,25,4.28,216.04,261,23,238
A34R2Q3FU4AUHW,"Strati G. Vourakis ""Drjones""",20080426,21,4.857142857142857,341.57142857142856,200,17,183
A34RLV8RAH5KDD,"imu ilu ""143""",20041104,23,3.6956521739130435,297.4782608695652,550,151,399
A34S5Z2A7PR6OL,Kenne,20110717,36,4.527777777777778,64.58333333333333,18,6,12
A34SDL7IQ76CXV,Richard,20121005,21,4.619047619047619,64.33333333333333,20,25,-5
A34UEBDU8IYLV7,MarkABee,20081105,26,4.730769230769231,198.0,99,13,86
A34USOX3ERME86,Terry M,20110203,22,4.7272727272727275,99.5909090909091,10,0,10
A34UVV757IKPVB,justsomeguy,20060616,95,3.6736842105263157,242.07368421052632,313,172,141
A34UZMZ043704I,Brian J. Rueger,20080505,24,4.458333333333333,42.916666666666664,56,4,52
A34VCCL1YO6D0I,Peter Dykhuis,20001227,40,4.1,191.625,489,60,429
A34VM6OQHV6ROZ,"R. Berry ""Okie""",20090127,39,5.0,114.43589743589743,233,35,198
A34VRVI4CSI5RQ,Matthew K. Morgan,20090206,75,4.253333333333333,647.4266666666666,1382,95,1287
A34VV0DDR0OFE5,K. Rowley,20070604,39,4.615384615384615,283.87179487179486,265,34,231
A34WRF3C70VMLL,frankfromnj,20070207,40,4.075,207.975,147,27,120
A34XRXHZ6BGEQD,,20130522,22,4.909090909090909,25.363636363636363,2,0,2
A34ZXK43BUZ4HC,Charles Vanderbilt,20090217,24,4.833333333333333,57.833333333333336,18,5,13
A3503WWKDSVXWF,B. Harris,20101104,22,4.409090909090909,175.6818181818182,395,30,365
A350H73QNQU2T2,Ted Weissgerber,20110810,23,3.5217391304347827,84.3913043478261,10,3,7
A350HRB16YUX9P,"Ron Wis ""Rw""",20070906,27,3.888888888888889,144.07407407407408,56,11,45
A351KOZWOOEKKU,Law,20110624,27,3.6296296296296298,110.74074074074075,36,9,27
A35293YH3GCP0U,Gary,20090711,23,4.043478260869565,182.52173913043478,50,14,36
A352NL60HDSUKU,Inwester,20080725,26,3.6923076923076925,363.9230769230769,240,51,189
A352O0OK12EIDY,Fairfieldwizard,20100829,23,3.0869565217391304,225.65217391304347,173,48,125
A35354A8LIKTLT,M. Chan,20140208,21,4.666666666666667,224.71428571428572,24,3,21
A353U0L2HAMSHV,"Cricket ""Living life and loving it!""",20080222,111,4.108108108108108,193.9189189189189,345,59,286
A354GLN1MK52Y5,I love buying stuff,20130911,21,4.523809523809524,33.0,2,7,-5
A355RC1I9JEK4H,Robert Schmitz,20080126,29,4.620689655172414,43.10344827586207,19,8,11
A356RFKNIG043B,K. Swanson,20060523,49,3.938775510204082,400.46938775510205,643,58,585
A357B3PUHSVQA,"Y. R. Wu ""The will to win is nothing without ...",20060510,84,4.0,354.8333333333333,763,83,680
A358AZ20WPULEQ,Van,20100814,23,4.3478260869565215,87.56521739130434,25,5,20
A358U1JEA514P6,lynne,20110416,21,4.333333333333333,31.238095238095237,16,3,13
A359EU8KKNH8JV,Stephen in Plano,20090101,26,4.346153846153846,75.15384615384616,38,11,27
A359GGHB5EOEHA,Techno Guy,20050801,25,4.88,43.28,17,11,6
A359MYLPLEOF7N,KP Jandt,20110425,40,4.575,105.375,35,11,24
A359XIBXA34BX6,R. Anderson,20070322,38,4.157894736842105,294.1578947368421,554,66,488
A35A2RWUMC737N,Gamore,20130122,61,4.377049180327869,46.85245901639344,6,14,-8
A35A7B02098XAT,Brandon M,20080810,23,4.478260869565218,151.95652173913044,21,9,12
A35AU5GPOQY5U1,Ray Stewart,20061112,26,4.153846153846154,132.80769230769232,14,3,11
A35BBZSYLQGGVI,"Efros ""12th level priest""",20080718,30,4.8,92.7,26,3,23
A35BVGH5X6Z4QH,Marino Shauye,20080322,28,4.25,237.60714285714286,88,40,48
A35C2IVVQR1HTK,"DK ""Coach""",20070409,67,4.029850746268656,165.83582089552237,295,46,249
A35DI8NJG51PZ4,S. Adkins,20130523,21,4.142857142857143,50.61904761904762,6,4,2
A35DXKKJWTVB7G,Amazon Customer,20130119,22,4.954545454545454,64.31818181818181,11,0,11
A35EIZ0JS0DNOC,Steven S. Nelson,20111210,21,4.904761904761905,77.47619047619048,22,7,15
A35ETL6NWKF6JX,C. Jolls,20090410,37,4.0,118.62162162162163,47,8,39
A35EYBTHX5GDP3,"Ritas Mom ""rita's mom""",20080324,21,4.666666666666667,66.04761904761905,5,1,4
A35FQ1CFU3FAAG,A-Tan,20110324,30,4.866666666666666,29.166666666666668,6,4,2
A35HFZ8O44O062,Carl,20110515,31,4.741935483870968,89.41935483870968,38,4,34
A35HNL2VEDK9Z1,Doctor C,20071223,67,4.268656716417911,225.23880597014926,875,405,470
A35HOUWHAYZZN6,Hedera Femme,20070408,53,3.9622641509433962,203.9811320754717,85,39,46
A35HUT8MQMT21L,Manny,20091016,67,4.134328358208955,86.16417910447761,123,29,94
A35ILBIBAXYHJW,"K. Dardashti ""Electronics fan""",20041214,21,4.523809523809524,112.23809523809524,994,134,860
A35IX2GE0VC0JP,"FirePepper Red ""firepepper red""",20050907,67,3.611940298507463,245.65671641791045,280,66,214
A35JHHE1NW0DIK,"A. F. Butchart ""Consumer""",20080710,23,4.391304347826087,155.3913043478261,80,8,72
A35JWG51KXPRJZ,Sanford A Mullet,20130520,29,4.551724137931035,32.44827586206897,3,4,-1
A35K1FNE06IRQJ,"Amazon Customer ""TJ""",20110403,23,4.478260869565218,50.69565217391305,19,8,11
A35KBAQ4VBNQ6L,DodgeD,20110307,54,4.722222222222222,34.48148148148148,14,15,-1
A35N8F5V2PELR9,Jimmy Kim,20120824,34,4.4411764705882355,123.26470588235294,75,11,64
A35NA14R0332AZ,"CMO ""CMO""",20080106,21,4.238095238095238,72.04761904761905,25,5,20
A35NAFXV5GHZ92,"D. Limbach ""Gadget Guy, Digital Media Produce...",20050803,27,4.666666666666667,139.25925925925927,69,31,38
A35NNZER9GP29Z,"Kenneth A. Patterson ""The Haunted Studios(tm)""",20101206,24,2.7916666666666665,55.208333333333336,31,21,10
A35OIWPVTGW3UC,Allan Hawkins V,20080608,53,3.4339622641509435,49.39622641509434,113,273,-160
A35ONL9ORL46UD,The Chef,20121220,22,4.363636363636363,57.13636363636363,6,19,-13
A35ORHRXYF9HM1,W. Bison,20080829,33,4.303030303030303,180.6969696969697,78,18,60
A35PL6PRWEZUA1,RosieAndMe,20050216,27,4.037037037037037,103.11111111111111,180,52,128
A35PPI93DWFF1H,Guillermo Perez,20081107,21,3.9523809523809526,156.1904761904762,61,19,42
A35Q0RBM3YNQNF,M. Hill,20100107,82,4.524390243902439,422.109756097561,458,61,397
A35R6ZWYHCKT0J,"JLB_TX ""Critical Eye""",20100821,21,4.666666666666667,62.142857142857146,21,5,16
A35SNSDRNE9P8Q,Kentucky Colonel,20101031,48,4.791666666666667,153.45833333333334,103,25,78
A35SQCUQBEZUKD,Leo Koach,20060423,23,4.782608695652174,107.91304347826087,62,8,54
A35T95CVL2QB9O,Jennifer,20130305,32,4.71875,46.625,25,5,20
A35TD8QAUMV0DB,Stephen G.,20040121,28,4.178571428571429,190.60714285714286,270,31,239
A35TOWGG1F5CZM,Ritchie Hernandez,20080224,24,4.791666666666667,62.541666666666664,40,17,23
A35UDCJGVPIPG6,Max Harry Johnson,20100723,28,4.5,331.25,379,16,363
A35UY8DCG2S57T,MkVsTheWorld,20120412,28,4.607142857142857,93.07142857142857,8,3,5
A35VOMDKKO3TOY,"Tony T. Kao ""Holycow""",20051228,31,4.387096774193548,160.29032258064515,455,52,403
A35W3JQYP0M655,"John Thomas... ""New England...USA""",20090212,73,4.3561643835616435,391.1232876712329,1689,107,1582
A35WYJH6MPPIFV,turf,20100213,21,4.190476190476191,298.7142857142857,166,11,155
A35X2JJI49OBZP,"C. Bayne ""katluvr_1""",20040831,71,4.549295774647887,203.42253521126761,403,45,358
A35X5DFR6NSU19,"Jacob Whittaker ""jacob w""",20120820,23,5.0,314.8695652173913,26,11,15
A35Z6A2J7CFW2,"dosers ""dosers""",20030812,29,2.896551724137931,165.86206896551724,1015,129,886
A360AVDDTDVA48,Mchel .  Mille,20101218,43,4.976744186046512,83.6046511627907,14,8,6
A360KI0SUWKUZ2,"M. Ross ""mick""",20090220,21,3.619047619047619,191.0,34,26,8
A360VP3RBMJFDL,Voyn238,20121204,44,4.5227272727272725,243.27272727272728,81,10,71
A3619DBZS5MXBM,Bob Montgomery,20121103,25,4.04,153.16,44,13,31
A361M14PU2GUEG,"Angry Ryan ""Ryan A. Forrest""",20110617,59,4.423728813559322,79.98305084745763,32,19,13
A361U4SXK7FCQE,"Joseph Jenks ""joe""",20070720,68,4.323529411764706,135.19117647058823,125,42,83
A362FM6FYA1SYS,kendalltristan,20120410,54,4.7407407407407405,143.11111111111111,98,23,75
A3639Z6O5JBLIZ,Brucer,20051108,54,4.833333333333333,163.12962962962962,1575,110,1465
A363G43TG2HTWV,Primeadona,20130607,21,4.523809523809524,28.666666666666668,6,5,1
A3643CL47FA32D,Eric,20100215,32,4.59375,70.3125,52,11,41
A36497S5E2I2MW,Bradley,20121106,27,4.814814814814815,102.03703703703704,13,8,5
A364YOXAKXTXP5,Dan F.,20080414,33,4.484848484848484,180.06060606060606,31,8,23
A365BJAGU86XY8,DP21,20110918,22,4.0,547.4545454545455,92,11,81
A365PBEOWM7EI7,ventingisok,20110113,47,3.765957446808511,94.63829787234043,25,15,10
A368IPE6EW0GZL,Mike Vande Ven Jr.,20100116,51,4.333333333333333,131.23529411764707,76,11,65
A3692DDAB6MUUK,"David J. Riffle ""TV dude""",20081216,26,4.384615384615385,68.38461538461539,44,8,36
A369BU62O5EGDT,Troy  N.Stennett,20110612,30,3.466666666666667,90.93333333333334,16,17,-1
A36A0MMVRYA5UQ,AEinstein,20110325,29,3.8620689655172415,154.51724137931035,216,36,180
A36A1ZYZH8568P,"Ethan Winning ""Ethan Winning""",20040910,118,4.194915254237288,425.364406779661,1406,194,1212
A36AIK1DQPSRNT,"Dana Y. Bowles ""DYB""",20080621,22,3.9545454545454546,102.9090909090909,22,15,7
A36ARO7W03JMXV,L. Hammer,20090430,22,4.181818181818182,68.0,22,2,20
A36B7TZNERS5IW,Krykie,20041007,34,3.9411764705882355,167.14705882352942,205,29,176
A36COCV5K2KYZ2,"Paul ""Traktor""",20130125,22,4.681818181818182,147.45454545454547,7,1,6
A36DDTX8HBR3WE,Paul,20120807,41,4.512195121951219,49.09756097560975,16,6,10
A36DWWV2RBTIM9,"Palgume ""If the shoe fits wear it""",20111118,26,4.576923076923077,79.11538461538461,29,11,18
A36E35E8LF43AJ,"EeeVee ""Another reader""",20090527,36,4.972222222222222,101.08333333333333,63,12,51
A36EA1M8V6GNPG,Luvz Buying,20110727,23,4.217391304347826,74.43478260869566,10,1,9
A36HEY6E2XQT75,"mommylove ""dc""",20061224,39,4.538461538461538,131.48717948717947,54,46,8
A36HYRW5KQCFB2,"Butterfly ""AnneMarie""",20130521,23,4.565217391304348,56.130434782608695,2,3,-1
A36IHC0K68NS2,"Jeffrey N. Fritz ""Nikon Jeff""",20021130,87,3.5172413793103448,316.7931034482759,823,162,661
A36IOSZXG6HQAU,Calvin Young,20110702,29,4.206896551724138,152.17241379310346,13,2,11
A36IWN8Z8OS1J4,Archibald Tuttle,20130701,21,3.4285714285714284,91.04761904761905,16,3,13
A36JO8IHKYBMMJ,Bart Motes,20040611,45,4.088888888888889,265.75555555555553,171,42,129
A36K2N527TXXJN,Dr. Bojan Tunguz,20080713,281,4.5088967971530245,378.4128113879004,2756,164,2592
A36K8DLXYRUMBR,Amber M. Anderson,20090301,31,4.225806451612903,520.5483870967741,211,15,196
A36LMXZJQFOH4W,C.B. Stone,20070109,21,4.761904761904762,167.42857142857142,84,2,82
A36LXCG8MLXJQ6,Ralph Pittman,20101205,44,4.795454545454546,57.81818181818182,18,14,4
A36M9UYXV36TBC,R. P. Bush,20130128,24,4.666666666666667,90.83333333333333,9,5,4
A36MP37DITBU6F,"Enchanted  In  Dixie ""Enchanted""",20100620,57,4.140350877192983,127.64912280701755,284,44,240
A36N61L5UHXSHI,Ricus,20110825,39,4.256410256410256,93.15384615384616,18,10,8
A36NK6HQPZPUBW,Cash A. Echevarria,20091225,23,4.695652173913044,38.78260869565217,3,2,1
A36OOL5PM3Q3MG,Resident Skeptic,20070119,30,3.2333333333333334,205.6,100,34,66
A36PFPY4O3E1DV,C. Fernandes,20030612,21,4.0476190476190474,293.2857142857143,464,22,442
A36RFJNENEHPOA,Cary,20110926,22,3.590909090909091,69.04545454545455,17,16,1
A36SVWIPEH29FB,Mike S.,20090725,26,1.9230769230769231,119.96153846153847,54,30,24
A36W9KV1EJBF6W,E Wehman,20121129,21,3.4761904761904763,52.476190476190474,2,2,0
A36WTQL2AW6NR5,David Enzel,20030531,22,3.9545454545454546,168.72727272727272,184,49,135
A36XG2H1S14FW,Richie,20130321,21,4.666666666666667,34.714285714285715,16,5,11
A36Y7X194VWVKA,Mark D.,20130809,21,4.380952380952381,134.38095238095238,14,2,12
A370XYLIZCSK1Y,Jordan Austin,20100521,90,4.5,100.81111111111112,33,15,18
A372P5H7NJ0PTT,"R. Alexander ""Tech enthusiast.""",20120220,23,4.260869565217392,158.52173913043478,262,50,212
A372X2HNH627N1,"G. J. Parks ""pilot2b""",20130404,27,4.592592592592593,47.25925925925926,3,0,3
A3733XMLLL2R38,Agent 007,20100310,22,4.590909090909091,73.81818181818181,112,35,77
A376K0HK1D7F9B,James Scott,20100109,21,4.666666666666667,57.904761904761905,6,2,4
A376OJHLE6SU9Q,M. Wolf,20040403,132,4.4393939393939394,120.97727272727273,437,60,377
A3775OP5VTX5ON,"Coolkayaker ""ck1""",20020629,66,3.712121212121212,297.6212121212121,1730,187,1543
A377LPVLLAI42D,Chris,20031007,42,3.4761904761904763,372.0,1457,98,1359
A379DLIAF0MFM5,"Mr. Deeds ""Opportunity is limited only by ima...",20061218,54,4.425925925925926,222.03703703703704,168,51,117
A379IB3EYAEL5,"SPARKY0210 ""CC""",20110130,24,4.375,76.08333333333333,18,11,7
A37A41GWQFMK3D,Dr. Freud,20080315,33,4.7272727272727275,72.18181818181819,17,6,11
A37A5MO133QN2H,Rajesh Ramjit,20110510,31,4.387096774193548,125.25806451612904,96,40,56
A37AEEF1B0GHAR,Gauron,20101028,27,4.222222222222222,132.55555555555554,29,7,22
A37AGASI7HJY3H,oluv,20100714,21,3.7142857142857144,625.0,428,80,348
A37CEYB95LK6R6,Dovetail65,20071029,89,4.47191011235955,139.6629213483146,160,35,125
A37D1ZP8GBHE38,Sprout,20070903,66,4.348484848484849,282.04545454545456,558,40,518
A37D2TGTIXRV2N,"plyopowerd ""Arrow Dynamic Mom""",20090916,48,4.375,195.58333333333334,168,34,134
A37DMII9M4O14Z,Photography Fan,20110107,31,4.32258064516129,58.354838709677416,77,5,72
A37DXIENIDHTVY,D. Wortham,20061125,26,4.346153846153846,548.4230769230769,120,51,69
A37E5KVAKOZFVS,Amazon Customer,20050823,23,4.130434782608695,292.04347826086956,56,9,47
A37G90KBW3CZXT,Cms3717,20120307,29,4.448275862068965,34.55172413793103,2,1,1
A37H473BZHX9P0,~Miss~,20121216,22,4.2727272727272725,31.90909090909091,1,1,0
A37HO9KMMB0JYU,Lynne Butler,20120805,34,4.882352941176471,82.32352941176471,8,4,4
A37HON08NH2H2R,"Frostbeyet ""Thermal""",20130330,22,4.363636363636363,27.272727272727273,8,7,1
A37HULJ59GY82,"Howard E. Tyree ""Htree11""",20070930,40,4.4,107.975,57,13,44
A37I3SRFD7Z8UH,D. Darby,20091008,25,4.24,66.12,21,0,21
A37IDFXMOBY1B3,"K. Hales ""brewmaster1957""",20100315,21,4.0476190476190474,247.23809523809524,62,8,54
A37IHRVO8JWYF2,Emily D. Agunod,20080101,25,4.64,156.36,31,6,25
A37IRE9GZ0CZ7I,"Aliza M. Beer ""Books & Belongings By Beverly ...",20070621,88,4.181818181818182,97.55681818181819,162,26,136
A37JNUJSVAJKYN,"V. Cummings ""victorc1978""",20040307,28,4.714285714285714,114.39285714285714,150,18,132
A37K9BUJ3K98YU,Wade Lee,20121202,43,3.953488372093023,44.23255813953488,35,25,10
A37KD47W5WONHK,S. Eckelberry,20110411,22,4.5,88.0,174,12,162
A37KEW14MD925E,"Kindle Customer ""love country""",20070308,26,4.3076923076923075,74.61538461538461,16,15,1
A37KG9AQK1PN10,William B. Dwinnell IV,20051105,30,4.633333333333334,130.2,312,22,290
A37KI4OTT5B452,Albert,20121101,25,4.92,40.2,3,0,3
A37KQ2QVXLNYP3,Richard C. Anderson,20130502,25,4.88,46.16,4,2,2
A37KXO7BGF1NMK,D. Henry,20130304,24,4.833333333333333,72.70833333333333,12,1,11
A37LLXWSLE879D,C. Walker,20080121,45,4.733333333333333,121.55555555555556,47,7,40
A37M3UTGX8CYIO,J Reinhart,20130126,30,4.833333333333333,119.06666666666666,45,2,43
A37MH7ICH80QOX,Kate McMurry,20110930,40,4.775,150.525,119,9,110
A37MTEV0TR9C3M,Kili Sands,20120224,29,4.379310344827586,69.10344827586206,18,4,14
A37N4W4RD4LKLA,Audio Guy in NC,20080426,29,3.586206896551724,276.86206896551727,151,13,138
A37PMCCEBEKPYK,Dallas Grantham,20111114,23,4.956521739130435,63.52173913043478,10,4,6
A37PV5GMP2ILJC,Amanda Richards,20041001,44,4.090909090909091,330.0,548,87,461
A37PZJH2F13IOR,"J. Rose ""JR From the Ball so Blue""",20070424,29,3.6551724137931036,112.51724137931035,64,57,7
A37QUQPYFMR9Y9,"M.D.C. ""Tempting Reviews""",20021130,33,3.727272727272727,846.6666666666666,1149,164,985
A37QUT4L7E6GPQ,Sir Loyne,20100110,23,3.0434782608695654,209.1304347826087,109,22,87
A37R3ICPIJRH67,Michael Paul Sebek,20090124,21,4.809523809523809,188.38095238095238,137,11,126
A37R5M2DJRRWG8,S-T-R-Y-D-E-R,20121126,22,4.045454545454546,52.68181818181818,7,8,-1
A37T2MU6L4521N,Scott Johnson,20130704,21,3.9523809523809526,101.19047619047619,40,115,-75
A37T74W067OYPB,Amazon Customer,20111028,21,4.0,47.04761904761905,6,9,-3
A37TFUSY61EFEB,John,20121128,23,3.217391304347826,323.6521739130435,16,13,3
A37U4HM0UG7FQ0,"T. Knox ""Regular Guy""",20091228,42,4.071428571428571,137.83333333333334,110,18,92
A37WU7T0IMD3KA,Kevin K. Fosler,20051228,28,3.9285714285714284,300.75,1933,77,1856
A37WVR9M1STQDU,"J. Musto ""Toolman Joe""",20060731,36,3.7222222222222223,301.5833333333333,375,46,329
A37XQ1R7WFPXXP,Gabriel Young,20100729,41,4.170731707317073,203.6829268292683,64,14,50
A37YSQCST33ZG8,"Jack Sprat ""jACKs""",20100211,28,4.214285714285714,197.57142857142858,41,6,35
A37ZI5TGSV8LLB,PC Scooter,20121220,23,4.434782608695652,140.17391304347825,13,2,11
A380P8LHEL3DZ9,"Eve UrAlly ""Ur Ally""",20121202,27,4.777777777777778,44.925925925925924,9,2,7
A381C6UUUIAB4V,NoBS,20090419,40,4.5,72.225,20,3,17
A381MT950I6KRL,JujubeMBA,20080724,24,4.041666666666667,106.08333333333333,23,13,10
A383XURHVF8ON6,Mrs. Kilo Delta,20081101,31,4.387096774193548,172.09677419354838,36,10,26
A384HAQMS7XRZ4,Tory,20110321,39,4.230769230769231,164.25641025641025,94,26,68
A3859W0UMFT6OG,Music Man,20080322,30,4.8,30.6,16,2,14
A385HZRPXDDFCL,Bob,20121127,39,4.871794871794871,30.71794871794872,2,1,1
A3866HDI6HMH53,"burke ""RTB""",20091006,25,4.4,117.24,26,15,11
A386LG0LRWKJZP,The Engineer Critic,20090701,61,2.7540983606557377,155.31147540983608,344,106,238
A386NVAVQV5WUO,"Richard D. Cappetto ""RickDC""",20020217,33,4.818181818181818,146.24242424242425,325,34,291
A386OP2O7Z5Y5L,"Derek Lowe ""twerking the jalopy""",20090916,33,4.0606060606060606,276.2121212121212,88,24,64
A3872Y2XH0YDX1,Amazon Customer,20071115,55,4.890909090909091,96.27272727272727,164,20,144
A38754C78HLXXP,Mike in San Diego,20080331,29,3.5172413793103448,123.82758620689656,128,14,114
A3877AOBSDUG2R,xyz123,20080503,22,3.409090909090909,49.22727272727273,18,46,-28
A3887GAGBKHG03,R. Ho,20081205,25,3.92,150.56,85,52,33
A389U7BPUTJRG3,MN from LA,20140321,26,4.076923076923077,52.42307692307692,9,1,8
A38B5RIJZ8Z8K2,DGator,20130302,25,5.0,69.0,139,7,132
A38B7DTWWL4JE,Glenn Connery,20000901,36,2.6666666666666665,138.83333333333334,94,40,54
A38BE06WWL20AY,"James Mcritchie ""Publisher/Investor""",20040106,24,3.75,154.625,2,9,-7
A38C12950IM24P,Christopher J. Cowen,20131031,59,4.745762711864407,186.5084745762712,672,92,580
A38CHSS1ZAE51B,Handy,20120321,43,4.209302325581396,132.11627906976744,26,7,19
A38DDM9FUAF4H1,"An Ikearat's Brain ""Tom""",20101220,24,4.166666666666667,241.95833333333334,199,18,181
A38DQSVRIXBP00,"H. S. Pope ""Spidurman""",20050313,24,3.4583333333333335,282.4166666666667,193,13,180
A38FBFG21XSUG0,"E. Tucker ""Looking for the Best""",20061126,27,3.4444444444444446,294.7037037037037,356,51,305
A38FEJ8BPFY320,"Nelson E. Ingersoll ""Nelson""",20091113,25,4.8,103.2,47,3,44
A38GBU7WGJARD0,J. Moore,20110512,21,3.8095238095238093,65.04761904761905,2,0,2
A38HO2WZIWE5B8,1fstfreride,20101019,32,3.8125,138.34375,104,27,77
A38IFC31823UST,"SL ""pismo10""",20030327,21,2.0952380952380953,110.28571428571429,79,88,-9
A38K3YPGRNGXGW,C. S. Brock,20110314,21,4.523809523809524,42.523809523809526,7,2,5
A38KK0SZYEH5UD,Busy Executive,20050905,161,4.3478260869565215,368.83850931677017,3585,223,3362
A38KXE0ISYCGTI,Max,20120722,25,4.88,44.44,11,6,5
A38MQHVEICK46P,"Patti Chadwick ""Patti Chadwick""",20120816,21,5.0,33.61904761904762,6,8,-2
A38NELQT98S4H8,W. B. Halper,20070703,86,4.0813953488372094,187.19767441860466,364,68,296
A38NHXL5257E3B,"Big Dawg ""Big Dawg""",20081202,92,4.565217391304348,104.84782608695652,256,38,218
A38O4FPZOIVS49,"JCC ""Tech Maven""",20011022,32,4.28125,288.96875,1347,152,1195
A38OCDJQOAQ2XG,P. McGuire,20040806,42,4.5,202.83333333333334,381,18,363
A38OCEOMU8XOX4,qrpike,20131112,29,4.827586206896552,52.44827586206897,3,12,-9
A38ON1MOZNBCGE,Richard Wagoner,20010911,39,4.487179487179487,124.05128205128206,82,19,63
A38Q2EI3LM24VT,"Ryzeldorf ""Ryzeldorf""",20040501,28,4.5,197.25,381,29,352
A38QEATH3NODFM,Wiseguy 945,20060625,43,4.767441860465116,253.58139534883722,309,20,289
A38QHZEEYZKT27,"Amighty ""Celebrity Poker""",20051014,28,3.5714285714285716,324.10714285714283,255,34,221
A38R7G4PREOMLE,R. Petersen,20100316,26,3.576923076923077,149.6153846153846,59,11,48
A38RMU1Y5TDP9,"Bob Tobias ""Robert Tobias""",20060624,244,4.389344262295082,294.2581967213115,6786,296,6490
A38SHOPZADNOLN,Bigrin,20011224,29,4.827586206896552,71.37931034482759,89,2,87
A38SKJGDRRX5V5,S. W. Conley,20120422,29,4.793103448275862,99.27586206896552,16,6,10
A38T55CCT4B3E6,Luan C. Do,20001209,35,3.4285714285714284,166.14285714285714,73,46,27
A38V76R24EJSHA,Lee Geiger,20081004,40,4.75,183.975,22,7,15
A38VI9M6QIDPI3,"GChicago (International Man of Intrigue) ""&#3...",20070108,27,4.62962962962963,191.62962962962962,33,6,27
A38WZ0ITR34AFN,Chinarut,20110306,26,4.0,119.88461538461539,14,3,11
A38WZ3WVV7LCNN,"LFGD1978 ""The Shopaholic""",20070916,29,3.896551724137931,160.20689655172413,55,24,31
A38X9XX2ZRR0ON,AS,20040619,35,3.4,232.4857142857143,150,53,97
A38XFBDC2Q1FRV,eblak3,20130905,28,4.714285714285714,136.5,5,2,3
A38Z11QP8B702T,Walter L. Johnson,20130220,26,4.346153846153846,90.61538461538461,7,5,2
A38Z49JP51XS3M,W. A. Cicora,20100207,25,4.24,61.32,12,5,7
A38Z6QG6988WS7,,20111021,45,4.933333333333334,110.95555555555555,31,8,23
A38Z8ZXX1BPFRL,"Melodie ""2kidznus""",20091231,22,4.590909090909091,99.45454545454545,16,11,5
A390F07SOAS4NI,"Shawn P. Smith ""is a Christian""",20101108,21,4.285714285714286,205.85714285714286,144,12,132
A390UFRRO2BLZS,"Tony Polito ""TonyPolito""",20051117,25,3.96,613.8,922,57,865
A39137LW12KK7B,"R. Toro ""Tech Junkie""",20081110,65,4.630769230769231,243.24615384615385,464,21,443
A391AS877NJKUB,"G. Smith ""Egghead""",20071208,32,4.25,128.71875,14,1,13
A3923UGIPX0QQM,ETD,20120129,25,3.36,180.76,53,13,40
A3927QGXOBDV0J,G. Monroe,20100926,25,3.96,92.32,46,8,38
A392BGTO28EN6V,"S. Jenkins ""Arshes Nei""",20061214,35,3.4857142857142858,397.7142857142857,596,87,509
A394CFIQH570SM,acousticmany,20120510,34,4.676470588235294,61.911764705882355,47,9,38
A3956O40ZZYFMY,"Dennis ""barbarosa""",20081221,27,4.407407407407407,110.33333333333333,22,9,13
A395BO6E2BLYW,Mariano,20120809,25,4.36,35.6,7,2,5
A395C200US350X,"J. Smith ""MacJoe""",20110704,29,4.206896551724138,78.06896551724138,21,4,17
A39633CU9DC0PY,"A. J. Minhas ""althotos""",20080828,34,4.294117647058823,168.6764705882353,51,7,44
A3963R7EPE3A7E,"John N. Schar ""cxxi121""",20061203,63,4.7936507936507935,288.031746031746,193,33,160
A3968V5F8JKMA3,DJ MinWah,20100807,34,4.970588235294118,76.38235294117646,20,4,16
A3969TR566TRCY,escavideo,20120229,21,4.571428571428571,70.66666666666667,1,1,0
A396ELNTQDFYPO,Mark King,20110219,32,4.25,159.625,105,26,79
A3977M5S0GIG5H,Joel Dauteuil,20060824,85,4.670588235294118,157.56470588235294,262,27,235
A397C1PRHBID0N,Kentucky Watchman,20120928,28,4.142857142857143,68.78571428571429,26,6,20
A397CFUAAECSG5,"K. Nakasato ""dolphin""",20100520,28,4.285714285714286,144.28571428571428,58,27,31
A397CWU6DM3O5G,ganka,20090916,35,4.228571428571429,121.85714285714286,43,25,18
A397GL7DSY3K6P,Colin MacLeod,20130812,23,4.391304347826087,96.0,4,1,3
A3992SE2YUH0B9,"Simon ""Mex""",20090810,28,4.142857142857143,89.5,22,7,15
A3998OSO98YJ35,Ken Webmaster About Facts Net,20080125,22,4.590909090909091,38.59090909090909,0,3,-3
A399GPFKUZJC0F,C. McKenzie,20080502,24,4.0,105.91666666666667,31,9,22
A39ANGL5T77E0B,David Higgins,20080326,37,4.243243243243243,135.64864864864865,52,10,42
A39APYUHMVNYCF,Pen Name,20130504,29,4.551724137931035,27.103448275862068,1,5,-4
A39AWSV06FEDW1,gta4 on laptop,20101114,21,4.761904761904762,109.42857142857143,6,21,-15
A39B5NJ5QOUQGU,Erol,20030622,21,4.142857142857143,162.04761904761904,80,13,67
A39BW25SNOBOS5,a reader,20090425,23,4.608695652173913,162.6086956521739,127,8,119
A39C974O5DW9FU,HIchris808,20090125,31,4.483870967741935,52.38709677419355,15,6,9
A39CDIJQNPLA5W,anton2g,20120516,23,3.608695652173913,193.82608695652175,16,13,3
A39D7ONPOORMUT,William E. Liberatore,20090406,39,4.615384615384615,243.76923076923077,826,40,786
A39DX6HRP48EZ9,Walter Wright,20090319,26,4.076923076923077,201.1153846153846,50,4,46
A39E456RQ65ADY,stumpedI,20120113,23,4.478260869565218,144.08695652173913,8,6,2
A39E4C7YVVQ02F,"Boomzilla ""Boomzilla""",20080426,24,4.5,74.66666666666667,25,9,16
A39E7IWNHY62JT,"LG ""*""",20090812,29,4.172413793103448,188.0,40,20,20
A39EIIHJC8W6CW,Keeffer,20120915,26,4.730769230769231,73.92307692307692,32,2,30
A39EN5XP8LDVX8,Mike M,20130401,21,3.5714285714285716,112.28571428571429,5,3,2
A39FALMRTZ0K5J,Goldie,20140707,27,4.777777777777778,16.14814814814815,1,0,1
A39G4M8L6I3CI3,zhezus,20110615,23,4.130434782608695,23.52173913043478,0,2,-2
A39G79LLPG83HZ,Raymond Perry,20090117,25,4.8,333.68,310,29,281
A39GJJT0H2BZH9,Mike,20131119,30,4.666666666666667,161.8,12,1,11
A39GR4IL73QPCB,"Lion Michael ""Dreamtoys""",20110224,25,3.52,53.56,4,10,-6
A39GTSUA8RSD8O,DigitalEagle,20070812,24,3.0416666666666665,567.6666666666666,153,22,131
A39H670PD32Z1X,"Adam Sorenson ""Adam""",20021104,34,3.5588235294117645,176.3235294117647,121,44,77
A39H8B6CTVS93P,Scott N.,20110719,26,3.8461538461538463,109.92307692307692,2,0,2
A39IQR42BQYFG1,"What'sthatinmycoffee? ""sss""",20121218,27,5.0,53.333333333333336,7,5,2
A39J7HE14SZTIY,1365Mike,20081212,27,4.555555555555555,66.5925925925926,26,3,23
A39K52QDP4C3ZS,Peter Brockie,20111129,49,4.591836734693878,170.87755102040816,246,21,225
A39KBWLS6TURMR,Julie Miller,20100129,25,3.2,54.72,43,36,7
A39L35PUI58CFY,"Bubbles-Desmo ""Danny Truong""",20071228,26,4.3076923076923075,133.6153846153846,33,8,25
A39LRLKACX89IP,Courtland J. Carpenter,20030707,41,4.146341463414634,480.0243902439024,319,63,256
A39LRXD7THXB4B,"M. Williams ""MBW""",20060924,24,5.0,66.375,27,3,24
A39M1VLKHWD3EO,"Hawkman ""Hawk""",20100111,25,3.8,79.0,25,11,14
A39N0BN4B2Q7F,"Amazoner ""reader, thinker, doer""",20090331,25,2.76,168.4,140,695,-555
A39NEMK0UIVUI4,"James D. Atchley ""Desktop Manager""",20090327,28,4.178571428571429,39.75,9,3,6
A39NGYK97FBZM3,"J. B Kraft ""lonestargazer""",20060416,36,3.8055555555555554,378.6111111111111,208,16,192
A39OM6SPWHS3FK,Neil Collins,20140127,30,4.566666666666666,90.63333333333334,10,2,8
A39P9MWS8L0FZH,Bruce Yarbor,20090113,22,4.954545454545454,51.95454545454545,12,2,10
A39PJ20IDNCH27,Fel Angel,20110113,28,4.535714285714286,43.17857142857143,5,18,-13
A39Q5JH09VUMR5,"ksuwildkat ""ksuwildkat""",20020102,24,4.625,336.5,512,31,481
A39QJHWQZCQQRT,"J. Sayson ""j1tanamera""",20080722,31,4.354838709677419,86.09677419354838,66,23,43
A39QYCBKS4D6E7,Tim Case,20140118,40,4.875,66.775,4,5,-1
A39RYTM5FN8OY2,SL,20071010,40,3.775,99.6,477,70,407
A39T0L7SX0BQ8R,"Bryan ""Never late for supper""",20060424,36,3.8055555555555554,96.13888888888889,102,17,85
A39TF3CW0JEK3H,"Santosh Geddamuri Sr. ""Happysan""",20080107,39,4.564102564102564,105.61538461538461,115,15,100
A39U6GDOK9HEYP,John,20060525,33,4.0,106.93939393939394,103,54,49
A39U8I1YS5ZCP8,Christopher Cobble,20120926,23,4.608695652173913,80.95652173913044,8,0,8
A39UA5WK18IY01,manfrengensen,20080313,21,4.476190476190476,90.66666666666667,72,9,63
A39UUAA10U71AM,John Q,20130511,24,5.0,34.583333333333336,4,5,-1
A39WALMR3G46FU,ray,20121213,27,4.444444444444445,69.55555555555556,10,14,-4
A39WT88YZXIJTB,Kmill,20140206,31,4.161290322580645,35.58064516129032,11,3,8
A39WU7E2QYISCH,PMC,20110524,35,4.857142857142857,32.2,11,2,9
A39XCO0TG2J6R3,nick,20120124,21,3.1904761904761907,386.76190476190476,104,63,41
A39XSKZ81YPLNX,Grizzz,20091114,24,4.541666666666667,92.79166666666667,54,6,48
A39YXYQWARRFEV,Horace'sWorld,20081203,26,4.346153846153846,161.76923076923077,64,12,52
A39Z4OU2C7ENWH,Dave C,20091204,26,3.923076923076923,131.0,86,15,71
A3A0DX3Z1SYNR5,"FBledsoe ""Silver Smith""",20100707,23,3.6956521739130435,211.3913043478261,105,22,83
A3A0KPQ1458501,"MaxVideo ""maxvideo""",20030919,22,2.9545454545454546,339.72727272727275,648,77,571
A3A0RFP8AL9GXO,"Edward Murdoch ""Renaissance Man""",20090115,30,4.166666666666667,85.03333333333333,100,23,77
A3A15L96IYUO6V,Michael Smith,20000519,64,4.203125,290.828125,196,60,136
A3A1OA237FOZFK,#1 Amazon Fan,20070721,42,4.166666666666667,268.9047619047619,149,25,124
A3A2XQ34N6VXZ1,Mike Callery,20120801,35,4.114285714285714,53.542857142857144,2,17,-15
A3A3F5N7NZCVMT,tightsandtea,20061125,33,3.878787878787879,258.5151515151515,158,13,145
A3A3MX94U0QVW3,Rick,20100923,27,4.592592592592593,59.407407407407405,16,3,13
A3A4ZAIBQWKOZS,Stephen M. Lerch,20060828,216,4.657407407407407,463.26851851851853,2021,246,1775
A3A57GX8FJ4QNQ,"MrBios ""PaulC""",20060112,37,3.7567567567567566,261.4864864864865,398,29,369
A3A5ULY7Q442LX,K. Kellogg,20101027,26,4.153846153846154,275.5,27,13,14
A3A5XNAM3ZW7Z6,"John ""Kula Kine""",20100605,26,3.9615384615384617,165.73076923076923,33,23,10
A3A6H8SFKSO9ZC,"Daniel B. Glover ""MadCow""",20090402,25,3.92,125.72,66,9,57
A3A6WEJOO0RJIQ,"Suzie Q ""Whytehouse""",20090819,21,4.857142857142857,24.333333333333332,0,3,-3
A3A8BQ0NVIUCRM,Roger,20061031,44,4.2727272727272725,593.8863636363636,298,131,167
A3A90CELVLOUP6,"Nanciejeanne ""Enjay""",20030428,39,4.717948717948718,263.4871794871795,91,22,69
A3A93JDI1CFDI1,Alf,20140613,34,4.117647058823529,53.970588235294116,8,5,3
A3ADKW0YREZD52,,20110111,32,4.28125,108.6875,27,4,23
A3AEDUJ7MXBNEX,"Sui Lin Chee ""Sui Lin Chee""",20050308,23,3.782608695652174,337.7391304347826,245,41,204
A3AEM8EMBWPQFX,techie,20110820,23,4.173913043478261,94.8695652173913,2,0,2
A3AG5QAT8L0I3R,J. Maxon,20071216,51,4.078431372549019,442.3921568627451,484,44,440
A3AGQAXTX6VRJ3,"D M Pax ""Kahuna""",20080105,40,4.35,349.475,115,40,75
A3AGSFLNNIFKNJ,"Benjamin M. Bethel ""Owner/General Manager - T...",20051126,43,4.116279069767442,199.4418604651163,313,171,142
A3AGTCQ1OYJGIP,"BK BAZHE ""writer, poet, & artist.""",20080814,42,4.619047619047619,36.595238095238095,24,59,-35
A3AGWRMHKLFLWR,"H. Sapiens ""Amanda""",20080418,33,3.878787878787879,283.6969696969697,114,27,87
A3AHDR4F2J7YXX,"Caliaha ""Caliaha""",20081205,36,4.361111111111111,289.30555555555554,73,22,51
A3AI3NGZWBVMF2,Chris Spurgeon,20101217,28,4.821428571428571,95.53571428571429,22,0,22
A3AI7RIH70YXAI,Joseph Nocella,20100214,21,4.190476190476191,81.42857142857143,44,32,12
A3AJ7JPRPK0IGR,T. Parks,20110612,25,4.28,209.72,22,2,20
A3AJPG967QETOU,Margarita Ramirez,20080621,24,4.458333333333333,39.083333333333336,12,1,11
A3AK8XN3938ZHE,Patrick Landy,20111028,24,4.708333333333333,71.5,8,3,5
A3ALH2Q3HWGZNG,Dr99,20110318,30,4.3,52.93333333333333,11,5,6
A3ALIYSLFFNT8P,Jim Jamesson,20100227,34,4.264705882352941,71.97058823529412,15,6,9
A3ALYCCIAB7FV5,Shawn Ramirez,20130110,22,4.681818181818182,40.63636363636363,9,4,5
A3ANGWW62RQBHS,Richile,20100216,27,3.2222222222222223,83.88888888888889,24,82,-58
A3ANRNLZ2LVM8J,Jackie Hebert,20110205,39,4.128205128205129,161.35897435897436,6,4,2
A3ANW3GC7TADUF,barbara cooper,20130607,27,4.777777777777778,78.88888888888889,29,4,25
A3AOB0VF6H0IF4,Daits,20100925,33,3.909090909090909,143.4848484848485,30,14,16
A3AOCR7H4IQY4D,Gilbert Chan,20130116,24,3.875,88.75,12,1,11
A3AOPVQ7EZHTWA,"frankp93 ""frankp93""",20100514,22,4.2272727272727275,335.27272727272725,44,16,28
A3AOUCF6XH0XE4,JSutherland125,20120620,25,4.24,105.36,13,7,6
A3AP2MA7YIWA4F,"RickG ""Rick""",20091017,39,4.435897435897436,40.12820512820513,9,5,4
A3AP96RMBZWYBY,SameOldStory,20110430,32,4.6875,272.90625,35,4,31
A3AQO91DYWF8R0,Seth Daniels,20111222,34,4.676470588235294,121.05882352941177,26,7,19
A3AQSJRSOU03C5,LMN,20070601,22,4.636363636363637,43.90909090909091,50,27,23
A3AQVLV3RP7R2L,"tipstir ""My Professional Review""",20081013,26,4.0,389.53846153846155,148,66,82
A3AR4LD2A9WNX3,"Marshall Masters ""Your Own World Books""",20040611,40,4.275,87.125,119,31,88
A3ASWULTGOS3CF,Richard N. Barg,20070524,22,3.772727272727273,165.1818181818182,152,34,118
A3AU9P1UAKRE2X,"M. Stern ""Shutterman""",20120606,24,2.4583333333333335,138.0,19,19,0
A3AUA3XA2X02VQ,Amazon Customer,20110716,38,4.894736842105263,61.28947368421053,26,7,19
A3AUL23GMCOP2A,Andrew S. Rogers,20060101,30,3.933333333333333,229.26666666666668,32,24,8
A3AUR4JFEJNXDY,anthonyg,20081119,22,3.5,290.8181818181818,35,13,22
A3AVD6J42P43VH,"J. Silberman ""jsmail951""",20040719,40,4.9,101.9,71,7,64
A3AVJCB1ZD6ZY5,R. Kyle,20071204,52,4.115384615384615,285.3076923076923,184,51,133
A3AVSGDYKZMCOX,chriek,20090529,30,4.066666666666666,123.3,127,79,48
A3AVXHU880YWQY,"Kevin C. Fairdosi ""Kevin""",20140106,21,4.0,120.76190476190476,10,2,8
A3AWB202EB076E,Cuffy,20120719,21,5.0,108.38095238095238,10,2,8
A3AWRXCTWQAHRK,DANAL,20090109,34,3.735294117647059,36.35294117647059,22,15,7
A3AWV00ZU7MSK1,"Succinct  Reviews ""Pirulina""",20090212,30,4.333333333333333,156.5,114,28,86
A3AXGDUO49R147,James C. Westland,20110401,25,4.64,157.32,146,10,136
A3AYF9CD4PXDJR,"E. Orchard ""I love lamp""",20030601,29,3.9310344827586206,321.0344827586207,289,26,263
A3AYSYSLHU26U9,Amazon Deity,20080527,231,4.324675324675325,277.6320346320346,2144,198,1946
A3AZ5LDRPW19VM,LVMoxie,20110225,23,4.217391304347826,90.17391304347827,24,9,15
A3AZI828WJN1CD,"Becky in NOLA ""Becky""",20110622,47,4.340425531914893,164.5744680851064,22,0,22
A3AZUX1EW379D0,M. Nolan,20100116,42,4.190476190476191,40.476190476190474,6,7,-1
A3B0HUYVGFCV46,KabutoCub,20110916,27,4.555555555555555,76.48148148148148,22,3,19
A3B1360JOYS0GJ,AccioFirebolt,20101201,26,3.3461538461538463,262.2692307692308,159,54,105
A3B20R4ZAH0Y2Y,"Dave Millman ""davemill""",20040912,69,4.36231884057971,257.7536231884058,514,78,436
A3B3DPD8GHIN0B,B. Austin,20071127,25,4.12,196.04,293,49,244
A3B3HBKN6PR2N7,Electronicbuff,20110825,22,4.636363636363637,307.0,385,14,371
A3B4N0MZFYJWN8,Kiran Maharaj,20091024,21,4.476190476190476,68.85714285714286,13,0,13
A3B4O5GR3AKS8V,Rowdy Tenor,20120523,21,4.428571428571429,87.52380952380952,5,3,2
A3B5E90IEV2PW5,"Gardening Girl ""Bonnie""",20081010,22,4.2727272727272725,80.45454545454545,35,3,32
A3B6TOMVGHAJTP,"FreddyMac ""FreddyMac""",20071228,25,4.6,54.56,12,2,10
A3B7NBM01191CF,rawtimes,20110430,41,4.463414634146342,83.21951219512195,11,9,2
A3B9EOUXZ494CL,C. Clark,20111226,33,4.484848484848484,163.87878787878788,178,31,147
A3BA9CAL1VYLKL,,20101026,24,4.666666666666667,38.958333333333336,32,3,29
A3BACUOZV1M0WM,L. G. CHARLOT,20060610,76,4.5,565.4342105263158,675,40,635
A3BAOIC7JMCY6R,"RPK ""Professional Shark Tamer""",20060223,37,4.351351351351352,226.97297297297297,65,25,40
A3BAXJF5NCZEDZ,"Bjudo ""BB""",20070512,34,3.735294117647059,128.64705882352942,53,11,42
A3BBCDCHC5U1VK,CAWireless,20030925,28,3.9285714285714284,252.53571428571428,355,20,335
A3BE4FT3VKBJ52,sc10,20131113,24,4.5,49.458333333333336,7,5,2
A3BFDEBT5IV4UN,"Dianne E. Socci-Tetro ""Never Judge a Book by ...",20090703,43,3.7674418604651163,256.83720930232556,557,29,528
A3BGYK1ELD652P,James Cook,20100824,28,3.7142857142857144,92.96428571428571,13,17,-4
A3BHMLC4E0GOLC,Dennis Wilcox,20070519,23,4.3478260869565215,51.30434782608695,32,9,23
A3BHSG5R5NGKWK,T. Sweny,20110914,28,4.535714285714286,127.07142857142857,16,6,10
A3BI8BKIHESDNQ,L. J. Cunningham,20121228,39,4.666666666666667,51.333333333333336,7,13,-6
A3BIR2418I0M3N,"BigJohn ""Big John""",20120801,29,4.655172413793103,29.551724137931036,2,2,0
A3BK450R9P94FX,Trevor,20120806,27,4.518518518518518,46.888888888888886,29,7,22
A3BKNXX8QFIXIV,"J. Finkel ""Jack of Trades""",20070919,84,4.428571428571429,301.7738095238095,419,66,353
A3BL87QHIEQ1NE,J. Weber,20060221,23,3.652173913043478,183.52173913043478,782,46,736
A3BLXBZ1I82B5K,cac22,20130111,22,3.909090909090909,168.4090909090909,43,19,24
A3BMC6FKX00U4H,Mastedon,20110820,25,4.88,157.64,19,3,16
A3BMK3DZDH0N6Q,TechMSS,20040503,32,3.375,255.6875,435,71,364
A3BMUBUC1N77U8,ahoffoss,20110115,39,4.589743589743589,90.2051282051282,42,2,40
A3BNMHRW2R35LK,"S. Peterson ""theswedishchef""",20060630,73,4.205479452054795,115.72602739726027,189,58,131
A3BOVI9G971LA7,Benjie Urbina,20070518,27,4.037037037037037,96.92592592592592,158,59,99
A3BPW1LXX5ALUV,Kevin S,20130123,28,4.392857142857143,66.39285714285714,14,9,5
A3BR71UJ21V9A4,"Marty d'Fried ""gadget geek""",20050105,36,4.361111111111111,152.19444444444446,50,10,40
A3BRMNYJHD5AT3,"Ellen C. Maze Sallas ""The Author's Mentor""",20120425,21,4.428571428571429,84.9047619047619,55,12,43
A3BSP0ZXLGJZK9,Joey,20120609,24,4.708333333333333,46.166666666666664,30,3,27
A3BTBIV6N9BZFR,Sam Moss,20110414,45,4.511111111111111,138.77777777777777,16,9,7
A3BTDFZI3FT6I7,"M. & S. N. ""Bargain Shopper""",20110117,21,4.714285714285714,67.95238095238095,6,4,2
A3BUNHF07TGZS3,Nunya,20050831,40,4.7,39.075,15,3,12
A3BVN2QBNPBHCR,Lincoln,20060320,103,4.631067961165049,280.50485436893206,3125,244,2881
A3BVSAZREDP9RH,WolfPup,20020503,34,3.7058823529411766,529.0294117647059,1575,207,1368
A3BXFJTHB5MVPG,Lee R. Chumbley,20120928,21,4.809523809523809,46.04761904761905,16,3,13
A3BXJI0FZX0TET,David Mark Engerson,20130213,22,4.363636363636363,78.0909090909091,5,31,-26
A3BXSR4ZFZS72V,RC,20131223,27,4.481481481481482,52.77777777777778,4,3,1
A3BY5KCNQZXV5U,Matenai,20020321,44,4.204545454545454,147.63636363636363,181,32,149
A3BZTID005K1WT,Printer User,20060417,22,2.3181818181818183,174.36363636363637,137,21,116
A3C08BZRVV500V,vrystaat,20051201,23,2.4347826086956523,103.52173913043478,65,152,-87
A3C0HQ4CIVQMND,C. Carlson,20060922,23,4.521739130434782,156.08695652173913,38,3,35
A3C0TQBK5GWKX9,"Dave R. ""Mr. Critical""",20070705,21,4.238095238095238,170.42857142857142,99,15,84
A3C14XYDRWUWQZ,"Big perm ""WW""",20101226,28,4.642857142857143,35.92857142857143,18,0,18
A3C156QETFSYHH,"Sharon L. Jones ""sljones""",20110930,30,3.8333333333333335,117.53333333333333,60,27,33
A3C1QYGEET3BVY,PC Mountain,20080909,22,4.136363636363637,153.5909090909091,52,14,38
A3C3TEMF8OMCRC,Tony,20120103,21,4.809523809523809,48.23809523809524,2,2,0
A3C4LUVT109T55,John J Novak,20130115,22,4.545454545454546,42.36363636363637,2,1,1
A3C50S1M9MI2UI,Moe Priell,20080807,35,4.914285714285715,58.34285714285714,42,2,40
A3C5EKV4LKGOU,Reizero00,20121111,25,4.68,94.24,16,6,10
A3C5K8B0R0F3WR,S. Dicken,20070323,27,4.518518518518518,266.962962962963,191,5,186
A3C5WTJO996F0X,"E. Nathan ""Zen Knitter""",20060309,21,4.476190476190476,114.95238095238095,29,1,28
A3C5ZTOPYEA60S,Hunter,20130619,25,4.48,114.28,176,166,10
A3C6CZC2JP67VK,"Jenny J.J.I. ""A New Yorker""",20081217,39,3.6923076923076925,139.05128205128204,52,15,37
A3C8H43HI6ODOA,"J. Smith ""scientist""",20071218,28,4.607142857142857,95.71428571428571,42,5,37
A3C8NRC6HQZATS,"WALLEYE22IN ""WALLEYE22IN""",20090106,21,4.523809523809524,29.666666666666668,6,3,3
A3C96IWQ26Q46I,"ManicBobo ""Manic""",20130225,26,4.5,108.6923076923077,12,4,8
A3C9PDZ3LAI85E,GQ,20070215,44,4.409090909090909,125.45454545454545,297,56,241
A3C9Q3KTNNLJJ,SouthernAmazoner,20070509,33,3.8484848484848486,115.3030303030303,45,27,18
A3CA3RWZYJDWXE,BJ Fraser,20100717,22,2.8636363636363638,161.77272727272728,91,33,58
A3CA65NQPR5BP4,ijst2000,20120216,24,4.875,41.708333333333336,1,1,0
A3CBCVHIK3G76X,Debra Brinkman,20110615,27,4.555555555555555,174.14814814814815,48,9,39
A3CBKKEUYGAGPR,"Michael S. Despot ""mdespot""",20070310,24,3.9166666666666665,102.70833333333333,68,7,61
A3CC7AD7WVC578,Cushaway,20130412,22,4.863636363636363,59.09090909090909,6,4,2
A3CCU6W5UEUE6W,Dane,20100910,21,4.142857142857143,110.9047619047619,37,2,35
A3CDEI38WFOQ2Z,Eric Sternot,20120304,25,3.84,79.44,5,5,0
A3CDF86VUZ1PZG,R. Surber,20100215,25,3.56,284.64,42,8,34
A3CEUT263RNUDO,Vivek Gupta,20091123,66,4.212121212121212,154.6818181818182,114,28,86
A3CFT1FLNSZ9VG,G. Kroll,20100925,42,4.642857142857143,75.28571428571429,40,15,25
A3CFU12GS5CZCN,"Trent Gillespie ""Trent Gillespie""",20100108,42,4.214285714285714,49.92857142857143,13,0,13
A3CG6YLYZJXQG4,"Tracy Rowan ""dargelos""",20010103,36,4.0,242.52777777777777,110,25,85
A3CG788F217SCT,MacTrades LLC,20130430,23,3.4782608695652173,99.78260869565217,12,39,-27
A3CG93783LP0FO,"Yarii ""fifty shades of blonde""",20081011,181,4.248618784530387,303.0220994475138,3635,224,3411
A3CHFU80MSI4X0,Christian Rowe,20111208,43,4.767441860465116,49.51162790697674,20,8,12
A3CHIF3EHXCLA5,R. Smith,20081211,25,3.16,209.2,234,36,198
A3CHMHGSJSQ02J,Anon. A. Non,20081212,30,4.266666666666667,124.33333333333333,97,14,83
A3CIET1UO3G51E,Mark,20110327,55,4.2,59.27272727272727,36,15,21
A3CJ3DKELFXX59,TheR3alDanny,20110802,28,4.607142857142857,134.39285714285714,34,5,29
A3CJ7MHAS9IMAM,Dom Miliano,20020824,53,4.471698113207547,264.188679245283,434,37,397
A3CJC7K4QZBYW5,Josef H. Buerger III,20070125,25,4.04,74.76,37,31,6
A3CJOB7CHOSZUG,Robert K. Mertz,20080422,39,4.435897435897436,138.64102564102564,138,8,130
A3CK1XNRHTN402,"Jeri J. Steele ""Jeri J Steele, Pioneer Inform...",20001207,21,4.476190476190476,105.38095238095238,230,13,217
A3CKI6VEH0HBMJ,S. Faulk,20080210,47,4.680851063829787,273.4468085106383,411,40,371
A3CL82UITQJLWS,John Doe,20040311,23,4.478260869565218,212.52173913043478,289,97,192
A3CLWR1UUZT6TG,"FD Firefighter 121 ""Remember the 343""",20090904,48,4.458333333333333,87.83333333333333,72,93,-21
A3CLWZGMC7M9Z1,"Hippie2MARS ""Hippie2MARS""",20080603,27,4.074074074074074,103.77777777777777,62,43,19
A3CMO216CWOF5N,jr_Tech,20060308,43,4.069767441860465,165.1860465116279,736,34,702
A3CNV3BDG5E5DC,Bruce Bevitz,20071223,29,4.206896551724138,81.93103448275862,29,11,18
A3COVLWESJ2QIJ,Archman,20111103,28,4.821428571428571,115.71428571428571,25,0,25
A3COXRUY6JPML5,medhchang,20070810,44,3.8636363636363638,141.54545454545453,99,15,84
A3CP1WGNTOSKDA,"Tim Naff ""Tim""",20060928,38,4.552631578947368,896.5263157894736,906,38,868
A3CP2IPFYP6B2I,Jose,20101210,28,4.964285714285714,23.285714285714285,0,0,0
A3CP3J7OEGQMD5,"TMCLEN ""tmclen""",20110729,42,4.166666666666667,36.976190476190474,21,8,13
A3CQHZQ352LKAL,"Eric G. Johnfelt ""Eclectic Collector""",20120603,23,4.521739130434782,104.47826086956522,41,9,32
A3CRJRGALQTSFL,Miguel Cruz,20130226,21,4.619047619047619,90.14285714285714,3,1,2
A3CRO2C5FNIXDC,James DeMichael,20130514,29,4.310344827586207,41.724137931034484,8,3,5
A3CSYCBJDE0UW,Mr.Buyer,20120605,25,4.24,27.2,5,7,-2
A3CSZGXOQMPY3P,"Jonathan Morales ""deitiphobia""",20080409,26,4.461538461538462,230.15384615384616,72,14,58
A3CTI2ARGG2T7X,"B. Williams ""&#34;We must be the change we wi...",20071013,28,3.892857142857143,203.96428571428572,17,8,9
A3CU0QL4C4LAA8,"James Korsmo ""developing theology""",20110616,21,4.238095238095238,283.1904761904762,119,25,94
A3CU7BX8LGW86S,Craig Niemeyer,20130604,29,4.9655172413793105,46.6551724137931,4,1,3
A3CU8A5WNQBKYF,Carl D. Mcnair,20130820,21,4.761904761904762,103.47619047619048,7,1,6
A3CVC8TCHFFDK8,retired teacher,20081226,32,4.53125,95.5625,34,9,25
A3CVD09ZSLUHD5,Sherry,20110405,28,4.75,206.07142857142858,126,9,117
A3CVMCBTBQ7R79,spl42,20130513,27,4.185185185185185,74.77777777777777,7,2,5
A3CW0ZLUO5X2B1,"35-year Technology Consumer ""8-tracks to 802.11""",20020504,198,4.217171717171717,245.81313131313132,1011,76,935
A3CW5EHY41TCH1,Jason,20100102,22,4.181818181818182,87.36363636363636,15,6,9
A3CWEK9HY2VPDL,J. Green,20071210,31,4.387096774193548,251.03225806451613,74,26,48
A3CWRKJTB2SEQS,Careful Reviewer,20040810,21,2.2857142857142856,145.85714285714286,665,91,574
A3CWVTH1M1ZP85,"daemon ""DMen""",20090427,33,2.606060606060606,134.27272727272728,57,77,-20
A3CY3CFCS553FZ,Darryl,20110105,22,4.409090909090909,207.3181818181818,26,4,22
A3CZ2ODWJ0HTHV,"T. Clifton ""Techie Tony""",20100503,21,4.190476190476191,563.047619047619,24,4,20
A3CZ8FSR0VWSR5,Amazon Customer,20091020,21,4.809523809523809,51.857142857142854,6,0,6
A3D01HLSUFEZQY,"H. Hatje ""Photographer""",20090913,43,4.465116279069767,251.41860465116278,124,22,102
A3D035KQL9KQFK,Shawn Stiner,20121207,29,5.0,47.0,2,0,2
A3D0HMC6RQT0N0,J. Flood,20080409,40,4.425,107.375,103,25,78
A3D0MT6MH2RTUU,"Amazon Customer ""Computer DOC""",20070715,26,4.653846153846154,38.11538461538461,76,3,73
A3D0Q4W0PH6DBY,James K,20110330,28,3.7142857142857144,298.60714285714283,145,15,130
A3D0UM4ZD2CMAW,Mauro serrano,20120801,93,4.978494623655914,159.0752688172043,71,17,54
A3D0VOQYPJGGL6,"Mike S. ""mikescr""",20110725,22,4.181818181818182,93.13636363636364,45,5,40
A3D1393GR3SH2M,"John McQuay ""Photographer, Videographer, Shooter""",20111008,27,4.333333333333333,122.81481481481481,23,1,22
A3D1TZH619NKHN,In the AmaZone...,20080117,60,4.333333333333333,227.73333333333332,84,13,71
A3D2CX7DNQW6TR,J. Patterson,20090706,22,4.681818181818182,149.27272727272728,22,0,22
A3D2LLNMKDAJOD,Samara McDonald,20110311,23,4.3478260869565215,90.95652173913044,29,4,25
A3D2PJC9CF87WP,IA,20020808,29,2.3793103448275863,84.10344827586206,259,279,-20
A3D2VIUT2HWP0Z,"Santeria ""Son of Tazz""",20021022,67,4.447761194029851,280.1194029850746,131,85,46
A3D36ARA7L7MII,L. S. Ruiz,20130130,27,3.925925925925926,30.0,6,4,2
A3D3EFG4XMO1XG,Jeffrey B.,20121212,23,4.608695652173913,59.391304347826086,9,0,9
A3D42ZX96FA6EW,Risenheart Consulting,20110324,23,3.217391304347826,47.0,3,3,0
A3D44VGIO6RX6R,Marilyn,20061113,23,4.434782608695652,86.17391304347827,24,31,-7
A3D4CR4PPINT7P,John Hamm,20110706,41,4.829268292682927,71.8780487804878,12,5,7
A3D5B2CBFNJB0K,ut158,20060311,53,4.150943396226415,444.3018867924528,268,47,221
A3D6OHGHXN95AS,William Jackson,20010125,22,4.818181818181818,84.77272727272727,56,9,47
A3D6OI36USYOU1,Ghenghis,20050305,57,4.12280701754386,182.8421052631579,740,47,693
A3D7BGK0P5QY0X,Neil E. Isenberg,20100816,46,4.1521739130434785,947.4782608695652,632,37,595
A3D822N1K2IAQD,Kenneth Stuart,20021217,65,4.107692307692307,324.4923076923077,352,62,290
A3D9JA10YPDHJ1,mattmkett,20111007,23,4.521739130434782,155.82608695652175,5,8,-3
A3DBW5ZEQIWVEY,TomT,20061205,22,3.8181818181818183,183.27272727272728,153,25,128
A3DCX8SNP4K3ON,Steve Williams,20100927,39,4.82051282051282,149.35897435897436,29,5,24
A3DDDXG42DOA0U,MAGstar,20130121,27,3.888888888888889,87.70370370370371,13,3,10
A3DDPLYMNIVED0,Mo,20110521,24,4.375,40.125,5,11,-6
A3DECRYWZZM0SO,KendoPt4,20130227,36,4.416666666666667,83.91666666666667,9,1,8
A3DGJMO6VPG6FJ,Wendy & Jeff S,20100409,82,4.036585365853658,307.2073170731707,967,60,907
A3DH53FPYSP9E,Media Man,20110614,38,3.9473684210526314,362.92105263157896,268,41,227
A3DHJ0UCEKRU93,M_Six,20030110,21,4.904761904761905,84.42857142857143,43,5,38
A3DI391K4GAI7Q,"A. Taylor ""Music Addict & Tech Junkie""",20020302,35,4.542857142857143,156.68571428571428,119,16,103
A3DIEBU257KDW9,Term8r,20060503,31,4.516129032258065,212.67741935483872,217,32,185
A3DIS5O83SQJWW,"Amazon Customer ""geekacres""",20050831,38,3.8684210526315788,199.3684210526316,41,9,32
A3DJRNEMOM1XF,"Amazon Customer ""Kevin""",20070717,32,3.78125,128.5,1099,186,913
A3DKP8M0GSP8UK,Justice for Trayvon,20080911,26,3.8846153846153846,154.30769230769232,321,23,298
A3DL29NLZ7SXXG,mike,20120211,23,5.0,54.73913043478261,95,32,63
A3DLK8Q3Z5FOY0,"John Salazar ""I do NOT review books, stop ask...",20080503,22,2.9545454545454546,576.0909090909091,196,51,145
A3DLSQMJRNDQKA,ZechariahB,20130323,24,4.416666666666667,67.58333333333333,15,13,2
A3DN0FLRNIRV6C,M. Bose,20130103,21,4.619047619047619,41.95238095238095,4,1,3
A3DNITI540RV1C,"Marc B. Blake ""Oh My Word""",20130718,22,4.363636363636363,60.31818181818182,8,21,-13
A3DO8CTP2VKXWH,Christopher J. Thibeault,20120905,29,4.310344827586207,115.37931034482759,13,8,5
A3DOPYDOS49I3T,Confucious,20070819,98,4.887755102040816,143.5204081632653,90,32,58
A3DPDUFRTXKAMI,"Thomas Rauk ""Red Lobster""",20110711,21,4.761904761904762,174.52380952380952,110,6,104
A3DQKTQVK7ZCCD,drp103,20061028,31,4.709677419354839,313.80645161290323,106,5,101
A3DQWFWINN3V5A,David A. Lessnau,20030720,42,4.190476190476191,397.42857142857144,706,71,635
A3DRT9IRH63ZHB,Michael Morgan,20051128,35,3.8285714285714287,244.97142857142856,2114,106,2008
A3DSXJDE6PAXHZ,"Robert K. Harvey ""BobH""",20080224,29,3.896551724137931,104.62068965517241,45,15,30
A3DTSC80W9RNB9,"Irv Haas ""dvdirv""",20070412,35,4.285714285714286,200.57142857142858,1246,109,1137
A3DTVMQGMNLX26,SroseO,20121026,23,4.3478260869565215,77.1304347826087,5,1,4
A3DTZG5S4S7AGI,CFI Esq.,20090423,23,3.3043478260869565,79.30434782608695,70,28,42
A3DU1OH7U1DJ71,Camera Kid,20130417,27,4.777777777777778,51.370370370370374,5,4,1
A3DUWATQEKWLTY,njrapid,20130803,44,3.1818181818181817,55.11363636363637,10,13,-3
A3DWI9EOW73N23,Gerald,20100123,42,3.9285714285714284,97.42857142857143,58,12,46
A3DWJPNIMV9PMG,G. Mark Stewart,20121007,22,4.7272727272727275,40.63636363636363,10,2,8
A3DWO5RJDA430F,"L. Da Vinci ""Renaissance Man""",20060625,115,4.052173913043478,88.40869565217392,164,70,94
A3DX5F0CW34Y9,"Long Live the C64! ""LongLiveC64""",20020115,30,4.8,310.6333333333333,817,45,772
A3DXRN8UPJ6W2N,"Jason Greenwald ""BA in Television""",20120608,24,4.416666666666667,56.625,6,4,2
A3DXU0KN3YEL2L,Original Vidiot,20111213,27,3.7037037037037037,311.2962962962963,36,12,24
A3DXWLHCHTB5OB,"Ed911 ""Alienplayer""",20091026,25,4.48,176.2,520,40,480
A3DZ7DLD5PY3WN,"SC Engineer ""SC Engineer""",20080101,25,3.56,62.16,80,19,61
A3DZFEICHK5LF2,Just Trying to Help,20090527,43,3.627906976744186,449.5348837209302,1731,95,1636
A3DZI1FQ6R9DI4,"Roger J. Exp ""Crew News""",20090429,31,4.967741935483871,87.83870967741936,35,3,32
A3E049PVKG7NDK,Kristofer Brozio,20071226,38,4.473684210526316,234.92105263157896,258,15,243
A3E0UUTSN81BUQ,Harry,20101009,35,4.171428571428572,159.4857142857143,72,14,58
A3E11WHSG52T0M,KimberlyinMN,20020204,33,4.878787878787879,169.5151515151515,84,16,68
A3E3EQ39FZTZEK,"sh ""sh""",20020716,50,3.36,244.04,261,62,199
A3E3L48LMUB0RV,JamesW,20111130,31,4.451612903225806,111.25806451612904,55,15,40
A3E3TUHZHUER7Z,"Amazon Customer ""k3for""",20031226,24,4.041666666666667,102.29166666666667,103,15,88
A3E3YJJ0KLYECK,Manny Lopez,20101006,36,4.361111111111111,113.33333333333333,701,35,666
A3E4EN8NV92TUE,T. Hensgens,20020331,22,4.181818181818182,79.04545454545455,23,36,-13
A3E68EBGXTWDNP,"E. K. Arnold ""amazon hunter""",20070109,56,4.339285714285714,330.9107142857143,978,90,888
A3E6HFD7U91DY,Daniel Burstiner,20070124,23,3.739130434782609,83.95652173913044,21,7,14
A3E6JBXN9KFHRX,"David A. Jacob ""Dave the Boss""",20070721,26,4.269230769230769,80.23076923076923,19,11,8
A3E6ZJMPO9SQWO,T. Rodeback,20080112,22,4.454545454545454,230.95454545454547,27,4,23
A3E78E4OXYE6ZB,"H. Beck ""BeckImpressions""",20100625,23,4.521739130434782,144.2608695652174,98,9,89
A3E9857YP2TYEN,BL INC,20080819,25,3.76,137.96,39,6,33
A3E9O1VNJ3U324,"Ruso Minnifield ""PrinceHappy2""",20111207,49,4.63265306122449,44.755102040816325,10,4,6
A3E9WG5BEAFF3T,"Jill Hart ""cwahmjill""",20070719,22,4.681818181818182,85.45454545454545,72,15,57
A3EAA602DJCZQ4,"Brendan Bhagan ""Brendan Bhagan""",20080531,31,4.258064516129032,282.06451612903226,162,23,139
A3EANUH7WV1AGU,Movielighter,20111217,37,4.8108108108108105,115.5945945945946,79,12,67
A3EAP2VG0BVYWX,nekojita,20111122,32,4.21875,215.03125,87,10,77
A3EAS9X3FYT7O1,MNDoc,20070918,25,4.32,108.4,40,3,37
A3EDN64C3A2FQY,"JW ""Rock Chalk""",20040808,25,3.92,74.96,72,14,58
A3EDYCF19JDSTU,Amazon Customer,20120706,29,4.068965517241379,81.89655172413794,110,29,81
A3EEBE82C3HYRD,David,20031226,33,3.9696969696969697,274.0,326,39,287
A3EFC4KBYSZYQ8,,20130211,31,4.548387096774194,229.2258064516129,17,3,14
A3EFSLEMHNPP6A,Senor Zoidbergo,20040329,82,4.2926829268292686,296.5731707317073,1544,119,1425
A3EFZZY5DUHLVS,"S. Rudge ""Always Even Steven""",20080129,26,4.576923076923077,335.38461538461536,357,9,348
A3EGYYIIFP568L,WinCrazy,20090805,24,4.291666666666667,147.41666666666666,63,39,24
A3EHEIN314XOZW,OhhWell,20120201,26,4.461538461538462,219.96153846153845,20,2,18
A3EHJ5519LG7TR,"Irene ""Live in his way""",20090812,38,3.9473684210526314,95.10526315789474,36,13,23
A3EI12AOWO9O66,J. Li,20041011,29,3.9655172413793105,178.75862068965517,194,55,139
A3EJEZOOSCFBFJ,John Morley,20121203,21,3.380952380952381,48.333333333333336,11,12,-1
A3EJZJQCMRRFT2,Brian J. Mcmahon,20120516,33,4.424242424242424,132.21212121212122,27,4,23
A3EK2KTYHJCPB9,Brian R.,20080902,69,4.2898550724637685,459.3333333333333,558,68,490
A3EKZQK46ULJ55,"Tarik E. Sivonen ""siv82""",20070602,21,4.761904761904762,64.52380952380952,5,2,3
A3EM243NDJ4DF3,"T Rose ""T Rose""",20090422,59,4.508474576271187,138.864406779661,148,15,133
A3EM7CXW4U9HTX,"Amazon Customer ""Cycle Newbie""",20090527,22,3.4545454545454546,100.9090909090909,68,8,60
A3ENQZ1LI2R914,chadginoza,20121127,23,4.478260869565218,28.130434782608695,1,1,0
A3ENS9LO4BYY1M,"James McFrogger ""-JMc""",20100307,21,3.9523809523809526,142.61904761904762,47,1,46
A3ENX1Y48DJQVK,Elphy 2,20070908,33,4.151515151515151,114.66666666666667,95,8,87
A3EOF1IQ3I1DDG,Martin Beckman,20110407,22,4.409090909090909,53.72727272727273,14,3,11
A3EOVXI1VZIHUQ,"Z. Freeman ""Zach""",20100428,25,4.32,191.2,164,15,149
A3EP26M3QHINXT,Nathan G,20120312,39,4.538461538461538,53.48717948717949,14,3,11
A3EPHBMU07LZ50,Mysterious Reviewer,20060904,38,4.315789473684211,169.81578947368422,70,10,60
A3EPJSPH03AS29,pebbles,20070120,48,4.645833333333333,155.02083333333334,164,26,138
A3EQNKWEHBAOV3,David P. Smith,20120707,25,4.44,57.16,34,7,27
A3EQQHWJ1EEYEU,Burt Bicksler,20110919,48,4.770833333333333,62.1875,37,14,23
A3ER6ARJ23CIN8,Justin Bongard,20090404,66,4.575757575757576,72.43939393939394,34,18,16
A3ERS94QZJJ9EP,D. Skye,20100905,22,4.681818181818182,86.18181818181819,17,2,15
A3ERTHGCYNZ1TA,"A. Thompson ""Skeptic""",20060622,22,3.727272727272727,165.0,46,5,41
A3ESMG31XIRL1R,David,20040911,27,4.037037037037037,335.22222222222223,908,101,807
A3ESNXS1FX0YJP,"JB Stoltzfus ""mega_click""",20080913,21,4.619047619047619,101.0952380952381,34,6,28
A3ESSJ2SGCKBG4,B. May,20040128,22,4.318181818181818,141.1818181818182,266,32,234
A3ESV4BP67N62E,B Tennyson,20121007,24,4.375,56.5,4,9,-5
A3ETVWL23GEZ2U,Casper Chauncey,20130115,25,4.16,191.96,77,28,49
A3ETYC1KEQDELJ,"Robb Fladry ""robb_fladry""",20120130,25,4.68,64.48,7,8,-1
A3EUSH8DPW75LR,barry,20081019,32,4.59375,346.21875,360,33,327
A3EV2R77V65VGM,Michael Saul,20130218,35,5.0,27.62857142857143,5,1,4
A3EV8JA23IUP7O,Charlie Howard,20060112,40,4.175,289.6,430,41,389
A3EVG8FCBJ6BHJ,Friedman Wagner-Dobler,20051118,22,2.3181818181818183,151.9090909090909,615,106,509
A3EVGPGOFVAP09,"WorknMan ""worknman""",20020209,28,3.2142857142857144,286.92857142857144,215,258,-43
A3EVH7XJ8KWOK2,deirdrebardowl,20120823,22,4.2727272727272725,188.1818181818182,21,4,17
A3EVSZSUWFBCXP,T. Whiting,20100323,38,2.710526315789474,149.31578947368422,40,56,-16
A3EWJX7W1X7E79,Amazon Customer,20100315,46,4.0,173.5,159,33,126
A3EX8ZFNVDHGPM,"S. Mitchell ""samintx""",20070101,38,4.447368421052632,64.1842105263158,41,20,21
A3EXIZWHSNVNME,"Cynthia ""Andante Cantabile""",20100702,22,3.4545454545454546,143.86363636363637,18,8,10
A3EXW4HNYX7HF5,"Atomic Tofu ""Code of Bushido""",20060226,21,4.619047619047619,133.42857142857142,29,8,21
A3EXWV8FNSSFL6,Daniel G. Lebryk,20070604,250,4.504,605.976,4847,416,4431
A3EZ1L463NJMIH,Zach,20100928,22,4.2272727272727275,89.36363636363636,22,3,19
A3EZD11AFUX23K,Jason P. Gold,20040421,22,3.909090909090909,363.6363636363636,113,16,97
A3EZEP0FX5BC1P,"A Conrad ""Ask Conrad""",20050915,117,4.068376068376068,440.84615384615387,1088,93,995
A3EZFFPVS34AMO,PD,20060811,101,4.544554455445544,312.8712871287129,1127,116,1011
A3EZLOKH9FKOVW,"Eznug ""eznug""",20100216,21,4.380952380952381,32.57142857142857,6,4,2
A3F116LSHJU7YS,klas,20120427,28,3.4642857142857144,321.2857142857143,865,92,773
A3F2K1RC9IMNLX,S. Misa,20120817,26,4.461538461538462,105.5,3,2,1
A3F2M27L02YDLM,"Alex Evans ""Alex""",20080405,37,4.54054054054054,76.91891891891892,56,9,47
A3F2VVIQIY6U64,Armando N. Roman,20100417,32,3.65625,413.15625,120,37,83
A3F3B1JPACN215,Michael G. Lustig,20070416,85,4.117647058823529,190.6235294117647,188,44,144
A3F3B6HY9RJI04,James Duckett,20031012,106,4.40566037735849,233.3679245283019,516,95,421
A3F3T0M58SE33C,"M. Montana ""M""",20091217,23,4.086956521739131,180.43478260869566,107,22,85
A3F3UARRAYEQH6,Kevin Woodward,20010919,22,4.454545454545454,261.72727272727275,1346,84,1262
A3F43PAJZLOE3I,"ice grizzly ""Grrrrrr""",20040212,36,4.5,185.58333333333334,326,38,288
A3F5I3P6PEWUBN,"md ""md""",20080221,22,3.409090909090909,202.86363636363637,63,27,36
A3F5NFPJ5XTT2Q,"David Wolf ""Misanthrope""",20100128,25,4.08,254.0,46,8,38
A3F6O2RD11GNDR,Chris M. Davies,20080621,25,4.08,91.84,40,15,25
A3F73SC1LY51OO,Alan Montgomery,20110811,35,4.628571428571429,230.42857142857142,651,56,595
A3F7F7QKQP2FKT,Beanie,20110430,44,4.681818181818182,52.59090909090909,49,9,40
A3F7USIDJBR8WU,nobody ya know,20070430,70,4.5,121.9,133,154,-21
A3F8T3BRXRX5P3,JWink,20120602,59,4.135593220338983,162.10169491525423,166,19,147
A3F9710KIUVDGC,"VladM ""reviewer07""",20021026,31,3.7419354838709675,124.19354838709677,110,37,73
A3F9CBHV4OHFBS,Thomas N. Gilmore,20060322,63,4.507936507936508,119.63492063492063,50,8,42
A3F9CG9LXM182L,Roger Bergman,20090425,23,4.826086956521739,60.43478260869565,26,9,17
A3F9CMU8KNAY1M,"Susan ""minniesm""",20080628,80,4.2,247.9625,215,46,169
A3FARCKMBHQZLY,givpilot,20031110,26,4.576923076923077,189.26923076923077,995,93,902
A3FBGRWDSWOC51,Sarge,20080523,28,4.642857142857143,193.82142857142858,131,3,128
A3FBM0RMCMAABV,Penguin Chick,20090929,55,4.472727272727273,95.07272727272728,78,25,53
A3FBMSWBJ202SF,amazon's fan,20091112,21,4.714285714285714,99.80952380952381,22,16,6
A3FD8AKQT178TR,Hebert Tejada Ito,20130401,23,4.608695652173913,55.30434782608695,51,5,46
A3FEGTOLCWXSV4,Ammy_Evaluator,20080523,148,4.006756756756757,361.13513513513516,2957,264,2693
A3FEJ8H2VTN0OJ,john ziesemer,20130314,40,4.725,79.175,15,5,10
A3FFKU2MTCOBM1,"new yorker ""drealyea""",20091215,38,4.2631578947368425,77.34210526315789,33,29,4
A3FFZQKCA7UOYY,"TheWaldo ""W.""",20060419,52,4.788461538461538,202.53846153846155,202,48,154
A3FG0FQHNV2UP2,E. A. Montgomery,20071109,41,3.5853658536585367,253.09756097560975,501,62,439
A3FGBYFE2AW26D,"Dr. Curmudgeon ""Doctor of misanthropy""",20130621,22,3.772727272727273,88.04545454545455,10,4,6
A3FGOOWBV8SUCA,,20120401,33,5.0,29.454545454545453,15,4,11
A3FGTMTVOYENT1,SDEF,20110601,32,4.09375,87.84375,25,8,17
A3FH2LTPJU3NXR,Mark Estrada,20120721,24,3.8333333333333335,317.5,67,16,51
A3FHHHFV46KFD6,L. Thurlow,20060822,30,4.8,25.266666666666666,6,7,-1
A3FHW0VEWAYCQ6,EC,20130723,35,4.228571428571429,55.82857142857143,9,5,4
A3FIA2QBJZJUIA,Sergio Augusto,20120418,22,4.818181818181818,70.36363636363636,20,10,10
A3FKQQTSMHOCE0,"Tezza ""Tezza""",20031029,47,4.702127659574468,218.12765957446808,611,37,574
A3FN5T0U561OTG,Gregory Topor,20030216,30,4.133333333333334,127.3,92,58,34
A3FO94MKFID2DK,Nancy Mitzen,20130307,38,5.0,24.210526315789473,7,2,5
A3FOASYBGBOETQ,W. Evans,20090530,29,4.137931034482759,46.206896551724135,22,6,16
A3FOBWCPSJWKJY,AQucsaiJr,20090128,21,4.666666666666667,151.61904761904762,95,2,93
A3FOSLM5G1BO63,"Eugene Tenenbaum ""reluctant reader""",20070319,103,3.679611650485437,171.58252427184465,431,69,362
A3FP8D5FQ0RPEJ,Get-A-Geek,20130302,26,4.5,100.3076923076923,20,18,2
A3FPQ84ERHTKYX,"Donald F. West ""Photostar""",20090629,21,3.8095238095238093,75.95238095238095,103,23,80
A3FPSY1M6G7XIB,RonAnnArbor,20060630,97,4.597938144329897,180.83505154639175,3012,271,2741
A3FQ9WYUHG9CD,"DMGenest | ""Genet""",20110730,24,4.625,263.9166666666667,19,2,17
A3FQC5WEAA9WDH,Nate,20110420,24,3.5,78.58333333333333,4,3,1
A3FS3FJPD3RJTD,"Sunday ""SundayAtDusk""",20050917,52,4.365384615384615,368.5,187,39,148
A3FSNQS8T99H1N,ralechner,20120515,29,4.9655172413793105,94.51724137931035,22,6,16
A3FTI86WAVJOLG,"John A. Radi ""jradi""",20000517,29,4.448275862068965,231.10344827586206,1295,66,1229
A3FU2A91KSXOHZ,Luckyone,20090521,26,4.0,95.03846153846153,93,13,80
A3FU8T75Q5YGC7,John Vasquez,20110314,39,4.717948717948718,136.74358974358975,13,3,10
A3FWI03TTRIWDP,1GoodDog,20100312,26,3.6923076923076925,102.23076923076923,24,17,7
A3G007LQX6KGOD,SevereWX,20050322,59,4.305084745762712,291.4406779661017,425,64,361
A3G05IEEQP0LHM,Christopher W. Morris,20081021,21,4.761904761904762,44.95238095238095,7,1,6
A3G0VC4V40KYFG,Amazon Customer,20030510,23,4.6521739130434785,89.91304347826087,43,10,33
A3G19SJMZO3NZW,H. Al-Harethi,20081029,21,4.523809523809524,242.66666666666666,41,7,34
A3G3QUF116C6RU,"georgehd ""georgehd""",20090204,22,3.090909090909091,112.27272727272727,79,60,19
A3G48J3TDU93AY,Techy A.,20140527,25,3.36,35.56,1,1,0
A3G4J51ZJJ1FDQ,Karen,20130826,28,4.928571428571429,40.285714285714285,8,0,8
A3G4NSG8P49G4L,K. Ambrose,20060616,21,3.8095238095238093,208.42857142857142,90,30,60
A3G4O3AF6JSTYW,J. Johnson,20120420,27,3.962962962962963,46.55555555555556,18,2,16
A3G50F5BB1J2CS,A. Santiago Jr.,20061209,22,4.363636363636363,234.95454545454547,118,13,105
A3G52XWKNLBC3,Andi C Bair,20130317,29,4.310344827586207,283.8965517241379,33,13,20
A3G5C3JE30FP89,"Dennis W. Simpson ""Dennis""",20030319,23,4.304347826086956,77.34782608695652,110,18,92
A3G5GPUE51I3DM,"Jony760 ""Jon""",20091108,21,4.523809523809524,99.0,35,8,27
A3G5MOHY1U635N,"A-mazon Customer ""SPB-RU""",20060314,76,4.131578947368421,203.60526315789474,308,67,241
A3G7BEJJCPD6DS,VeraP,20070521,58,4.017241379310345,175.89655172413794,79,14,65
A3G7LGYQ8GCZMG,chemstudent,20090814,22,3.6818181818181817,128.86363636363637,24,9,15
A3G86RMDGTI4WD,chris,20121213,25,3.88,24.64,1,16,-15
A3G8L4U5W9XMEI,Eric Gross,20050310,29,3.0,115.82758620689656,54,41,13
A3G9EPATNH74MN,John D.,20131115,43,4.651162790697675,32.55813953488372,15,3,12
A3G9FZJ3WMNHA4,"J. Verma ""brazilianloser""",20120821,22,4.318181818181818,75.13636363636364,6,3,3
A3GAEVQR5F9Q9J,Kiendawtcom,20020216,22,4.318181818181818,100.04545454545455,7,2,5
A3GAP455S8YH0M,"Joe's Gadgets ""JOE H.""",20100120,29,4.724137931034483,97.37931034482759,23,8,15
A3GASQRWPQW28W,No*BoUnCe,20050702,22,3.272727272727273,126.18181818181819,59,20,39
A3GB3663QXYMYD,WDT,20120731,35,5.0,24.742857142857144,7,1,6
A3GBET6SMQUF4X,ActionAndAdventure!,20090502,24,5.0,80.58333333333333,42,5,37
A3GBGWUWKQGJU2,T. Hansen,20090808,26,4.230769230769231,100.65384615384616,110,61,49
A3GFK7F5IUF60X,"Myra Schjelderup ""Ignolopi""",20090124,37,4.405405405405405,310.35135135135135,155,20,135
A3GFOJX5RZC7PZ,"Lee Perez ""LP""",20110323,21,3.619047619047619,71.9047619047619,11,11,0
A3GFPC4MTFIQK1,ChrisLanders6694,20120319,27,3.074074074074074,74.4074074074074,97,29,68
A3GFQHHVMEAIO,Danny K,20010623,52,4.25,306.46153846153845,372,40,332
A3GG4CORPIP02S,Brad M.,20031207,40,4.075,125.325,61,16,45
A3GGLQIVAMJ060,"JoshPies ""I ain't no drag, papa's got a brand...",20101110,23,4.130434782608695,109.65217391304348,28,4,24
A3GHITPT5SRXBH,Evgueni Tchirkov,20101218,23,4.6521739130434785,137.69565217391303,106,9,97
A3GICKMSI88AGG,"Eliott Mendelson ""ele""",20070512,22,4.2727272727272725,80.13636363636364,33,15,18
A3GISRNT7BJEO8,"Pop ina Bottle ""Never argue with an idiot. th...",20050910,34,4.323529411764706,100.3529411764706,103,57,46
A3GIVGGBFPFBQM,"Guy C ""g""",20080831,27,4.37037037037037,127.25925925925925,45,15,30
A3GK1O5S6188AJ,Amy Willingham,20110615,31,4.580645161290323,333.5806451612903,70,27,43
A3GKGV6ELBPF11,R. Precourt,20080326,32,4.0,274.125,498,56,442
A3GKOWG6UIIEKX,"Richard Fisher ""Rich Fisher""",20110508,22,3.6818181818181817,97.4090909090909,11,6,5
A3GMRYV7VAYK5Q,Georgia Mom,20030814,29,4.103448275862069,242.93103448275863,117,19,98
A3GNZUE5BIH395,Richard Barr,20120215,29,4.620689655172414,80.89655172413794,13,1,12
A3GOS8Y7DV0E4X,Ed Figueroa,20140203,21,3.7142857142857144,32.95238095238095,2,2,0
A3GOVWMQ10MI75,Physical Engineer,20100112,25,4.32,93.08,76,6,70
A3GQKB1KF0CRPE,"Deborah MacGillivray ""Author,""",20020429,26,4.730769230769231,157.96153846153845,434,62,372
A3GQP16J109A3F,"Homer Jay Simpson ""Homer J.""",20110116,21,4.142857142857143,62.285714285714285,15,4,11
A3GQY0TFRG0MPZ,"John Wing ""Wingman""",20110105,53,4.811320754716981,222.54716981132074,26,3,23
A3GQZO7IS2FDGG,"BiG-SaVeR ""Nazrett""",20091111,21,2.619047619047619,199.0,28,55,-27
A3GRRDOYGIEZ45,"Tom Trails ""Tom Trails""",20040424,28,4.142857142857143,207.17857142857142,429,45,384
A3GRXW7XYZ0L7,"Julia ""JB""",20060917,27,4.222222222222222,69.14814814814815,9,2,7
A3GS12USHLMPR4,Josh J.,20131219,22,4.454545454545454,51.95454545454545,2,0,2
A3GS67Y2O3RRO0,Dad2014,20101019,41,4.170731707317073,248.5609756097561,212,41,171
A3GS7OZXUEW48R,Gene Cloner,20050908,34,4.294117647058823,287.38235294117646,434,38,396
A3GSYEL2O5A65,Mel R. Scurbica,20080103,21,4.428571428571429,244.8095238095238,139,16,123
A3GTDJYQQWS0MS,Silverwolf70,20101213,23,4.3478260869565215,128.0,52,13,39
A3GVJ88EHS08RZ,GailK,20060510,25,3.68,170.56,90,21,69
A3GVTK181RD96Y,S. J. Simmer,20060117,30,4.466666666666667,73.36666666666666,26,10,16
A3GVXKCTFN3YDN,"Lawrence H. Bulk ""Lawrence H. Bulk""",20071208,76,4.828947368421052,1033.657894736842,3215,290,2925
A3GVZ1F1HBW2KV,Andrew Bishop,20110525,25,4.64,178.52,20,4,16
A3GW8KCILR2E8L,William B. Gavin,20120416,22,4.363636363636363,45.5,21,5,16
A3GX0FAMEXV6FB,Mark,20120410,61,4.065573770491803,139.14754098360655,82,12,70
A3GXWGBCGF4HX,ECTECH,20140708,31,4.903225806451613,36.70967741935484,2,1,1
A3GYY4CBRUZRSO,sjw,20070415,28,3.607142857142857,169.03571428571428,227,56,171
A3H0F51UIOZQJ7,jwzumwalt,20101225,21,3.619047619047619,41.80952380952381,2,2,0
A3H3SSMA6M73IF,"Neoprimal ""Tech Kid""",20060802,24,4.25,623.875,111,11,100
A3H48JGW7UB7PI,"Matinikk ""Matinikk""",20120318,27,4.444444444444445,58.96296296296296,4,4,0
A3H4A1QB7J8M1K,"Amazon Customer ""Likes electronics.""",20030529,39,3.8974358974358974,55.256410256410255,201,100,101
A3H4S6YO9VNGDZ,Anthony J.,20131015,93,4.56989247311828,338.3225806451613,293,29,264
A3H4TIVTTA5IBB,Brian A. Wolters,20080416,46,4.043478260869565,241.5,250,45,205
A3H6M91BEVULCS,Mark D. Pashia,20090922,22,4.454545454545454,104.63636363636364,28,12,16
A3H6NNGCINPLEC,Penetralia,20060303,51,4.333333333333333,132.50980392156862,211,159,52
A3H7087YTQO9PO,"Ozgard ""Oz""",20031226,30,4.733333333333333,137.96666666666667,140,13,127
A3H7ADUP07D93H,"J. Fuchs ""jax76""",20050601,26,3.6923076923076925,373.7307692307692,221,35,186
A3H7BGDXSBPPEA,Jeremy Wilcock,20130424,21,4.428571428571429,39.38095238095238,3,1,2
A3H7I249HK26NI,"David Norwood ""Central Coast Real Estate""",20080321,21,4.714285714285714,104.04761904761905,19,10,9
A3H7IN7FW22Q7Z,Mister B,20110217,25,4.8,96.12,15,2,13
A3H7NPNDMGLOU4,"Amazon Enthusiast ""The Lucky One""",20081204,26,4.8076923076923075,304.96153846153845,139,17,122
A3H8PA7AG48K33,A. Silverstone,20100606,27,4.7407407407407405,129.96296296296296,29,2,27
A3H99DFEG68SR,1m2,20110405,27,3.6666666666666665,189.25925925925927,50,42,8
A3HB3UYIWQ2MI,samswildworld,20121127,22,4.590909090909091,74.77272727272727,15,5,10
A3HC7NWLKCPX4X,joel,20100927,45,3.3555555555555556,58.4,21,76,-55
A3HCMJOGRRSAF2,"Paul C. Huang ""Paul Huang""",20050128,48,3.6458333333333335,181.83333333333334,418,247,171
A3HEPUB4I9EDA6,Gaigemc,20110308,22,4.5,89.72727272727273,66,14,52
A3HFBHAEG1LOEO,"K. Mudge ""Senior Research Engineer""",20061225,21,3.7142857142857144,129.0952380952381,23,7,16
A3HG0DNFURFXR4,"CCE ""greenness""",20080923,26,4.038461538461538,177.15384615384616,15,7,8
A3HH340REI4J47,M. Lam,20120318,48,4.4375,106.75,88,8,80
A3HICRL1GPX5QR,John,20120708,24,3.4166666666666665,37.041666666666664,8,14,-6
A3HIORRZPFPH8V,mnpilot,20110727,22,4.045454545454546,39.0,1,2,-1
A3HIUWKL4D853W,RayH,20120519,34,4.852941176470588,94.58823529411765,14,0,14
A3HIZRE3I7X6UV,"A. Craig ""Surf Striper""",20111210,34,4.029411764705882,60.23529411764706,20,4,16
A3HJHV83O2U8BL,Robert A. Grossman,20080821,29,3.8620689655172415,283.17241379310343,189,34,155
A3HKWOC783B7PL,Darren,20080117,28,4.642857142857143,315.25,293,19,274
A3HLUBDLMU8RGO,Ryan L,20131216,34,4.411764705882353,57.05882352941177,5,0,5
A3HN318DL1X2G3,XDanteX,20130804,28,4.607142857142857,68.25,2,1,1
A3HNLJGBLFBJIA,"J. Robson ""Reflective Artist & Product Designer""",20100920,37,4.4324324324324325,273.2162162162162,447,59,388
A3HOC1P7HS7KFC,geogeo,20071220,27,3.962962962962963,73.48148148148148,10,10,0
A3HOQ9C7UMZQCS,GamerGal,20080804,34,4.529411764705882,53.05882352941177,29,4,25
A3HPCRD9RX351S,Spudman,20090425,86,4.441860465116279,243.04651162790697,748,44,704
A3HPFC4WMB2LZD,kre8iv1,20071001,28,4.642857142857143,156.57142857142858,79,5,74
A3HQAPXAJV7PRX,Diane Kistner,20090718,56,4.303571428571429,333.3392857142857,195,57,138
A3HQJWQMRH5AEG,A. Le,20070923,22,4.681818181818182,69.86363636363636,86,6,80
A3HQKJ7S1U19P7,"C. Ayala ""nuto""",20051102,31,4.129032258064516,125.38709677419355,20,4,16
A3HR0ZZOFKQ97N,RLC,20110426,93,4.731182795698925,143.752688172043,199,23,176
A3HRDRQ5VAFPQS,"P. Falcioni ""Ducatisti""",20060629,51,3.7254901960784315,252.68627450980392,477,53,424
A3HRTSBFHCCOJK,CMOS,20050812,23,3.9565217391304346,214.82608695652175,139,9,130
A3HS3ZI46QOG14,Nick,20120615,31,3.3225806451612905,80.41935483870968,14,11,3
A3HSDV9Y0TV5Z2,"Jim ""Jim""",20100511,79,4.556962025316456,111.20253164556962,181,16,165
A3HSJ1MXU5YX8X,Chris,20040122,30,4.433333333333334,127.46666666666667,45,20,25
A3HSJJ0JG0FUWO,Amy Hoover,20111127,23,3.9565217391304346,90.82608695652173,17,2,15
A3HTGJAK801WJC,botw,20090624,21,4.095238095238095,80.80952380952381,43,13,30
A3HU5LZYOFAWR4,gboat,20121122,31,5.0,33.25806451612903,11,2,9
A3HUC8541SJ6UT,"B. Junkin-Mills ""brookemom""",20080208,37,4.243243243243243,250.45945945945945,110,15,95
A3HUK2D3SNXHMR,"Shorian ""gadget guru""",20100617,34,4.029411764705882,88.76470588235294,88,28,60
A3HVGH7PARA3BG,J. Riga,20080425,40,4.375,229.525,521,39,482
A3HVLIZMG8BNDZ,am,20110519,23,4.260869565217392,335.30434782608694,72,88,-16
A3HVML44BPPS2G,"S. Adams ""S. Adams""",20091030,22,4.454545454545454,293.77272727272725,64,18,46
A3HVT0QG7SLKFJ,J. C. Kaessinger,20091117,24,4.416666666666667,308.8333333333333,185,12,173
A3HVU562SSVP8Q,Ms N. Boone,20070112,28,3.9642857142857144,288.67857142857144,119,28,91
A3HXGSMCIOZEW8,Zakatronics,20120510,52,4.538461538461538,132.34615384615384,30,8,22
A3HYQHTMEQI1MI,Tim Williams,20131222,23,4.739130434782608,49.56521739130435,0,0,0
A3HZANL0GB61U8,SCAT,20110827,24,4.416666666666667,63.0,29,7,22
A3I04RM049YS8Y,Jeffrey Stanley,20070117,28,3.7857142857142856,635.3571428571429,1878,179,1699
A3I0B42BE8ABQ5,John E. Scott,20080102,33,3.3333333333333335,211.45454545454547,166,27,139
A3I0I0YHZB013F,"IPPete ""IPPete""",20050213,37,4.621621621621622,90.37837837837837,34,7,27
A3I195NZP83EU1,Robert Gammon,20131027,25,4.84,27.56,3,3,0
A3I1BJIFFM4S21,Atomicwasteland,20001124,38,4.7105263157894735,443.39473684210526,774,53,721
A3I1GZ3Z7AXSNZ,M. Kalagias,20100721,21,4.0476190476190474,229.85714285714286,20,7,13
A3I1LYDUSZSGUY,John D. Steere,20080104,22,4.7272727272727275,82.9090909090909,135,9,126
A3I2DSAHZ5NCBV,Malcolm G,20120204,23,4.521739130434782,79.0,7,1,6
A3I37WRTVINAGI,"squeek ""zebra217""",20111214,21,4.857142857142857,29.571428571428573,3,0,3
A3I3LYRV37ISY7,"CWR ""Power down""",20110805,24,4.75,76.41666666666667,3,2,1
A3I3OSZR5GDGV3,Rich L.,20131008,34,4.382352941176471,48.205882352941174,8,3,5
A3I5YPJZMTG1QO,D. P. Taylor,20060808,30,4.4,159.96666666666667,37,27,10
A3I64CVN1BSX2U,Michael Ferrara,20140110,24,4.625,44.958333333333336,4,0,4
A3I6704DLTIILE,powerop,20091209,41,4.658536585365853,478.1219512195122,927,36,891
A3I6HYTU037QBA,Obiburner,20060810,31,4.290322580645161,322.9032258064516,272,29,243
A3I73QMJPPMZ3Q,"minacel ""minacel""",20060413,30,3.1333333333333333,79.0,25,25,0
A3I7I0MKM53JUC,"K. R. Goldman ""Ken G""",20061129,29,4.0,119.03448275862068,58,24,34
A3I9Q7TS5FQY0W,DJ,20140129,25,3.64,177.24,40,5,35
A3IAU6ZPVF2R5K,"L. Maupin ""drop-dead-books""",20090904,32,4.6875,93.25,34,22,12
A3IB935PA94VIQ,IndyTom,20120704,23,4.478260869565218,79.08695652173913,9,2,7
A3IBY8HITDNX1J,Best Value,20101026,22,4.954545454545454,45.27272727272727,2,0,2
A3IBZN5AUG04I7,ProjectJLN,20120101,25,4.88,108.68,11,3,8
A3IE8PNBE2LPJE,lapis,20061230,23,4.043478260869565,165.7826086956522,50,11,39
A3IFCL2696IUER,Amazon Customer,20120425,23,4.217391304347826,82.30434782608695,13,2,11
A3IFHLX3U0M7SF,oloung1,20110425,23,3.608695652173913,121.82608695652173,15,8,7
A3IGETH1M17L0W,Jack,20090817,23,4.260869565217392,65.1304347826087,50,11,39
A3IGLE6X6RSNZX,"Abhilash K. Oommen ""Abhi""",20110427,22,4.181818181818182,639.7272727272727,149,21,128
A3IIB6N91ASPWO,"Thomas Bangash ""THBangash""",20080521,23,4.478260869565218,335.0,40,17,23
A3IIGCFLKVFW8M,"Brian M. Kaplan ""Brian M. Kaplan""",20070521,30,4.066666666666666,60.233333333333334,331,24,307
A3IJ4Z18FTIIP,"K. Halloran ""bridgenet""",20021228,48,3.8958333333333335,95.16666666666667,99,26,73
A3IJL9A50KVVZ1,"Danny Newport ""......Danny""",20110321,46,4.913043478260869,59.69565217391305,43,7,36
A3IJMGVOWPBCPJ,"looking around ""aworldtraveler""",20010722,23,3.6956521739130435,231.04347826086956,233,46,187
A3IK2VCQ007CJ,"ALK ""AK""",20101004,54,4.2592592592592595,71.48148148148148,57,34,23
A3IKLTT9JQACCI,Becky Rose,20081226,26,4.653846153846154,216.96153846153845,37,9,28
A3IKZ15AVH556K,FRED CONTRERAS,20120923,34,4.617647058823529,97.02941176470588,19,13,6
A3IL4WNBMGBJRY,"Brian Smith ""Tough But Fair""",20080527,39,3.871794871794872,322.0769230769231,72,19,53
A3IL5XA8XYBPUD,Amazon Customer,20030409,27,4.111111111111111,398.22222222222223,476,42,434
A3IMALU0RM8UT9,C. DeHart,20070816,65,4.6923076923076925,115.53846153846153,23,3,20
A3IMK08UX0I46A,"TOPJOB7 ""topjob7""",20051229,23,3.739130434782609,216.3913043478261,65,44,21
A3IN7UPZ5F178G,"Laurent ""grinmister""",20070626,24,3.9166666666666665,128.33333333333334,17,4,13
A3INKBDWXCL8LP,"Lensviewphoto ""Mark""",20091109,33,4.121212121212121,208.93939393939394,197,27,170
A3INN916E4VION,S. Kosloske,20001116,70,4.5,153.72857142857143,288,41,247
A3IOCPLIMYDBCD,"Hummingbirder ""Don't ask for a man's soul whe...",20090101,34,3.823529411764706,252.55882352941177,198,33,165
A3IOQ7NVVLAUEE,I. Guch,20130401,86,4.348837209302325,41.75581395348837,74,104,-30
A3IPSECQAUAT8V,JanSobieski,20031001,36,4.444444444444445,330.1388888888889,2961,138,2823
A3IQFC5I1NA9EU,Eddie,20130517,29,4.620689655172414,127.6896551724138,17,5,12
A3IR834T7AROBT,Ed,20080509,29,4.724137931034483,233.79310344827587,487,63,424
A3IRA0BHI9NE9U,"Justin Quigley ""Justin Quigley""",20130910,53,4.867924528301887,57.716981132075475,11,3,8
A3IRC9ONDV8YJ3,Geob Donte,20090214,21,3.857142857142857,158.33333333333334,10,6,4
A3IRE552497R6O,Han,20090130,23,4.304347826086956,178.43478260869566,84,13,71
A3IROM8JD6KAVG,Floyd Sense,20070526,29,3.5172413793103448,175.82758620689654,80,12,68
A3IS23397LB45,steve,20121220,44,4.681818181818182,41.09090909090909,4,2,2
A3IS7IWI3RFS47,John Coltrane,20101213,24,4.583333333333333,66.25,5,2,3
A3IT5YOH6MQTWM,"Martin ""LS""",20060630,24,3.6666666666666665,183.45833333333334,228,33,195
A3IULQ4N5W3G93,M. Rylaarsdam,20091015,31,4.451612903225806,79.41935483870968,21,3,18
A3IUW081KXD3PE,pixels and bits,20090309,58,4.396551724137931,223.27586206896552,152,11,141
A3IVD40AUG8DZW,robertsmx,20110801,44,4.863636363636363,160.61363636363637,152,9,143
A3IVDLIXVJCRDQ,"A. Ryan ""AJRyan""",20101202,33,3.8181818181818183,240.06060606060606,126,28,98
A3IW9TTG36O24X,Er,20121031,25,4.4,27.96,2,2,0
A3IXXWSTNWCS4G,David A. Morehead,20030303,26,4.653846153846154,411.65384615384613,236,20,216
A3IY316DRNF5F2,ElmoTheCat,20050212,101,3.9207920792079207,101.33663366336634,245,85,160
A3IYQ2A1EZ07BD,,20110728,21,4.476190476190476,131.57142857142858,10,5,5
A3IZDVIS87YT60,"N. Berry ""north""",20050105,21,4.285714285714286,95.52380952380952,9,14,-5
A3IZG4220L7VIM,lightspeed2121,20130522,24,4.041666666666667,37.0,9,36,-27
A3J029KBNG5MNP,Mr. Bey,20091005,55,4.218181818181818,157.9090909090909,54,36,18
A3J031UXHGZTWV,"Ethan E. Harris ""Ethan E. Harris""",20090101,22,4.7272727272727275,137.86363636363637,79,8,71
A3J0BIM3BE26J3,Alicia,20120321,32,4.9375,43.3125,8,0,8
A3J2N3MC99CLB3,ShoppingGeek,20071129,22,4.0,250.1818181818182,167,51,116
A3J2YU2D9BH2J7,"Christopher ""Chris""",20131030,68,4.367647058823529,112.6470588235294,151,9,142
A3J3OCM6PPWNRY,"Dinakar Sarma ""Dino""",20070118,41,4.585365853658536,186.9268292682927,40,24,16
A3J3ZHGDUDPCFL,fatmav,20060428,52,4.5576923076923075,359.75,340,55,285
A3J40JUCYGXNPN,Richard M. Miller,20060324,21,4.571428571428571,31.952380952380953,39,17,22
A3J4EANDO3NM6S,The Photographer,20070308,22,4.545454545454546,50.40909090909091,26,13,13
A3J4OBCX23VPCK,"Doc Wittmer ""DocWittmer""",20090401,29,4.241379310344827,129.44827586206895,165,31,134
A3J6Q0Y0SKY7AR,"EngrPaul ""EngrPaul""",20080406,49,4.428571428571429,194.22448979591837,190,14,176
A3J86WG2SZEFJM,Carlos,20070915,25,4.56,207.32,78,5,73
A3J891E9B6FIIP,brian d. bouvier,20130122,21,4.714285714285714,44.19047619047619,2,2,0
A3J8A5L5AF5TX9,Richard La Barca,20081107,153,3.9411764705882355,150.58823529411765,498,62,436
A3J9I66REX8ZBO,viper,20110608,35,3.3714285714285714,75.91428571428571,18,34,-16
A3JAH5WW61N2EK,Michael Laferriere,20071222,40,4.475,217.175,29,3,26
A3JCBDXNF0ZB66,Ram-Z,20100306,35,4.057142857142857,173.8,30,5,25
A3JCNLSNSA04G8,Chris A. Mahar,20120129,21,4.380952380952381,102.19047619047619,5,1,4
A3JCPV1EPCPP64,Angelo A.,20100415,25,4.4,91.36,120,15,105
A3JCWGHCVC2ZNF,Sheri in Reho,20010720,22,3.727272727272727,477.95454545454544,304,18,286
A3JFQSOF150OEI,H. Stevens,20081015,36,4.083333333333333,241.86111111111111,38,7,31
A3JGEM4UXXOGZY,Ryan Hansen,20130620,21,4.476190476190476,33.333333333333336,15,2,13
A3JGIXQPX65TGJ,Dr Mike,20061224,36,4.361111111111111,185.5,215,20,195
A3JHC8O59WDHFZ,Silea,20001111,31,3.161290322580645,303.741935483871,99,43,56
A3JJ222HEKM10R,Rosalise Ellis,20140404,31,4.548387096774194,33.354838709677416,6,3,3
A3JJNSW1XHXX9B,BaPuters,20050320,21,3.9523809523809526,182.42857142857142,274,39,235
A3JL3YQYI7OR5O,Jason Chamberlain,20091229,33,4.424242424242424,165.3030303030303,52,9,43
A3JLGYV7IN38YN,Kathleen Derevan,20070527,29,4.689655172413793,169.55172413793105,41,10,31
A3JLOIXFM75QNV,"Valerya Couto ""LOTRsherlockHPFreak""",20070821,47,4.191489361702128,135.91489361702128,81,27,54
A3JM1TJILHPS7G,A. Hearn,20060110,21,5.0,113.85714285714286,65,10,55
A3JMC0JT0NM7K9,Mark M.,20100202,24,4.791666666666667,170.25,8,0,8
A3JMDRBJVVQ6C6,Jack,20110123,23,4.695652173913044,120.17391304347827,43,1,42
A3JN514KNXO6OU,,20110831,23,3.130434782608696,72.34782608695652,13,6,7
A3JNBO7H2SPL44,Daniel,20111101,54,4.833333333333333,37.75925925925926,30,9,21
A3JPFWKS83R49V,"Bryan Carey ""Bryan Carey""",20051221,21,3.6666666666666665,394.9047619047619,117,24,93
A3JQ58CZBV3FOZ,M. Wang,20070426,38,3.973684210526316,204.73684210526315,380,37,343
A3JQFZN172EQ4E,"Allan Forbes Suarez ""Xforbes""",20070517,28,4.678571428571429,59.892857142857146,21,17,4
A3JRPHF898TEW8,Ivan,20110910,21,3.857142857142857,124.33333333333333,33,14,19
A3JRW716H3AX14,Brad Teare,20100112,22,4.681818181818182,100.27272727272727,23,3,20
A3JRZ4W140YICJ,M. Heltsley,20070822,33,4.7272727272727275,310.06060606060606,184,16,168
A3JSBSXZRB2BBJ,Antonio Mallah,20130617,34,4.470588235294118,53.1764705882353,14,1,13
A3JU16JTNLVK1J,Tony,20130306,45,4.155555555555556,70.53333333333333,6,3,3
A3JU990UTN5RQP,mcgman,20121221,59,4.389830508474576,60.59322033898305,35,10,25
A3JUHP1E3WUHEA,Dr. Stuart Gitlow,20061206,67,4.402985074626866,484.55223880597015,1948,125,1823
A3JUQ2E799OC5B,"Markcm ""Markcm""",20071118,26,4.461538461538462,178.80769230769232,14,2,12
A3JV071KO43Q5X,"Jeffrey Pittman ""Jeff""",20050110,62,3.8225806451612905,276.7741935483871,826,104,722
A3JW6DWIHUUVQL,shotgunb,20110516,22,4.5,148.27272727272728,132,7,125
A3JW711GJ97CEY,"zipturtleaz ""zip!""",20091231,30,4.033333333333333,86.9,12,4,8
A3JWD0WQ3VEZEX,"Wood B. Hermit ""Seeker of the one pure and cl...",20110801,23,4.3478260869565215,372.5217391304348,1465,114,1351
A3JX1D26WFEXOS,"S. Bains ""singh""",20050618,34,4.588235294117647,142.8235294117647,59,12,47
A3JZOITOIP90EW,Cass G,20061116,23,3.6956521739130435,241.17391304347825,84,18,66
A3K1Z7D96XFHNE,"Technocratic Addict ""Shameless geek""",20110916,24,4.0,165.41666666666666,26,5,21
A3K24XG2HBT7XU,Ray Bellotti,20121215,23,4.869565217391305,97.30434782608695,10,4,6
A3K43UM7TWLC6K,"Gc ""iPoker""",20040811,26,4.230769230769231,372.1923076923077,44,15,29
A3K4S4M486B9WH,"Ghost ""Think Amazon.""",20050526,35,4.285714285714286,42.08571428571429,67,117,-50
A3K55SHF4MN6RR,Wayne,20070402,31,4.290322580645161,203.0,191,58,133
A3K5NP63E32ZBG,Scarlett Bront,20070927,26,4.461538461538462,152.23076923076923,28,6,22
A3K5XD03GGLNW4,Bryce,20130122,28,4.642857142857143,85.60714285714286,38,13,25
A3K6B2P3KV0OCC,"Timothy S. Shropshire ""'rangsmith""",20101003,31,3.4516129032258065,54.45161290322581,8,21,-13
A3K6MC8NUGAY7C,chinee,20090422,23,4.217391304347826,141.7826086956522,172,17,155
A3K6VZ6XT8PZAU,Amazon Customer,20110603,38,3.973684210526316,168.78947368421052,90,25,65
A3K6Z80X3DK8OV,"Steven S ""Steven""",20120430,22,4.681818181818182,81.36363636363636,12,2,10
A3K8QGDWJ22EOX,"P. To ""PTo""",20041005,33,3.393939393939394,105.36363636363636,43,9,34
A3K91X9X2ARDOK,"Terrence A. ""cinemaparker@twitter""",20070114,57,4.315789473684211,244.35087719298247,146,50,96
A3K93OWHKHGI9V,"Water Monkey ""Marc B.""",20030424,34,4.0588235294117645,225.11764705882354,84,39,45
A3KB5OXRFFC31L,R D,20130107,22,3.909090909090909,39.13636363636363,13,10,3
A3KBUTSIFX0K9V,Steve,20110117,21,4.571428571428571,608.4761904761905,181,34,147
A3KCETSIJNOK56,"Amodeus1971 ""Amodeus1971""",20090122,50,3.94,204.94,71,38,33
A3KCKECEO3E2AN,K. Dubose,20080813,52,4.0576923076923075,354.9807692307692,140,31,109
A3KCWQMEOLRC2U,"R. Richardson ""Home Theater Geek""",20070311,24,4.375,235.0,69,7,62
A3KDO3XV0MK1GX,Go Blue 99,20080625,42,4.333333333333333,250.28571428571428,188,28,160
A3KE1AQ22CPJVL,J-John.,20130908,30,4.1,48.96666666666667,6,2,4
A3KEDOP6R6FDU5,James Schmeling,20131029,21,4.857142857142857,69.42857142857143,6,2,4
A3KELEDAQNR9L3,"Daniel Garcia ""DeadPlasmaCell""",20061205,24,4.708333333333333,153.16666666666666,48,12,36
A3KEZLJ59C1JVH,Melissa Niksic,20040408,31,4.193548387096774,148.06451612903226,180,55,125
A3KF2K1ZMAZSX4,Terry Schoenberger,20071002,25,4.28,104.08,290,32,258
A3KF79AODCE7YE,"J. Oh ""aletheia67""",20080417,30,4.7,299.2,170,26,144
A3KFB0U7M82L96,"Earl Dunbar ""Zuikoholic""",20041229,26,4.230769230769231,209.15384615384616,30,4,26
A3KGD2WT1V5MW,Amazon Customer,20090409,29,3.7241379310344827,45.241379310344826,7,8,-1
A3KHRW6ZC2EQIL,"Erik Okerholm ""some normal guy.....""",20110530,27,4.37037037037037,83.51851851851852,51,8,43
A3KIHIO3VQF7T8,Fletch,20110501,26,4.346153846153846,52.53846153846154,35,16,19
A3KIRC8DQF0Y9Q,David Zhang,20100510,21,3.9523809523809526,123.28571428571429,83,13,70
A3KKA2GYA0J7LB,Morphling,20121015,31,4.193548387096774,348.1290322580645,32,7,25
A3KKM0T1KY42HA,Sky,20060706,31,3.935483870967742,474.7096774193548,665,100,565
A3KMYHC1E69P32,E. Orgon,20040303,39,3.8461538461538463,115.15384615384616,141,34,107
A3KN1J914HP91Q,Albert M.,20110219,26,4.115384615384615,42.26923076923077,8,1,7
A3KN4D8MSPAJ3E,,20121226,26,4.615384615384615,109.84615384615384,11,1,10
A3KNGMX2RVQG91,Richard R,20070109,58,4.362068965517241,62.60344827586207,47,9,38
A3KO6JEVS1FJ8X,"Little Tank ""LT""",20090529,28,4.535714285714286,99.57142857142857,10,3,7
A3KOASATK1KTI,Amazon Customer,20060113,21,4.380952380952381,194.38095238095238,46,14,32
A3KOWOXEUEHJX8,"Richard Anderson ""Rick Anderson""",20130117,22,4.636363636363637,43.31818181818182,4,30,-26
A3KPIYXAGWMQXY,Nate,20120804,21,4.809523809523809,40.04761904761905,3,2,1
A3KPJ1MOGTZVGC,Catfish Kozmo,20070323,35,4.057142857142857,230.68571428571428,63,24,39
A3KRBCYGXC9CG3,"foiegras ""foiegras""",20061127,26,3.6153846153846154,248.96153846153845,74,13,61
A3KT5LA620QTKD,"skisby ""skisby""",20040112,21,3.4285714285714284,124.23809523809524,125,15,110
A3KTDW3IRFBEN9,Ivo,20110526,32,4.71875,86.1875,20,4,16
A3KTWUXXB8KKC7,Epsilon Delta,20030402,43,4.0,144.69767441860466,908,139,769
A3KVCHF2QXJKN5,"Ryan Grattan ""Rumble and Roll""",20121105,22,4.2727272727272725,170.22727272727272,18,4,14
A3KVUJCK7Z6SZP,,20130725,22,4.2272727272727275,207.36363636363637,48,34,14
A3KWLE7H7QYUOJ,"leo clark ""bob""",20110127,26,4.576923076923077,30.0,18,1,17
A3KWRHCD3IVZES,WC,20111212,45,4.711111111111111,87.64444444444445,8,3,5
A3KWZ941YN0KXA,value hunter,20090912,21,4.285714285714286,76.04761904761905,41,3,38
A3KY5RJPX71812,easye,20121212,21,4.761904761904762,33.42857142857143,8,3,5
A3KYGQI7G4NJPY,Amazon Customer,20040629,22,3.272727272727273,53.36363636363637,62,28,34
A3KZ7OH4VRL048,Jonathan,20080726,53,4.30188679245283,258.811320754717,170,38,132
A3KZCNV1N8R9GC,diljs,20050418,42,4.166666666666667,251.23809523809524,3546,55,3491
A3KZEGBTPH6MMF,"Lucy Cat ""Mandy""",20081122,48,4.270833333333333,234.27083333333334,280,43,237
A3L12XQ9R21O44,DeP,20070206,24,3.9166666666666665,140.33333333333334,249,305,-56
A3L1QODR4QR8I6,Stephanie Jimenez,20130729,27,4.888888888888889,55.851851851851855,11,6,5
A3L1VJMHFWONCB,"CDP ""Double00Buck""",20091213,94,4.361702127659575,103.40425531914893,38,28,10
A3L2HNTHFMTPFT,"Woodlandsman ""Woodlandsman""",20021221,37,3.4864864864864864,202.2972972972973,201,44,157
A3L2KYOYDWSRPL,Lostplanet,20090507,22,4.0,34.5,12,19,-7
A3L2UZLJZKDUTY,Trust Me,20100126,37,3.7567567567567566,180.27027027027026,30,9,21
A3L38AZQUJP7XR,Jon Almada,20051230,23,4.956521739130435,287.3478260869565,274,17,257
A3L3TRT4S57C7K,"David Scott ""David Scott""",20081007,22,3.9545454545454546,115.0909090909091,35,14,21
A3L4UZ6RU66UUL,D. Stevenson,20080623,24,4.25,104.95833333333333,22,5,17
A3L5TGXVJJQUMP,MarkUS,20081217,25,4.04,137.44,170,19,151
A3L60UJZQ0O0R5,D. Schwartz,20030323,34,4.529411764705882,74.26470588235294,72,3,69
A3L6L5O89JTX2T,"M. Gehret ""G-Man  Colorado""",20070524,78,4.5256410256410255,117.97435897435898,195,26,169
A3L7I2TS2WX7MA,Arthur Robinson,20130201,23,4.565217391304348,38.91304347826087,26,9,17
A3L9E0YI7C5G0W,P. Collins,20050911,104,4.326923076923077,62.53846153846154,85,51,34
A3L9WR7LGB4ZZV,KSArnold,20130110,31,4.935483870967742,57.225806451612904,6,3,3
A3L9Z3PULP7PCV,M. Robinson,20121231,25,4.32,48.0,3,0,3
A3LB1B61S50FEK,TedW,20110201,33,4.818181818181818,69.6969696969697,14,5,9
A3LBQDLXFQ7GWX,Shaina T.,20121110,22,3.727272727272727,40.90909090909091,4,5,-1
A3LDAG4FVWGCNT,"Amazon Customer ""Mr. Ed""",20101114,26,4.0,163.0,72,13,59
A3LDFTSXU3UPBO,Tim &#34;Timdiana&#34; Dunn,20121206,52,4.980769230769231,68.57692307692308,34,18,16
A3LDHTZQQXXKS3,I. Clements,20071225,28,3.5357142857142856,163.03571428571428,81,13,68
A3LDLV1GWQJLEQ,"eric talerico ""Greenmanwest""",20070612,59,4.677966101694915,165.8135593220339,203,26,177
A3LDPF5FMB782Z,Alan  Houston,20071015,59,4.067796610169491,358.7457627118644,871,29,842
A3LEV82KANJVZL,JoeRod,20080705,25,4.36,84.16,88,38,50
A3LGT0FSQ3IDJO,,20081206,21,4.714285714285714,63.142857142857146,5,5,0
A3LGT6UZL99IW1,"Richard C. Drew ""Anaal Nathra/Uthe vas Bethod...",20020216,245,4.228571428571429,260.16326530612247,2276,236,2040
A3LH77PBDFEO3F,"G. E. Williams ""Nunah""",20070319,43,4.8604651162790695,142.90697674418604,70,36,34
A3LHGVJKZ0KH9X,adamjive,20111017,21,4.285714285714286,96.0,183,14,169
A3LI50AX5WYICE,"Bg Boyd ""BGPhoto""",20130102,24,4.416666666666667,51.625,3,2,1
A3LIC994TP9I19,"Amazon Customer ""pablo""",20071003,21,4.095238095238095,530.7142857142857,454,37,417
A3LIOQ6M991VBX,nikki,20111012,29,4.241379310344827,46.44827586206897,5,12,-7
A3LJ83ASHLCLVL,Cindy,20120206,25,4.44,46.04,6,3,3
A3LKJ0Y9WPTD49,Ben Myers,20140705,36,4.666666666666667,30.055555555555557,10,12,-2
A3LKN9GND01EWJ,ManiS,20080326,32,4.0,223.6875,387,40,347
A3LM2YCDD8HR7G,BB,20090504,31,4.32258064516129,99.93548387096774,23,4,19
A3LMPD1ZQTWOC4,AmazonLover,20030214,29,4.068965517241379,160.44827586206895,597,47,550
A3LMS2UO0ESHX5,Albert J. Valentino,20040920,26,4.846153846153846,450.34615384615387,609,36,573
A3LN0W2BNVZX3A,Kwok Ng,20060126,21,4.380952380952381,144.8095238095238,116,13,103
A3LNKX22ZWRHUA,z,20110202,31,4.419354838709677,97.61290322580645,67,22,45
A3LNVP9DGN46FB,"dwf ""computer guy""",20061109,23,4.478260869565218,89.3913043478261,10,5,5
A3LOAQX4DVQPCS,"Southernreign ""SR""",20110803,36,4.75,119.80555555555556,122,18,104
A3LOC24GCZBZ0N,J. Gilbert,20091228,22,4.545454545454546,62.5,5,2,3
A3LP6E8DEEKAJ7,Duane,20120503,31,4.774193548387097,33.58064516129032,4,1,3
A3LPL35P7FH78Y,Marie Daniels,20111108,76,4.868421052631579,80.17105263157895,211,23,188
A3LPV7RA8ONDC5,"Ernie Beckley ""Quality will be remembered lon...",20031028,23,3.869565217391304,146.2608695652174,48,9,39
A3LQ3LQ75K38MN,"Paul Ulrich ""AMERICAN CITIZEN""",20110618,22,4.2727272727272725,105.86363636363636,2,8,-6
A3LQI6DLFEXOVJ,BobbyB,20130620,45,3.8666666666666667,104.17777777777778,28,19,9
A3LQQQTERW2XRP,"Harish &#34;Engineer, Photographer and Electr...",20070115,23,3.869565217391304,270.95652173913044,46,9,37
A3LQUEB84IR3VO,Sam,20091023,52,4.461538461538462,75.0,21,16,5
A3LR47S4I7Q0NS,John Doe,20080605,26,1.6923076923076923,55.96153846153846,103,60,43
A3LSEIG2PIJYBL,"desertfox ""desert fox""",20101124,39,4.230769230769231,93.58974358974359,29,12,17
A3LT90XMQ0ZJM7,Tamara Ching,20101225,28,4.928571428571429,43.17857142857143,5,2,3
A3LUXWL4QZO91,"Tuan A. Vu ""hqbabie3""",20071124,28,4.142857142857143,155.39285714285714,39,16,23
A3LVTATM6TO27B,Amazon Customer,20050730,34,4.029411764705882,229.2058823529412,60,13,47
A3LW1N4P1VIZFI,golf4278,20101130,27,4.481481481481482,50.51851851851852,10,5,5
A3LWC833HQIG7J,austin_Larry,20010324,108,4.361111111111111,413.85185185185185,1374,97,1277
A3LWP3A64W9Y9N,Dan C,20061103,25,4.08,89.24,32,18,14
A3LWV4B2ZTBDQ0,Camman,20110429,36,4.083333333333333,34.388888888888886,16,17,-1
A3LXE6P0ITX1R9,C. Scheck,20071119,21,3.619047619047619,73.71428571428571,72,31,41
A3LYAEH6HDDO24,JStewart82,20110929,24,3.625,35.916666666666664,4,2,2
A3LYRF8UZ0W182,"oleg ""oleg106""",20051213,30,4.133333333333334,100.93333333333334,440,55,385
A3LZ00UXN4FYVF,Richard Allen,20121222,24,4.5,43.083333333333336,5,0,5
A3LZ604I77MS6O,PJ1,20100723,26,4.384615384615385,241.5,73,7,66
A3LZ710NCZ8EBI,"FunkeeChild AKA Jose Mateos ""J Dealio""",20070228,25,4.4,93.64,31,6,25
A3LZA698SQPCXE,"Trevor L ""God is on the side of the army with...",20030606,78,4.397435897435898,183.26923076923077,587,98,489
A3LZEFHIYZ1FGA,Sajid Ansari,20091213,21,4.142857142857143,248.04761904761904,82,40,42
A3M1BNMWE8A633,"Kevin Hudson ""Kev50027""",20020808,22,4.0,183.86363636363637,84,35,49
A3M1F7BNER0SN5,CrlMac1,20090426,23,3.782608695652174,152.2173913043478,56,14,42
A3M1PLEYNDEYO8,"G. Thomas ""Tom""",20080201,21,4.619047619047619,99.76190476190476,41,6,35
A3M2O06MCHJG18,"MiddleAgedReviewer ""M_A_R""",20081203,21,4.190476190476191,302.3809523809524,100,8,92
A3M2TMPK88UCSR,Mark,20111020,30,4.066666666666666,240.43333333333334,152,42,110
A3M2XWZ7SMFBS1,"Matthew Coenen ""Ah. Books.""",20100830,35,4.057142857142857,178.0,189,28,161
A3M48SSAOTBSMW,"L. Rapoport ""lenrapp""",20081206,23,4.217391304347826,94.26086956521739,6,2,4
A3M6FSDG784SXG,Randy,20071030,27,4.2592592592592595,89.29629629629629,21,7,14
A3M6TSEV71537G,Sibelius,20080221,48,3.8541666666666665,248.54166666666666,203,43,160
A3M78605OXJY8P,Brian K.,20100311,22,4.2272727272727275,226.77272727272728,54,9,45
A3M78642QA852V,"R. Sarma ""rssarma""",20060227,27,3.962962962962963,314.81481481481484,215,34,181
A3M7BCQKSQAK4L,"Sally ""Sally""",20110607,74,4.27027027027027,205.1891891891892,298,41,257
A3M7R4PD0FEPUB,"T. K. Paul ""imatyak""",20050130,46,4.369565217391305,165.91304347826087,86,20,66
A3M82NO6OU1FHS,N. DiPasquale,20130713,46,4.326086956521739,85.23913043478261,45,3,42
A3MAQJLQNWNMX0,Ashwini Aragam,20031231,22,4.136363636363637,355.3181818181818,209,12,197
A3MAT1NQF6UC4O,Kayla,20131001,30,4.266666666666667,51.666666666666664,2,1,1
A3MBTVX9FJQU2S,rockinwaggy,20100713,27,4.2592592592592595,93.74074074074075,16,1,15
A3MBW88G1VLND5,"Patrick Maraj ""If you want it, just buy it.""",20090120,22,4.2272727272727275,107.0,29,11,18
A3MCIAFO37VH14,"2-Stage ""2-Stage""",20060226,35,4.742857142857143,78.54285714285714,57,5,52
A3MD21R28F1OZI,English_Wolf,20090814,26,3.576923076923077,63.61538461538461,34,26,8
A3MDA891A1EPT8,"Chris Winchester ""mikeystoyz""",20100328,38,4.5,154.1315789473684,61,30,31
A3MEEWZZQ890YB,Brandon,20120430,21,4.428571428571429,52.61904761904762,8,6,2
A3MFF3HWX2TB60,DR-J-J,20100131,28,4.071428571428571,269.2142857142857,1037,92,945
A3MFORLOKIOEQY,Amazon Customer,20080403,91,4.615384615384615,484.27472527472526,751,74,677
A3MFU0GVZUVH3K,"Betty L. Dravis ""BETTY DRAVIS, author/reviewer""",20071214,30,4.833333333333333,195.53333333333333,74,24,50
A3MG41TQBWVCT,Pyro.Man,20131231,21,4.380952380952381,72.52380952380952,3,2,1
A3MGPW01PY4T0G,Dal,20130319,24,4.5,40.625,9,2,7
A3MHEGH6EIS5ZU,S. Hamilton,20070715,21,4.333333333333333,105.57142857142857,15,1,14
A3MHGA6BJJ7P27,"W. T. Hoffman ""artist and musician""",20100615,23,4.608695652173913,523.9130434782609,92,26,66
A3MJ1OH04JQNQF,Js Banks,20100411,24,4.416666666666667,161.375,48,7,41
A3MJ3YYO1AMNRO,"Michael Epstein ""scienceguy51""",20091126,29,4.482758620689655,50.310344827586206,61,9,52
A3MJR0F0NUWJL7,Steven,20130415,30,4.466666666666667,80.86666666666666,8,2,6
A3MJTC00XJWGBF,James A. Keenan,20100315,21,4.428571428571429,136.38095238095238,24,8,16
A3MJXNJJLPYD76,DW1,20130608,24,4.0,31.416666666666668,2,4,-2
A3MJYQFHRYLUUB,five times the cat,20040306,32,4.15625,246.21875,119,18,101
A3MK4MGSU22GR,"TaosGuy ""Taos Guy""",20070913,24,4.958333333333333,104.29166666666667,90,31,59
A3MKEIRB9TJ0WJ,Amazon Customer,20070813,25,3.96,176.84,92,15,77
A3MLKJ1HHA2SX0,Robert L. Stinnett,20070106,21,3.619047619047619,335.42857142857144,153,13,140
A3MLSY6VS7AB8O,J. S,20080606,41,4.170731707317073,66.78048780487805,68,31,37
A3MMDEO32T3G26,Reuben A. Ware Jr.,20100730,25,4.76,52.88,2,0,2
A3MMJEMXBJOJ8H,Carlgo,20060226,40,4.4,464.3,646,71,575
A3MMR2WDKAK0PA,TEVA NOVA,20030610,57,3.3684210526315788,118.42105263157895,290,391,-101
A3MO8ABHF30P3H,Maros,20070120,25,4.16,132.92,43,12,31
A3MPWONT80G4RQ,"Robyn Swaim ""robynthetexasvamp""",20070610,24,4.958333333333333,155.83333333333334,23,0,23
A3MQ15651KGVLJ,Rick L. Parrish,20060217,85,4.4941176470588236,183.18823529411765,209,85,124
A3MQ3FGEV8MECC,Joe D.,20100414,23,3.130434782608696,178.56521739130434,185,41,144
A3MQAQT8C6D1I7,AverageReviewer,20050416,56,4.892857142857143,359.17857142857144,1494,95,1399
A3MR8LV3BK9L68,C. Brillhart,20090111,28,4.642857142857143,47.642857142857146,9,0,9
A3MU33YJNP2FNB,Dufus,20070313,24,4.333333333333333,95.0,182,20,162
A3MU5O1170B3LB,R. L. Frank,20070321,38,4.7368421052631575,128.5,260,29,231
A3MU9G6YWKTGTA,Cary L. Brown,20100130,40,4.35,590.0,630,42,588
A3MUO47CT6EQF8,Real Raleigh Reviewer,20100402,21,3.6666666666666665,511.0952380952381,841,45,796
A3MUSWDCTZINQZ,"Ulalume Jones ""Creative Gal""",20091006,69,4.2898550724637685,87.3768115942029,19,22,-3
A3MUYMIXK4CR07,Grmcrkrs,20130828,23,4.826086956521739,31.82608695652174,4,3,1
A3MVMPFBN1RFFV,M. H Shamp,20031107,23,4.434782608695652,228.0,261,27,234
A3MWP39R0W9TQX,"Heather W. ""heartful_home""",20100121,21,4.523809523809524,212.42857142857142,871,67,804
A3MY4TZI3R7A1L,"Noach Klein ""Video Editor""",20091129,28,4.214285714285714,36.535714285714285,7,10,-3
A3MYSRHD2F2QD0,Jeremy Thomas,20131205,23,4.173913043478261,29.695652173913043,0,0,0
A3MZZ9W0WJP01B,"Capt GH ""Capt GH""",20090828,21,4.857142857142857,100.0,40,7,33
A3N0P5AAMP6XD2,H B,20110418,76,3.6710526315789473,260.4868421052632,250,164,86
A3N0Z0QVRS1PP9,"Gringo A La Carte ""Marv""",20091111,33,4.454545454545454,186.45454545454547,34,18,16
A3N1BZ7190CI3J,Mark H,20130619,22,4.954545454545454,34.13636363636363,3,1,2
A3N27L13CWJ9HY,D. R. Smith,20070131,22,4.318181818181818,73.77272727272727,6,7,-1
A3N2DZA2PXRRXC,"Scott B. Husted ""Informational Barista""",20090430,28,4.857142857142857,74.0,25,3,22
A3N3CNQD0L3HX9,David A. Franklin,20050802,21,3.9523809523809526,187.04761904761904,55,31,24
A3N3HEPKYWZBEZ,miles2121,20110418,24,2.7916666666666665,98.45833333333333,54,13,41
A3N3NSTEAB5S2K,J. Lofing,20111216,28,4.678571428571429,102.03571428571429,37,3,34
A3N4CUW4UYC9I3,MH,20070509,21,3.857142857142857,185.9047619047619,58,9,49
A3N4I2KRSMACW8,NotaSecondTime,20080105,54,4.018518518518518,244.33333333333334,1036,251,785
A3N4VTNFPMTHEF,James Lin,20020727,114,4.298245614035087,253.41228070175438,1122,89,1033
A3N5S2CCIXYOUB,Mr.D.,20120816,22,4.818181818181818,55.31818181818182,2,2,0
A3N6L7HBSPZ1JL,Amazon Customer,20120618,22,3.590909090909091,61.59090909090909,6,7,-1
A3N6VBAVGRAKP4,"7 ""7""",20090313,24,3.125,666.7916666666666,697,176,521
A3N8O68DOEQ2FE,"Harold P. Fultz, Jr.",20101021,45,4.7555555555555555,30.066666666666666,4,3,1
A3N9946VS9D0CC,"Amazon Customer ""bnjroo, planet earth, sol sy...",20110915,22,4.454545454545454,115.68181818181819,9,3,6
A3N9GHCDGGP7QA,NotOnline,20111209,26,4.653846153846154,111.15384615384616,75,17,58
A3N9TOPHBENB9I,S. Harrison,20070926,24,4.041666666666667,335.9166666666667,664,31,633
A3NA11HX8HY85O,D,20111215,22,4.363636363636363,55.31818181818182,9,2,7
A3NAS03A35FAQ3,Chris I,20080813,22,4.5,140.36363636363637,93,5,88
A3NCIN6TNL0MGA,"M. JEFFREY MCMAHON ""herculodge""",20040831,74,4.5675675675675675,217.95945945945945,5462,288,5174
A3NCSQ3UE9X7U5,randyc,20111212,24,4.375,61.625,23,3,20
A3NDUBKYPI47N2,LawyerMom,20081027,38,3.973684210526316,287.39473684210526,110,31,79
A3NEAETOSXDBOM,Stephen M. Charme,20040411,151,4.516556291390729,341.7748344370861,3976,73,3903
A3NEDHBYWLOWWG,Thursday Trader,20050312,24,4.75,107.0,551,61,490
A3NG7X4APIV649,Sam I Am,20060207,74,3.9864864864864864,186.3783783783784,195,64,131
A3NGABXDIB0POU,Tactical Keychains,20140706,43,4.604651162790698,10.953488372093023,1,3,-2
A3NGOG8Z78AZSD,Edward Barnett,20040628,47,4.0212765957446805,432.93617021276594,424,25,399
A3NGX35C4OQNBV,Glenn C. Martinet,20080819,23,3.9565217391304346,69.52173913043478,44,7,37
A3NH30B70DU5IH,"jlf ""jlf""",20061109,22,4.090909090909091,41.72727272727273,8,3,5
A3NHUQ33CFH3VM,Citizen John,20091120,183,4.442622950819672,123.50273224043715,364,30,334
A3NJIIDIXLQFIN,Siffert,20060128,29,4.551724137931035,89.96551724137932,21,10,11
A3NKQDP0UY5ZMB,"M. Bentley ""mrb186""",20031009,23,4.478260869565218,176.47826086956522,262,13,249
A3NKRH3TJ4DPVI,Book Glutton,20021109,66,4.590909090909091,214.9090909090909,79,10,69
A3NKYCPMP07994,Faisal,20130119,33,4.757575757575758,33.03030303030303,3,2,1
A3NKYJCQBSA4LU,Kamel,20110406,22,4.2272727272727275,332.22727272727275,40,8,32
A3NLPQUOLT45U2,"Kenneth L. ""Kenneth November""",20101204,31,4.354838709677419,203.58064516129033,118,21,97
A3NM01NNPL5JZL,Amazon Customer,20060411,30,4.066666666666666,350.6666666666667,86,7,79
A3NM0RAYSL6PA8,"Maine Writer ""David""",20020209,31,4.419354838709677,259.0,2125,180,1945
A3NM1MT3Q2FHXV,S.E. Poza,20050705,44,3.9545454545454546,397.5681818181818,160,47,113
A3NMSAKV0RRIDD,Jacob Lo,20111012,22,4.409090909090909,27.318181818181817,2,6,-4
A3NNMTEEEFAEED,cutterjohn,20120702,21,4.190476190476191,208.8095238095238,11,80,-69
A3NNTYXX1O8D61,L. Wilson,20100702,27,4.555555555555555,57.592592592592595,20,5,15
A3NO9NOCWLFAAJ,"Susan ""Bubbasu""",20071228,27,4.074074074074074,147.66666666666666,30,28,2
A3NOBH42C7UI5M,"Amazon Customer ""kepela""",20030528,82,3.8292682926829267,174.1219512195122,612,120,492
A3NOGMLY0GFOJY,Thomas S,20100216,27,4.37037037037037,189.22222222222223,355,25,330
A3NP7IIMI89BD5,"Amit ""aj""",20100522,22,4.181818181818182,48.90909090909091,9,5,4
A3NPETMZXGIG65,C. Dooley,20100817,22,4.681818181818182,146.22727272727272,11,3,8
A3NR08HZ9C4BYT,jirobinson13,20100930,25,4.6,47.84,2,1,1
A3NRDPXTD1375S,Charlie,20090913,27,3.7777777777777777,168.85185185185185,78,20,58
A3NRIS6JOJ2R8K,Home Reviewer,20080309,34,4.5,98.76470588235294,8,7,1
A3NSTC73P8F9P3,"William D. Pierce ""The State of Jefferson""",20090222,29,4.620689655172414,109.58620689655173,81,8,73
A3NU9S8PXCEA5Q,John Puopolo,20120529,26,4.615384615384615,100.65384615384616,12,5,7
A3NUYN9LX5W56V,"Wilbur Lidzy ""GuateStudio""",20070611,29,4.827586206896552,72.44827586206897,24,9,15
A3NVI9PGM1RCO1,"PC Junkie ""Pc Junkie""",20060222,30,4.633333333333334,225.76666666666668,178,10,168
A3NVKSXOEGADOS,C,20081018,27,4.444444444444445,90.11111111111111,242,15,227
A3NVRBHJERYH9V,decibillionaire,20120109,22,3.3181818181818183,126.4090909090909,19,18,1
A3NVZTGPORNPRW,B. Pearce,20080914,58,4.431034482758621,153.41379310344828,419,42,377
A3NW4P85QUUAEA,George Cheng Jr.,20130806,27,4.962962962962963,45.77777777777778,7,2,5
A3NX29Z4TQK3HM,"JOSEPH ""Joseph Brown""",20071211,35,4.742857142857143,209.77142857142857,50,5,45
A3NX8BO569AGQZ,JJP,20080526,29,4.655172413793103,101.20689655172414,122,6,116
A3NXJDNTQK2YJL,"Andy in Washington ""Andy""",20050605,51,3.8627450980392157,436.1372549019608,517,57,460
A3NXN2XK3S4HN1,"Mark ""Mark""",20081120,31,4.516129032258065,65.48387096774194,29,3,26
A3NXYWHH1WDHKT,BuLy34,20111010,28,4.535714285714286,34.392857142857146,5,1,4
A3NYBI5VMVEEIK,303 GearGuy,20101210,47,4.276595744680851,56.97872340425532,23,10,13
A3NYZB4V55CZIM,,20120412,33,4.181818181818182,122.03030303030303,6,3,3
A3O0CDE35GWWCC,BluegrassPicker,20100121,30,4.433333333333334,183.03333333333333,41,1,40
A3O0P7XGZO3COI,Amazon Customer,20120710,21,4.666666666666667,67.52380952380952,4,2,2
A3O12K1YQR2FZ9,steakburger,20110716,39,4.358974358974359,32.15384615384615,5,8,-3
A3O1DI7R4INCNX,R. Jackson,20100930,44,3.840909090909091,103.45454545454545,225,81,144
A3O1FVLUD9X1XC,Zach,20110322,42,4.523809523809524,200.57142857142858,59,17,42
A3O2C8D38BPEZX,Brad Bortner,20030131,41,3.8292682926829267,129.390243902439,250,50,200
A3O2NS5RJ7OU5G,Joe Wood,20090815,46,4.478260869565218,217.65217391304347,179,12,167
A3O4OIBCML0683,Chris M,20090328,45,4.288888888888889,168.9111111111111,98,15,83
A3O4OL81Z48AVF,RamyG4c,20100727,23,4.086956521739131,63.95652173913044,47,5,42
A3O56ZO3EU9SVJ,John Johnson,20010709,34,4.5588235294117645,63.6764705882353,5,7,-2
A3O583ZUFQ3QGB,Amazon Shopper,20120919,26,4.153846153846154,189.19230769230768,35,28,7
A3O5ARNY18JR9,mark dickhaus,20130101,28,4.142857142857143,55.107142857142854,10,4,6
A3O5ASFUXC32UA,Marx Lives,20061008,42,4.333333333333333,114.16666666666667,124,43,81
A3O60C5513YYD6,H. J. Spivack,20041101,38,4.052631578947368,446.44736842105266,673,49,624
A3O64H3WE8HHK0,HSPevolved Archer,20070730,27,3.7777777777777777,293.74074074074076,83,23,60
A3O75UULU0XR60,Value Buyer,20101114,25,4.56,31.12,4,1,3
A3O7IOU2BVRVZ9,Daniel Kowalec,20090404,21,4.523809523809524,48.61904761904762,4,2,2
A3O8Z6IZ0VU3BB,"Laura B. ""Kindle Fan""",20071129,22,4.318181818181818,150.54545454545453,127,22,105
A3OA4DV4L81N1D,"P.K. Frary ""Gochugogi""",20060122,149,4.570469798657718,426.4161073825503,918,39,879
A3OB2311CVP0KX,"S. Bashor ""snowwillow20""",20090209,22,4.7727272727272725,66.54545454545455,12,8,4
A3OBP99ZV5TG6C,Jay,20040922,29,4.827586206896552,115.10344827586206,165,18,147
A3OBZ4F27KV8NO,G. Meredith,20080413,28,4.5,43.142857142857146,15,13,2
A3OC42X7H74D1Y,"J. Friedman ""J-F""",20050907,26,4.076923076923077,337.03846153846155,70,12,58
A3OC93X866Z8TB,Celestialsky29,20090108,32,4.21875,274.1875,40,15,25
A3OCIWPCPXNN0I,"Tetsu Noguchi ""tekkster""",20110404,25,4.28,429.88,177,20,157
A3OEE8468LMYE8,Doug,20110701,22,4.409090909090909,55.27272727272727,5,2,3
A3OEIPLU13BEW2,funbear,20060721,41,4.219512195121951,313.9268292682927,596,43,553
A3OEWQXYMIXYVI,monoblocks,20060715,22,3.227272727272727,470.1363636363636,275,26,249
A3OFJES10PZGEH,SN,20020219,41,4.365853658536586,88.82926829268293,98,13,85
A3OFWBLNJV4QNY,"Get Back Jojo ""manard""",20060105,36,4.5,153.94444444444446,65,9,56
A3OG4Z1C10GGDW,P. Lamarine,20080119,21,5.0,102.52380952380952,23,0,23
A3OG85XSUW19VK,"Amazon Customer ""RG""",20080213,32,4.09375,213.03125,405,63,342
A3OGPCWAPUJQY,Tad A.,20070926,26,4.269230769230769,168.34615384615384,163,11,152
A3OHADG98OLCAB,KL,20090115,24,4.291666666666667,170.625,66,8,58
A3OHV1J3JGC56O,"Juan Carlos Nunez ""Kickman""",20071118,31,3.7096774193548385,48.516129032258064,14,7,7
A3OIE7IE9LTPJG,GatorMan,20080128,32,4.25,44.53125,69,14,55
A3OIMUR42XIOFQ,David Field,20051204,49,4.63265306122449,379.9183673469388,177,52,125
A3OKH5G69MS8D9,"JRH ""j5094""",20060628,39,4.153846153846154,211.66666666666666,177,43,134
A3ONE2VJCDI5GZ,William Lau,20010318,24,2.5,212.16666666666666,515,93,422
A3ONII9X9JLI16,"ZenReader ""ZenReader""",20080503,25,3.56,171.84,40,13,27
A3OO4WIO4SKD55,I'm hungry. feed me,20050504,26,3.769230769230769,111.6923076923077,133,21,112
A3OOQH73VQ97VN,"Jem ""Microsoft""",20070620,29,4.517241379310345,269.62068965517244,154,68,86
A3OOY1YZ6LA9GD,R. Lefever,20070120,22,4.045454545454546,167.95454545454547,74,91,-17
A3OPRKAZ0FMA5H,Michael J. Tria,20110302,28,3.8214285714285716,87.17857142857143,18,35,-17
A3OQL5IVZBB7BJ,R. Baer,20110531,31,4.548387096774194,89.58064516129032,24,8,16
A3OQOIIA2O9I4,Bryan D. Uslick,20040511,26,3.8076923076923075,83.53846153846153,41,9,32
A3ORQG6JQJTTAC,Bryan B,20110814,26,4.615384615384615,78.76923076923077,62,5,57
A3ORSXDMGX21O0,Penacious H,20070325,22,3.4545454545454546,56.04545454545455,15,4,11
A3OSHB0AACYN95,Tom Tracy,20070221,28,4.142857142857143,409.64285714285717,254,19,235
A3OUH3ATL4GO18,"J. Carl Hudson ""KnightSix""",20101231,25,4.16,232.4,116,41,75
A3OUKYWKNCOF0L,Daniel Hoherd,20040107,21,4.0,147.1904761904762,52,12,40
A3OUYFXUOHDGH,slvbeard,20050225,21,4.238095238095238,81.95238095238095,102,15,87
A3OXHEV3U8YOAZ,scout1968,20110322,28,4.678571428571429,44.642857142857146,4,1,3
A3OXHLG6DIBRW8,"C. Hill ""CFH""",20040116,407,4.474201474201474,163.8009828009828,2013,143,1870
A3OXM4NUGQKIQ0,Kula,20070701,38,4.026315789473684,181.6315789473684,176,62,114
A3OY71ZRALZKS0,Jim D. Farmer,20100223,27,3.925925925925926,76.25925925925925,177,19,158
A3OYO7B6SS7QLH,SY,20130122,63,4.0476190476190474,35.714285714285715,13,17,-4
A3OZA8HNJM26DC,Hamlet423,20080906,51,3.7254901960784315,107.70588235294117,190,67,123
A3OZL34OLQJJM9,James P. Garin,20070319,30,4.633333333333334,169.7,184,24,160
A3P0DIE1J0QQ9Y,Philip Holden,20090712,40,4.4,35.575,7,2,5
A3P0Q7OY0SV4CO,spotz44,20090102,22,4.136363636363637,70.45454545454545,54,9,45
A3P1508PZ0UADD,B. Bates,20070112,55,3.8363636363636364,63.41818181818182,165,78,87
A3P3XP70BMBX06,John Dembeck,20121028,44,3.7954545454545454,153.22727272727272,142,22,120
A3P4T1DKRWTL36,Rob W.,20120529,44,4.318181818181818,115.3409090909091,125,11,114
A3P5G64FFNWSWC,SM-NM Catboy,20080103,34,3.9411764705882355,76.29411764705883,34,42,-8
A3P69DTOXII004,Christian De Freitas,20060111,28,3.9642857142857144,128.75,320,48,272
A3P8N3YORM08CA,Jay,20110621,28,4.142857142857143,109.10714285714286,102,10,92
A3P8SSQ21NTZ0C,Cybermed Rick,20100612,22,4.545454545454546,43.77272727272727,37,9,28
A3P8ZDHC7XSKSE,"Ravenskya ""Princess of Horror""",20090728,29,3.689655172413793,259.2758620689655,97,35,62
A3P969K133IDIR,K. Ferguson,20060918,21,4.476190476190476,73.28571428571429,40,21,19
A3P9BN02LLPDPH,Scott Rupertson,20140621,21,4.714285714285714,58.0,0,0,0
A3P9OYUD5RER20,wise1owl,20080325,28,5.0,94.32142857142857,39,2,37
A3PAUB3M715CJC,the Commish!!!,20130403,35,3.6857142857142855,27.485714285714284,7,7,0
A3PAYT2SQY7J3H,"Chet ""Chet""",20081012,26,4.846153846153846,97.03846153846153,54,0,54
A3PBPEFMYAX0CT,"JimD ""Jim""",20050726,26,4.769230769230769,74.65384615384616,67,8,59
A3PBR3QLZFRGZX,John S. Smith,20111113,29,2.896551724137931,92.41379310344827,39,26,13
A3PCEB9ND82AGE,maj71303,20110816,55,4.872727272727273,41.50909090909091,13,15,-2
A3PD8JD9L4WEII,"Bron ""Bron""",20050109,204,4.3431372549019605,418.6421568627451,1689,127,1562
A3PDWA32BAMB2Y,alf randell,20121109,58,4.258620689655173,166.08620689655172,40,3,37
A3PE2YMF9574U7,"Jonathan Stewart ""jonathan_stewart2""",20030927,31,3.4193548387096775,135.06451612903226,366,38,328
A3PEJHC7PRDCG9,"RMPRO ""PhotoBob""",20060309,28,4.714285714285714,94.92857142857143,78,9,69
A3PEN6PH24S5DU,Amazon Customer,20070924,21,4.0476190476190474,368.0952380952381,332,51,281
A3PF5VEKQCHEBJ,Dean,20110426,24,4.333333333333333,102.0,15,4,11
A3PF7CD8W1IF93,Gary X,20050302,21,4.285714285714286,141.0952380952381,67,11,56
A3PFK6FEZ2GKIU,Todd,20110522,22,4.681818181818182,29.954545454545453,6,2,4
A3PG659VPWCT05,JoeyGoSki,20110426,29,4.068965517241379,79.17241379310344,34,56,-22
A3PGE0N774CEXW,Kim,20080420,24,4.708333333333333,320.9166666666667,177,4,173
A3PGGVAY8PKSAY,Xyooj,20110403,26,3.923076923076923,90.65384615384616,34,16,18
A3PGVJF37JSHFO,MysticJaguar,20000804,69,3.9855072463768115,189.95652173913044,142,36,106
A3PIPF1UAVY7IW,"F. Oquendo ""Papo""",20091210,25,4.16,216.76,37,3,34
A3PJJTAKISAFI9,"pamboy ""pamboy""",20070811,44,3.6136363636363638,45.43181818181818,40,44,-4
A3PJZ8TU8FDQ1K,"Jared Castle ""Oregon writer""",20080625,42,4.095238095238095,235.57142857142858,111,34,77
A3PL8UPZK4AZD3,,20130326,40,4.9,122.65,33,7,26
A3PLBAYDL70M9T,KD,20080428,38,4.473684210526316,42.973684210526315,7,10,-3
A3PLMDJWVIIVRY,Jeremy Hall,20070820,25,4.52,99.84,16,0,16
A3PLZLAXNFVNQ0,"GR ""Roadkill""",20111005,39,4.358974358974359,75.84615384615384,58,4,54
A3PMB2CU0U1PSL,D. Brodsky,20041027,26,4.1923076923076925,333.11538461538464,836,80,756
A3PMF6DVKGFCN6,scribe,20110523,21,4.142857142857143,103.14285714285714,14,1,13
A3PNN6W95O5XNV,"M. McFall ""Yay interwebs""",20080720,41,4.560975609756097,397.8780487804878,767,61,706
A3PO2N4C4TVPUM,Razgank,20121115,25,4.08,61.4,12,2,10
A3POO958KE65MS,"Scott Sylvan Bell ""Entreprenuer""",20090318,33,4.818181818181818,191.3939393939394,27,10,17
A3POOQMFOLS1B7,Standingtree,20090606,35,4.314285714285714,83.62857142857143,91,60,31
A3PPLH5DL6DHN7,"G. Coley ""Greg""",20071116,26,3.8846153846153846,61.38461538461539,48,17,31
A3PPO2X5PJE1L9,"Gene Bowker ""Rusted Rail Images""",20100701,50,4.44,122.06,55,12,43
A3PPPYFU3WD5NZ,P. Chebib,20080629,41,4.317073170731708,171.58536585365854,322,39,283
A3PQCUUEF0GVWN,"Mark S. Ring, CPA",20110618,25,4.84,74.04,9,2,7
A3PTW5IV3OJLS0,"J W Bfield ""JWB""",20130519,31,4.419354838709677,42.54838709677419,11,5,6
A3PU3EDJ2FG1AW,JUST-JIM,20100907,50,3.96,101.32,139,37,102
A3PVE6QACV6WRK,Alejandro Au Ma,20060603,23,4.391304347826087,35.91304347826087,25,14,11
A3PW4EWMNEMAEK,"cityToCountry ""wang""",20130115,21,4.666666666666667,71.42857142857143,13,2,11
A3PWC4B7RPPNBP,"Shawn Patrick ""Shawn Patrick""",20120219,21,4.476190476190476,373.23809523809524,16,6,10
A3PWDPQ4B1S7G8,DSLR Shooter,20090814,24,4.208333333333333,42.625,49,5,44
A3PWSAC6ORW33Z,Rodster,20110808,26,4.346153846153846,202.03846153846155,69,18,51
A3PWTTPN2ORIZI,"Gregory M. Spitzer ""Mark Spitzer""",20080607,31,4.258064516129032,84.41935483870968,25,10,15
A3PXICZ0O2H3VO,"John Davidson ""Magic Feather""",20081102,30,4.333333333333333,50.93333333333333,170,76,94
A3Q0D79RQZO91V,,20111230,23,4.304347826086956,25.695652173913043,2,1,1
A3Q1EDCBV2KU8D,Craig Frooninckx,20070629,27,4.296296296296297,88.77777777777777,77,14,63
A3Q1J68QY1MZQ9,Natalie Kilpatrick,20020311,67,4.0,210.5820895522388,105,55,50
A3Q2JMJNMVCGFI,shog,20071025,23,4.304347826086956,115.34782608695652,31,1,30
A3Q30NBLMAY4ZG,Jeff ten Bosch,20051109,23,4.478260869565218,345.04347826086956,775,15,760
A3Q3ICZ7K0RA1V,Carol A. Anderson,20110801,40,3.975,217.0,398,67,331
A3Q4TYJVAM4IRM,Omar Siddique,20030622,121,4.454545454545454,313.12396694214874,2456,113,2343
A3Q5EK9I10Q9YM,Aldenone,20071209,23,3.8260869565217392,92.82608695652173,46,14,32
A3Q6P1AJF2HH68,readyk,20070904,21,4.095238095238095,76.57142857142857,6,12,-6
A3Q6ZPW60CVF2L,AntennaMan,20101005,47,3.617021276595745,198.0,38,91,-53
A3Q7LVUP45XLUZ,Jim K,20070930,25,3.76,69.72,9,6,3
A3Q9BX67GBXRST,V. Dean,20070119,23,4.173913043478261,101.65217391304348,275,19,256
A3QA13W0Y7TM86,"Mike S. ""-Mike""",20080214,33,3.757575757575758,184.0909090909091,102,17,85
A3QAD1BD3NIIO4,"A Taxpayer ""Jerry""",20100330,21,4.095238095238095,190.8095238095238,41,3,38
A3QAO3QBCQF89T,"Network Pro ""cubanomx""",20081109,59,4.254237288135593,109.62711864406779,43,11,32
A3QBHMMDRSC5VY,"M. J. Mccaffrey ""Matt OneLANE""",20000110,21,4.714285714285714,368.0952380952381,594,38,556
A3QBY1KPQC6ZKK,J. Chavez,20100405,24,4.916666666666667,66.25,13,2,11
A3QBYS6X6R03KL,mike892,20090705,35,4.457142857142857,80.71428571428571,32,7,25
A3QC5QE44DTTEL,Aveesh Kumar,20100514,24,4.708333333333333,89.25,16,7,9
A3QCLEQ7F77V6C,"A. Cazarescastillo ""wary shopper""",20091025,29,2.7586206896551726,152.72413793103448,305,114,191
A3QCN8WYG4OG8G,Cynthia R. Peterson,20101227,27,4.666666666666667,118.4074074074074,82,8,74
A3QD59N3M7O7KB,Xina143,20080728,47,4.148936170212766,341.531914893617,241,36,205
A3QDMBKR5XDTH7,Frank R.,20110121,28,3.75,220.5,89,18,71
A3QDMDSANPYGUX,Amazon lover,20120102,40,4.75,33.45,30,16,14
A3QDNQLX1ZR60U,Gabriel,20110921,22,4.454545454545454,60.0,5,8,-3
A3QDPQBJAJC6C,Jaco,20120218,32,4.65625,75.28125,18,0,18
A3QDY9I0CNMD2W,R. D. Collins,20011125,53,4.264150943396227,76.28301886792453,114,22,92
A3QE7ALIPRCQH6,Ricardo Consonni,20041211,21,3.9523809523809526,121.61904761904762,37,6,31
A3QEJ40NQEW36Q,"Desired FX ""Call me Don. It's shorter than Is...",20030305,24,4.208333333333333,303.375,194,23,171
A3QERAVM26ZPQP,Robert Beeman,20111231,44,4.7272727272727275,150.5681818181818,65,3,62
A3QFD0J9ZWFOHX,"Joe D ""RealGuns.Com""",20080217,37,4.162162162162162,126.62162162162163,94,19,75
A3QFZJZ22WHX80,"Geoffrey F. Beneze ""geoffbeneze""",20030319,21,4.809523809523809,143.61904761904762,154,31,123
A3QG1KCB8HB5AQ,"edrock ""edrock""",20091112,34,4.470588235294118,105.41176470588235,25,3,22
A3QGL4W4KC6I45,"Marke R. Weeks ""Marke""",20050718,28,4.357142857142857,81.14285714285714,70,17,53
A3QGSZ5VCUVY8B,J. Tidwell,20080107,38,4.473684210526316,31.55263157894737,9,4,5
A3QIEISBZP4QTV,"Mark E. Baxter ""Inquirer""",20051130,23,3.5217391304347827,141.43478260869566,28,8,20
A3QJA5OHFXJ1JT,kevin c,20050427,42,4.619047619047619,81.5952380952381,126,21,105
A3QJIBCDXJOWZC,Ali Roustai,20080316,24,4.041666666666667,123.83333333333333,448,111,337
A3QJU4FEN8PQSZ,"Grimmy ""Grimmy""",20070425,115,3.7304347826086954,187.87826086956522,137,75,62
A3QKIR8J56EUI1,M. Luu,20080424,56,2.9464285714285716,79.10714285714286,232,423,-191
A3QL2115DZCA62,Ryan,20110525,41,4.609756097560975,88.78048780487805,30,4,26
A3QL857ALV5RCJ,Tamara Thorne,20071209,24,4.333333333333333,250.375,74,19,55
A3QLAOOTFEHCJI,M. Oleson,20101211,22,4.318181818181818,384.22727272727275,58,14,44
A3QLYWNWI8DTKW,russ8128,20071121,22,3.6818181818181817,99.95454545454545,17,4,13
A3QMHEOQCC30A9,BlackDave,20100702,21,4.380952380952381,67.47619047619048,19,1,18
A3QMJMTLJC34QC,"Vincent E. Martin ""Darkbard""",20030112,78,4.294871794871795,709.6025641025641,434,68,366
A3QN0HJ2NJOD8T,Miech,20070607,43,4.27906976744186,163.41860465116278,630,38,592
A3QNDSQJFA360M,glindagoodwitch,20111011,42,4.642857142857143,83.95238095238095,11,13,-2
A3QNHOI7DU4O0V,"afool ""~Pass the wine~""",20121008,23,4.826086956521739,50.869565217391305,3,6,-3
A3QNPC1RBZSNQ1,Scott,20130615,21,4.380952380952381,38.38095238095238,3,0,3
A3QNQQKJTL76H0,buru buru piggu,20060807,159,4.213836477987422,372.2830188679245,1895,194,1701
A3QNURO5S4VMOI,Eliot Khuner,20111223,26,3.8846153846153846,65.61538461538461,8,8,0
A3QNX5KWHDV0GD,"J. S. Cooper ""Conspicuous Consumer""",20050619,77,3.4025974025974026,257.46753246753246,1410,365,1045
A3QQCEQ33O0GJU,RDS,20120411,43,4.651162790697675,36.81395348837209,30,29,1
A3QQGPI3CTV9SX,Stuart Floyd,20080125,80,4.8,226.25,1047,87,960
A3QR5KBKZFDONP,Eskil,20121116,22,4.636363636363637,178.86363636363637,10,1,9
A3QRR8PSCBI07C,JJM,20110206,59,4.491525423728813,47.40677966101695,42,7,35
A3QRW0UJPKIAX7,Grant Fritchey,20070608,53,3.943396226415094,250.79245283018867,269,30,239
A3QS4WWC1LCA6H,"Eric C. Sedensky ""late-to-jazz musician""",20080119,23,4.260869565217392,346.2608695652174,62,13,49
A3QSBA4YOYLAP5,BlueGemenis,20050827,23,4.217391304347826,22.52173913043478,5,9,-4
A3QU3O79AGNWCY,"T.D. Orr ""Dano""",20071025,57,4.245614035087719,109.2280701754386,99,47,52
A3QU89RBYRMR67,ALJ,20120202,27,4.333333333333333,126.44444444444444,133,40,93
A3QUDXLOJTKEP9,"C. BLANCHARD ""Desert Reader""",20060630,62,4.516129032258065,198.9516129032258,261,32,229
A3QUG39UDJOPNB,John I. Gonzales,20061109,40,4.925,141.75,82,9,73
A3QUZG4J7L8D4K,MeteorMagnet,20110306,25,4.36,164.8,25,7,18
A3QVAKVRAH657N,"Orrin C. Judd ""brothersjudddotcom""",20100606,29,4.103448275862069,73.10344827586206,23,24,-1
A3QWNQ2WA7QZYJ,kireviewer,20040916,28,3.5714285714285716,352.89285714285717,1141,95,1046
A3QWYUC0FBK5VY,Cultech,20131126,21,4.523809523809524,38.904761904761905,14,1,13
A3QX0ERX4D03TF,ButterflyGuy,20080311,51,3.764705882352941,157.19607843137254,86,11,75
A3QX14AZKQCLAF,Phillip Ward,20091013,34,4.382352941176471,67.52941176470588,125,19,106
A3QY52JWC79ZLB,kyuumu,20101117,25,4.48,37.36,1,3,-2
A3QZU3A1L17O3M,Lulu Magoo,20050509,30,2.8333333333333335,196.26666666666668,106,41,65
A3R06XBV9VP4IR,"Joseph ""J. R. Stokes""",20120104,30,4.466666666666667,145.43333333333334,19,7,12
A3R19OX24R49WT,N.Yorker,20100512,23,3.3043478260869565,262.2608695652174,115,40,75
A3R19YKNL641X3,"Thomas Duff ""Duffbert""",20031228,115,4.260869565217392,303.24347826086955,192,66,126
A3R1GJY2MY8041,"Lord Rhys ""dog lover""",20110101,46,4.869565217391305,41.5,8,5,3
A3R1SCOWB2F7V7,amazonfan,20060331,25,4.32,107.72,128,24,104
A3R1WFO4KIUQXZ,PhotoGraphics,20050521,131,4.244274809160306,477.03053435114504,1691,132,1559
A3R2J4ICQJMG87,"Elston Hill ""Elston""",20060310,31,3.5161290322580645,70.6774193548387,93,63,30
A3R2M5ABAYL63P,"Shikantaza ""Shikantaza""",20080104,30,4.3,159.26666666666668,75,60,15
A3R33KMESG0XGQ,romevi,20090304,49,4.122448979591836,259.40816326530614,82,24,58
A3R4794K2RVU1S,Danny Yu,20080108,163,4.558282208588957,227.12269938650306,352,50,302
A3R54PYQ2CBXK8,Fabian Ochoa,20130304,24,4.666666666666667,38.291666666666664,21,0,21
A3R56AWX8PRQLP,Indy Reviewer,20050314,29,3.7241379310344827,403.7931034482759,634,39,595
A3R5GTYQ50QVMD,Hannah 3086,20070223,30,3.5,79.1,27,56,-29
A3R5JML5QXRGF3,"Ralph L. Wahlstrom ""writer, teacher - author ...",20101014,23,4.086956521739131,48.82608695652174,18,3,15
A3R7EE1SEQJ728,Tom,20110409,23,4.565217391304348,71.56521739130434,14,46,-32
A3R7RE5O61M112,@homemom,20070528,42,4.214285714285714,333.0,119,43,76
A3R8M455KMAQ5K,H. Jeff Perry,20130118,24,4.458333333333333,87.375,1,2,-1
A3R9GPRGY0BYPQ,"M. Walters ""FineLover""",20130108,23,4.956521739130435,28.782608695652176,5,2,3
A3R9X003XW0LNR,"Deborah Verlen ""Deborah""",20090623,47,4.595744680851064,215.80851063829786,77,21,56
A3RCEXV5769SG8,Albeniz,20051013,34,4.764705882352941,41.76470588235294,48,6,42
A3RE3G5W9BHSZU,"JC Companies, Inc ""James Ray""",20111229,22,4.2272727272727275,35.18181818181818,2,1,1
A3REBHTMMJ9MIB,Historken,20040930,25,4.08,140.6,58,8,50
A3REDIO2K6MLR2,"William Corsair ""Will""",20090529,24,3.75,128.625,92,7,85
A3REK3OFONWB1Q,"Paul M. Provencher ""ppro""",20020807,104,4.759615384615385,202.34615384615384,913,81,832
A3RFOQB5DQEFFD,JeffT333,20101228,21,4.333333333333333,81.9047619047619,12,0,12
A3RG3S43T1TTH4,Ivory,20120205,21,4.190476190476191,69.0,14,5,9
A3RGHO0Q938FRS,Amazon Customer,20080324,67,4.208955223880597,144.1044776119403,173,52,121
A3RGJ1FXOB1ZLL,Norseman,20090111,73,4.917808219178082,188.1095890410959,129,19,110
A3RH6G3UO7LHJU,"Barry Harting ""Chief""",20120116,26,5.0,74.38461538461539,13,1,12
A3RI2C0RY4DHK,Chris,20100504,34,4.5,283.6470588235294,117,20,97
A3RIVD4TCKDE8T,Britt,20101028,23,4.608695652173913,73.6086956521739,9,0,9
A3RK9H16OZ0ZWG,Matthew Eberle,20060130,23,4.565217391304348,95.52173913043478,35,4,31
A3RLXDK4KJ6FI6,Vegas Smitty,20051118,25,4.32,41.88,33,15,18
A3RMEU4GNP60BM,"Sussman ""Sussman""",20111215,42,4.214285714285714,133.35714285714286,81,4,77
A3RML23W0UA5B3,R. Contello,20090206,25,4.92,53.84,39,4,35
A3RNNHT8T1I5ZR,"G. M. Arnold ""Geoff, that is""",20040408,30,4.2,205.43333333333334,276,64,212
A3RNSQICKCN2SX,J. Capobianco,20081209,29,3.6551724137931036,128.20689655172413,72,29,43
A3RNSX8VKC38WA,Jeff Kimble,20100409,32,3.90625,280.03125,429,61,368
A3ROMB95RLWSHV,Clutch,20100803,21,3.9523809523809526,73.33333333333333,23,10,13
A3ROWBJW70FJF,Lance D. Ripplinger,20061207,38,4.631578947368421,195.78947368421052,63,8,55
A3RPDKD7SN7EZY,G. Wu,20061104,22,3.8636363636363638,76.36363636363636,45,16,29
A3RQ2K3WTCOHFU,Oddi S. Diaz,20110301,28,4.785714285714286,27.892857142857142,5,5,0
A3RQNQD090NUN1,Matt A,20120507,33,3.9696969696969697,68.18181818181819,9,1,8
A3RR2P5IS3DGPR,"Dr. M. A. Dixon ""hyper-observant""",20061118,61,4.655737704918033,299.3606557377049,387,55,332
A3RRAIE5VGNS0S,Matt,20000615,25,4.68,64.44,43,11,32
A3RRK9PUUWFZH1,Jason Heiss,20040801,24,4.625,112.70833333333333,95,6,89
A3RTCA21S7BQ3P,"Daren G. Peck ""tingo25""",20091008,36,4.222222222222222,125.27777777777777,60,28,32
A3RTT36S1DRT3K,Amazon Customer,20120106,25,4.56,42.72,24,3,21
A3RUG8QEPN87R,"KentR ""Kentrda""",20050206,24,4.208333333333333,142.29166666666666,269,42,227
A3RUY3TH5FNNDK,"Radical Technoid ""We know we're right, we hav...",20101101,28,4.392857142857143,71.14285714285714,43,11,32
A3RW42FT2Y2SYU,Brian,20101226,35,3.8857142857142857,144.5142857142857,40,16,24
A3RW761LJ7L9CA,FERGON,20110411,23,4.043478260869565,131.7391304347826,9,5,4
A3RXAATBOKBXKZ,"b.deren ""b.deren""",20121225,37,4.756756756756757,56.648648648648646,8,6,2
A3RYHP2OYFJ3YC,The Sarcasticynic,20120121,37,4.324324324324325,89.24324324324324,10,2,8
A3RZOPQ42Q50B1,"Christina Paul ""Live like you MEAN it!!""",20100517,42,4.023809523809524,194.85714285714286,51,23,28
A3S0DBBR693O06,starstruck,20090919,44,4.5227272727272725,88.81818181818181,51,7,44
A3S0EHEIR52HP1,"Mike Brooks ""Tech & Media Enthusiast""",20110621,69,4.782608695652174,40.231884057971016,11,6,5
A3S15YGZ6W6EV2,K. Varraso,20030524,26,4.384615384615385,219.34615384615384,32,10,22
A3S2EMUC1Y9XES,"Robert Agostinho ""Forever Student""",20130111,27,4.962962962962963,65.66666666666667,16,4,12
A3S2FE88P3V0QE,Michael Nguyen,20110928,28,4.571428571428571,115.5,29,4,25
A3S3KU23F9TAAP,Amazon Customer,20130626,22,4.7727272727272725,56.0,24,2,22
A3S3R88HA0HZG3,PT Cruiser,20071223,123,4.747967479674797,382.780487804878,885,71,814
A3S3TGIWP6785Z,"John ""Len""",20110729,30,4.333333333333333,215.06666666666666,37,6,31
A3S3VSXEFXBMRC,Natasha Chernavska,20100516,64,4.359375,57.015625,35,7,28
A3S58J9HNVKP32,"William Shakespeare ""The Bard""",20110520,28,4.107142857142857,314.7142857142857,96,111,-15
A3S5DKSZPFN3CR,Kalibr,20090408,40,4.4,141.65,283,21,262
A3S5EXYZDEBF3K,Brian Morris,20041202,89,3.7752808988764044,395.1011235955056,1339,119,1220
A3S5WYWYKSAI9C,Bradley Olin,20061206,62,3.774193548387097,187.06451612903226,165,40,125
A3S87ZOPB3UM9N,atmj,20001124,27,4.037037037037037,526.3703703703703,291,33,258
A3S9DOTT4Z8JF9,Amozarte,20070827,40,4.125,296.525,213,18,195
A3S9DTM7BCJS21,G,20070510,30,4.166666666666667,93.53333333333333,77,16,61
A3SA7H4B87S4KW,"Michael Montagne ""mike montagne""",20091118,23,4.391304347826087,234.17391304347825,162,26,136
A3SAP1GZDBKENR,Don,20140622,31,4.709677419354839,65.19354838709677,2,3,-1
A3SBL75CSO5PUK,MikeB,20120131,25,4.28,55.84,10,2,8
A3SBYZLMMG9M0Z,sting and the deputies,20110817,21,4.238095238095238,61.42857142857143,6,1,5
A3SC8ZUDU3TR2H,El Geraldo,20060102,22,4.0,251.77272727272728,210,9,201
A3SDDMEUMCN858,Joey Joe Joe Jr. Shabadoo,20120614,34,4.764705882352941,126.32352941176471,13,3,10
A3SDJ70H00OQCJ,JerryWithaJ,20040923,45,4.266666666666667,320.35555555555555,2063,219,1844
A3SGBRA0BQTB7J,rai777,20111217,21,3.4761904761904763,234.76190476190476,115,28,87
A3SGKKMNG4BD0X,Alex L. Shelton,20100204,26,4.961538461538462,67.46153846153847,14,2,12
A3SIFPKLMOY07N,Richard Aubin,20050326,46,4.130434782608695,230.3695652173913,2603,83,2520
A3SIZVHWCTD9Z3,William Grayson,20100325,39,4.538461538461538,99.64102564102564,63,8,55
A3SJJVLA0N6J1V,B.K.,20121205,40,4.7,86.675,14,10,4
A3SKMWPVR5CO1H,Computerdude1032,20081126,32,4.3125,277.84375,207,60,147
A3SL0HA6422W4M,Dale Thorn,20090622,70,4.5285714285714285,1523.1857142857143,174,0,174
A3SLC8F6VIWXIR,"John T. Horner ""jthorner""",20070213,24,4.0,113.125,89,56,33
A3SLIVSNS5DFYF,"SuspiciousAlias ""SuspiciousAlias""",20100409,35,3.914285714285714,91.42857142857143,40,11,29
A3SMD3T0QTN109,Dustin Farahnak,20071129,83,4.397590361445783,288.04819277108436,1794,122,1672
A3SMH6EOXOYNX3,"Bob in Tucson ""Chipper""",20081201,35,4.571428571428571,67.91428571428571,92,71,21
A3SMPC84SOLLL9,Scarrz,20070316,31,4.225806451612903,149.7741935483871,84,25,59
A3SMR4HRFJARSC,christinemm  from The Thinking Mother blog,20080221,46,3.847826086956522,323.9347826086956,103,53,50
A3SO2AGQXXL8LC,Jeffrtey Ankiel,20100206,26,4.653846153846154,28.03846153846154,17,16,1
A3SO8IS08TELUA,"K. Sanz ""KSanz""",20080606,26,4.538461538461538,153.92307692307693,27,5,22
A3SOJO7Z7R9WIA,L. Schrader,20070119,61,3.3442622950819674,152.72131147540983,301,124,177
A3SP5OZ25GTBIH,BeccaHouck,20120709,25,4.12,42.68,7,3,4
A3SP7T2PZ3HSDE,D. Bezboruah,20060610,47,4.212765957446808,282.3191489361702,758,57,701
A3SPRSLV03DT6Y,t49y,20121109,23,5.0,114.52173913043478,9,27,-18
A3SQ3W73LZECJV,Burninglancer,20130819,32,4.84375,40.78125,9,3,6
A3SQCTNYQFVBWM,Mintex,20111201,49,3.857142857142857,153.0612244897959,47,7,40
A3SQQYS79AV13M,"Terri J. Rice ""ricepaper""",20090521,32,4.71875,147.875,154,14,140
A3SQV1Q3LQH59Z,Dot,20091206,26,4.615384615384615,99.57692307692308,286,6,280
A3SRDVCD2ATIIS,Voltaire,20090819,51,4.7254901960784315,70.31372549019608,23,10,13
A3SRQ9QJ1CJKGB,"VeritasluxMea ""Neoplatonic Platonist""",20091116,26,3.769230769230769,195.69230769230768,477,156,321
A3SS6919NRQ2MF,&quot;Corn Fed&quot;,20040212,31,4.67741935483871,140.4516129032258,132,21,111
A3SSSVZHCZDCVG,"capndino ""Dinoz""",20100109,27,4.037037037037037,63.0,22,3,19
A3STDPXRUJQBOQ,"Don Stozicki ""78gremlin""",20100117,22,5.0,27.40909090909091,4,3,1
A3SU1JZBMQ5ABZ,"F. Wise ""JV""",20071214,41,4.2682926829268295,170.9268292682927,36,14,22
A3SU7JSTPH9CC9,adamsko,20111130,44,4.613636363636363,66.36363636363636,2,0,2
A3SUZA0C8QV8AW,"Charles G. ""An Engineer and Business Person""",20050120,30,4.2,196.86666666666667,225,14,211
A3SVYWA9O1KUQV,"Alan ""Choklat Luvr""",20051004,48,4.708333333333333,266.9791666666667,885,54,831
A3SWLDY5FWIDNL,Eric C. Williams,20080108,23,4.391304347826087,210.47826086956522,106,11,95
A3SX1K1N7VR310,"RockShoX ""punkrockfan""",20050323,25,4.2,260.72,30,6,24
A3SX5MZTCZRQLF,Bradford Schmidt,20080120,76,4.026315789473684,399.17105263157896,331,55,276
A3SXDB0KMYMHQH,unclespoon,20110822,21,4.809523809523809,68.19047619047619,60,12,48
A3SZBE5F3UQ9EC,"ChasRat ""ChasRat""",20090205,27,5.0,72.33333333333333,7,4,3
A3SZXYX9YEDGT6,"Addison Dewitt ""I'm nobody's fool.""",20081226,32,3.90625,294.375,55,23,32
A3T0C8SMG7HLFY,Computer teacher,20070908,22,4.454545454545454,200.9090909090909,51,5,46
A3T1GBLPD4I6GH,"W. Rehs ""Audio/Video enthusiast""",20061113,30,4.533333333333333,293.06666666666666,127,12,115
A3T1J6ZJ2IWX2B,Thomas Almy,20071101,26,4.346153846153846,119.23076923076923,67,9,58
A3T1LD0C65QCWK,Gordon M. Wagner,20030519,31,4.451612903225806,183.93548387096774,148,36,112
A3T1S9ZTHNLVJY,Inspired Dribble,20060328,28,4.25,493.17857142857144,266,29,237
A3T2J7YMQT11Y2,M. Dana,20100131,27,4.777777777777778,150.37037037037038,37,6,31
A3T3JW81QUXVSJ,Weather Nut,20050323,38,4.552631578947368,90.21052631578948,107,9,98
A3T3KPW2QE866W,leelee,20040721,24,5.0,82.16666666666667,69,8,61
A3T3OSRNXHRA0D,I call them as I see em.,20061118,24,3.25,181.79166666666666,104,68,36
A3T41DSAR6AN4R,Jim,20120830,21,3.8095238095238093,21.61904761904762,4,7,-3
A3T48TAIWI9U4K,jd46ski,20110907,21,4.380952380952381,53.904761904761905,3,1,2
A3T4OHEAHOJ700,B. Colonna,20051008,113,4.061946902654867,457.353982300885,2054,139,1915
A3T6472ESEV6UD,"BdotA ""Bobby A""",20120509,24,4.625,66.66666666666667,13,0,13
A3T6UB8OL7NWEE,JazJon,20100410,27,4.518518518518518,162.03703703703704,57,33,24
A3T7BTQBVRJDOH,"Carrie Waterston ""Carrie Waterston""",20080127,22,3.3636363636363638,308.8181818181818,154,28,126
A3T7V207KRDE2O,SMXSteve,20060116,169,4.284023668639053,204.44378698224853,627,113,514
A3T8WOFS5RD2IR,John D. Hillmer,20070331,49,4.510204081632653,204.77551020408163,465,25,440
A3T99ZL93O3NRM,"J. Penegar ""Golfer393""",20080204,30,4.533333333333333,107.33333333333333,62,9,53
A3TA1UJWRJF9NC,jschristian44,20100204,45,4.5777777777777775,133.95555555555555,59,11,48
A3TAS1AG6FMBQW,"Jeri Zerr ""formerly a Road Warrior of the Nth...",20081130,143,4.734265734265734,180.98601398601397,232,30,202
A3TB9HNQR54B5V,"John ""John""",20001023,33,4.121212121212121,270.45454545454544,254,18,236
A3TBMAWIIHKHFN,Willie V. Hughes,20060406,82,3.3536585365853657,133.97560975609755,429,153,276
A3TBMGNSEQBWIL,Canadian Gypsy,20080603,45,4.088888888888889,155.42222222222222,17,34,-17
A3TCMJ6GKZJFBQ,W. Stohler,20011026,69,4.057971014492754,102.34782608695652,771,85,686
A3TD42X3DNZT7T,John,20120204,21,4.142857142857143,128.71428571428572,23,30,-7
A3TDYJPBZ7DXE7,"Q. Lin ""bookworm""",20060828,29,4.413793103448276,156.55172413793105,51,11,40
A3TEP6U427LK9Z,Fabian B.,20110224,24,4.958333333333333,47.916666666666664,7,2,5
A3TGO4V3LFIXJ3,Also-ran,20130325,22,4.954545454545454,57.31818181818182,4,3,1
A3THJLGG03GA3S,"Tech & Bio Expert ""Rich""",20070109,21,4.714285714285714,83.80952380952381,15,2,13
A3TIJLY4VX8CH3,Ohio Mom,20100621,32,3.84375,268.875,61,31,30
A3TIU8KJ29GASQ,TaserTot,20070118,24,3.5,65.0,36,17,19
A3TJ1V8IW0VNBT,R. Kaufmann,20070111,24,4.666666666666667,260.4166666666667,558,44,514
A3TJ2K4LP6V71U,Mike Phillips,20090604,27,4.703703703703703,66.5925925925926,34,4,30
A3TKLYTX5M1O2J,Ruben Cruz,20130202,28,4.25,32.964285714285715,12,4,8
A3TL36D4EDYWS0,"Christopher K. Sluder ""Xioticin""",20130802,35,4.885714285714286,221.71428571428572,16,4,12
A3TL64H6FMF4EM,"J. Haindel ""Jay""",20050217,21,4.571428571428571,250.38095238095238,370,46,324
A3TLV6X0NJV934,Johan,20120913,24,4.5,109.33333333333333,13,2,11
A3TLZI55X3PH9Y,Rob Marlbrough,20120611,23,4.913043478260869,95.56521739130434,99,3,96
A3TLZJVX40WJOV,"William J. Campbell ""W.J.C.""",20120718,23,5.0,44.0,8,7,1
A3TNM3C9ENUCFW,"A.M.Boughey ""Poetmaster""",20020622,65,4.061538461538461,261.81538461538463,747,86,661
A3TNZ31U9DD7UE,"Dr A ""A reader of biographies, history, and o...",20070311,22,4.2727272727272725,82.0909090909091,81,19,62
A3TP31S61PPE3G,AlexJouJou,20100123,60,4.016666666666667,237.0,76,17,59
A3TP8U0RSGEC3L,UNSC Jon 117,20090612,21,4.714285714285714,122.61904761904762,43,1,42
A3TPNC3TKGCCEI,"Raquel S. ""Avid Amazon Fan and Kindle User""",20031120,64,4.390625,293.28125,485,27,458
A3TQEF7QWHABGE,"Wombat Ed ""Wombat Ed""",20010126,22,4.318181818181818,42.18181818181818,6,5,1
A3TQTYD0D6AUO3,Steve F,20120215,31,4.645161290322581,70.3225806451613,8,3,5
A3TR3KLL5PXSZ8,Jenn S.,20140319,38,4.7105263157894735,37.31578947368421,6,3,3
A3TR4J71PYZVU9,CheezeWhisperer,20120712,23,3.608695652173913,86.91304347826087,10,8,2
A3TRHVSN8YESKB,pedro,20110908,30,4.9,25.066666666666666,4,4,0
A3TRIIEZG92KFY,Mainsil,20121025,24,4.25,51.375,6,5,1
A3TRSUX9JYKNCJ,Zavi,20110510,35,3.8285714285714287,106.51428571428572,110,9,101
A3TRY87JJCA5Y8,Frederick E. Hutchings,20070212,50,4.32,86.5,73,25,48
A3TU618RIP1SGL,Sail Away,20071030,32,4.25,178.71875,183,25,158
A3TUMQ1SQE9P0A,"Ron B. ""Ron""",20090630,23,4.695652173913044,78.52173913043478,20,6,14
A3TUZOJZM9008Y,"Michael A. Brown ""maniacmedia""",20001031,26,4.8076923076923075,157.65384615384616,453,92,361
A3TV9TEIZ2GWD8,"April B. ""LETHAL  FAN""",20100123,21,4.761904761904762,61.80952380952381,20,18,2
A3TWBW1B17R151,"liat2768 ""liat2768""",20090918,36,4.25,292.1111111111111,174,46,128
A3TWSBAR05BU1G,f.rose,20111211,21,4.857142857142857,41.666666666666664,9,1,8
A3TWUBZY3G44V5,Rlam,20090525,26,4.5,203.30769230769232,114,10,104
A3TXQIOHXRCDFC,Riyad Kalla,20070111,26,4.1923076923076925,305.96153846153845,512,30,482
A3TXZJQWCPYNVS,Tropylium,20120727,31,3.838709677419355,96.0,24,31,-7
A3TYJTG8HXTWKY,Stewart Bernard,20080226,28,4.607142857142857,27.107142857142858,36,13,23
A3U029B8Z5WGI2,Katherine Chan,20051201,50,4.6,172.22,91,22,69
A3U1WPDQLP9CQ,Lemon,20090105,32,3.9375,104.53125,131,16,115
A3U41ZL33SS92P,"Kevin Nicholls ""jaded, aging hipster""",20030822,169,3.621301775147929,280.11242603550295,2554,311,2243
A3U4AFML9SZPWK,"Leith Tussing ""I like tacos.""",20110916,35,4.6571428571428575,81.62857142857143,25,3,22
A3U4LQGN5AE9DO,"Brandon Spacey ""Furthermore, what?""",20110216,25,4.56,145.76,6,4,2
A3U52V5ZAHZZKU,"Wayne Crenwelge ""teacher""",20050809,34,4.852941176470588,122.6470588235294,138,29,109
A3U5HKDHPYBAK3,Thomas P. Troyer,20090608,47,4.191489361702128,159.74468085106383,103,74,29
A3U648J0AHF50K,usaf_drew,20061217,22,3.3181818181818183,311.04545454545456,32,6,26
A3U6J0DLLDEWM2,Jason Stokes,20090713,50,4.02,189.3,237,43,194
A3U7HS3TEX6B90,"Amazon Customer ""fyngyrz""",20071015,22,4.363636363636363,707.9090909090909,1157,33,1124
A3U8SQA062Y3DL,"Sethmatics Inc. ""Seth Carstens""",20100329,24,4.25,112.83333333333333,64,26,38
A3U9M6GJGKW5D7,dbx820,20110103,33,4.909090909090909,126.12121212121212,35,6,29
A3U9VONGIT9DYG,pcmojo,20130107,27,4.2592592592592595,75.51851851851852,9,3,6
A3UC3YT2E65LZO,R. Dowling,20040704,30,3.8,217.36666666666667,162,17,145
A3UCV4DD7L73NP,scottjl,20061020,22,3.772727272727273,212.22727272727272,78,24,54
A3UER4E69L7B4S,"G. Wernette ""After all the identity theft wit...",20091121,28,3.1785714285714284,134.92857142857142,127,59,68
A3UI5JZCU0F2AQ,Bohdan Sienkiewicz,20110113,30,4.7,46.233333333333334,12,6,6
A3UK6XF38M32SK,alanSJ,20120314,23,3.8260869565217392,196.17391304347825,40,4,36
A3UKKBIHTY2DTU,W from Chicago Metro,20090912,33,4.0606060606060606,63.81818181818182,22,8,14
A3UKPBTB65LLH6,John Anderson,20120118,22,4.5,201.1818181818182,20,6,14
A3UKWQS8SRW6IO,OrchidSlayer,20080221,54,4.7407407407407405,129.64814814814815,238,39,199
A3ULCLCHPLPCDS,John Grooms,20090126,21,4.904761904761905,511.6666666666667,223,9,214
A3ULWD7PM5OFKU,JA,20080809,37,3.6216216216216215,192.83783783783784,128,29,99
A3UMNO0WJS929H,RJQMAN,20110820,38,4.368421052631579,160.78947368421052,56,14,42
A3UN4PJ3WDJCP1,Drewmaster74,20110104,24,4.958333333333333,38.541666666666664,4,0,4
A3UO7TPKCH3D4,M. Anderson,20070613,22,4.2727272727272725,123.36363636363636,91,21,70
A3UOJSQM80ILY1,AQS,20080623,31,4.32258064516129,51.903225806451616,36,8,28
A3UOS7EC0NN88A,Jonathan Strawn,20070516,21,4.0,145.61904761904762,124,18,106
A3UPEG3LRWOX16,Alfredo,20130415,33,4.2727272727272725,53.484848484848484,18,10,8
A3UQSOJW51UU9T,BrianD,20070223,46,3.9130434782608696,165.32608695652175,65,15,50
A3UR2N0ATGBCU8,X. Chen,20071119,81,4.444444444444445,92.98765432098766,97,58,39
A3URIS1G20CGRK,"Scott Cho ""SwooP""",20121123,37,4.378378378378378,42.972972972972975,6,2,4
A3USVJXZXK7XRI,j flavors,20110807,22,4.454545454545454,81.18181818181819,6,9,-3
A3UT8LPZL0UGI8,J. Seelye,20060818,22,4.363636363636363,79.5,31,9,22
A3UUQBM7UGCNAI,"Robin L. Downey ""champmav (gamer tag)""",20100315,23,4.565217391304348,98.30434782608695,15,4,11
A3UW0PQLDUACMH,Kent J. Smythe,20071117,47,4.808510638297872,160.2127659574468,104,58,46
A3UW23DBF2KHWC,Denis Vukosav,20130712,40,4.825,191.7,126,18,108
A3UWRQZV34509I,Bitey (the big one),20080129,23,4.608695652173913,118.56521739130434,12,0,12
A3UXW18DP4WSD6,"Richard ""Richard""",20120103,49,4.816326530612245,51.36734693877551,16,3,13
A3UXXGZ955DM55,Christopher Evenson,20100321,25,4.64,63.92,14,2,12
A3UY2ZIAYCK4DQ,Kimberly Hoye,20121214,31,4.903225806451613,26.64516129032258,1,0,1
A3UYBRB74RJFXB,Mkhmn,20080904,41,3.5121951219512195,119.3170731707317,30,20,10
A3UZ17HANZ9F1E,Eldho Thomas,20001023,35,4.114285714285714,173.05714285714285,481,100,381
A3V08V821QXL10,Michael Drob,20080111,22,4.090909090909091,165.1818181818182,22,2,20
A3V0YR50F1XSKP,Mcomeau,20120105,88,4.7727272727272725,68.61363636363636,16,5,11
A3V15SFD7918WZ,Jesse D. Walker,20090625,58,4.051724137931035,258.51724137931035,261,81,180
A3V1A3C9DTLPME,"Peter Faden ""robilar5500""",20101008,37,4.756756756756757,166.56756756756758,31,6,25
A3V1AHX8P4R839,"Forrest Wildwood ""Phil""",20050908,27,4.481481481481482,149.2962962962963,25,11,14
A3V1DYN19UXF4F,"R. Iredale ""moderate zealot""",20060913,33,4.2727272727272725,168.03030303030303,256,62,194
A3V1L3KY8R9Q16,Mike Calimari,20121225,33,3.8181818181818183,67.15151515151516,7,1,6
A3V1T6WFSPV9CG,Cindi Burns,20140227,21,4.285714285714286,41.23809523809524,1,1,0
A3V2ESDQOBDOWM,AgogoLive,20110410,21,4.0476190476190474,268.2857142857143,35,8,27
A3V2EZ6MA32FF6,Bearcat,20061008,84,4.642857142857143,197.38095238095238,877,104,773
A3V2PI7YM6U7YI,"Joe Sr. ""Joe""",20100618,25,4.96,43.2,20,6,14
A3V52OTJHKIJZX,"A. Saenz Jr. ""Bettering self""",20120404,24,4.625,47.958333333333336,19,2,17
A3V55DVYU80LDS,V. Canfield,20081204,34,4.4411764705882355,184.23529411764707,30,11,19
A3V5F050GVZ56Q,Dre,20111010,91,4.681318681318682,364.1868131868132,1406,76,1330
A3V5THYJYDIJK6,"tterb45 ""tterb45""",20080424,30,4.5,113.23333333333333,19,2,17
A3V6QSTG2T9MIO,John Smith,20060322,52,4.25,248.90384615384616,147,24,123
A3V6Z4RCDGRC44,"Lisa Shea ""be the change you wish to see in t...",20001108,56,4.589285714285714,331.32142857142856,1909,115,1794
A3V79KXIY09MOE,"Stacy ""Amazon Junkie""",20100705,21,4.428571428571429,766.3809523809524,83,15,68
A3V7CDBG8SDO6Q,Stevan Varnell,20120423,22,4.318181818181818,334.1818181818182,46,9,37
A3V7D0LH8L7BG0,"H. Dinh ""shooter""",20070520,175,4.377142857142857,179.30857142857144,424,145,279
A3V8FQ3SBVG9HY,e,20071022,21,4.238095238095238,93.52380952380952,35,26,9
A3V8P0O224OBDB,S. Ghaemi,20070830,49,4.530612244897959,68.57142857142857,138,78,60
A3VBDVGH06EPMA,Kyle E. Kneisl,20071019,23,4.521739130434782,253.69565217391303,110,9,101
A3VBGZ1TOJNAIL,"A. Antonio ""CMDTA""",20101028,26,3.730769230769231,244.03846153846155,415,89,326
A3VBORHS4H8LES,"John E. Wente ""okiebikinguy""",20090510,27,4.666666666666667,85.11111111111111,21,1,20
A3VBXQKRM7A4JR,eyecore,20030413,61,4.065573770491803,328.1311475409836,407,52,355
A3VBZDYGHF4NK8,"Movie Maker ""Rik""",20081101,66,4.515151515151516,188.78787878787878,112,30,82
A3VC74TJ06WDDD,James E. Scott,20120823,60,4.416666666666667,63.46666666666667,29,11,18
A3VCZYKQIIZPSY,Fred Pisa,20110619,37,4.351351351351352,52.37837837837838,47,29,18
A3VD4PLV020VVT,Amazon Customer,20041030,22,3.4545454545454546,60.31818181818182,89,17,72
A3VEA7ACJUPTZ4,L. Russo,20080412,30,3.1,262.6666666666667,509,71,438
A3VEFQ25OSXMOQ,sony,20101203,23,3.5217391304347827,52.73913043478261,5,12,-7
A3VF91VPHNP00L,"Patrick Nguyen ""Trance Music""",20090418,27,3.2962962962962963,103.48148148148148,173,79,94
A3VFQ69HAGOPH5,"Photo Guy ""Product Researcher""",20100824,24,4.625,107.875,115,14,101
A3VFWX3FJXRJ7J,"Gamer ""Gamer""",20070313,27,3.2962962962962963,92.85185185185185,46,30,16
A3VG1RDWHEYK6V,David McCutcheon,20130206,21,4.333333333333333,30.333333333333332,3,3,0
A3VGWCK1K0512G,Stickyickyooo,20110211,22,4.318181818181818,43.95454545454545,2,1,1
A3VHGUZCGYA4KK,"kmrotterdam ""kmrotterdam""",20110330,30,4.566666666666666,86.86666666666666,66,3,63
A3VI2VETB90ZG5,J. Sullivan,20070322,89,4.348314606741573,308.0674157303371,207,69,138
A3VIFJZC7SHX1T,P. Claxton,20040305,34,4.323529411764706,164.76470588235293,233,22,211
A3VIS4P126GF0F,D. Nate,20130212,35,4.6,79.94285714285714,4,5,-1
A3VJMUXMRM8Y9Q,A. Kunetka,20110206,23,4.086956521739131,129.7826086956522,31,6,25
A3VJU6P3QN3T8,Dan,20110502,21,4.428571428571429,107.57142857142857,12,1,11
A3VL4RXCWNSR3H,DISenchanted,20060202,29,4.413793103448276,195.24137931034483,127,17,110
A3VLVOVWP2ZX63,FreelanceViper,20130506,27,4.37037037037037,94.51851851851852,5,4,1
A3VNBV1613K5Q5,"Robert A. Suarez ""Shadax""",20091230,29,4.0344827586206895,88.6896551724138,20,9,11
A3VNK46D07TJ0D,mpinch,20130205,21,3.4761904761904763,67.38095238095238,13,4,9
A3VONQL7YW8UPM,Geoff Ables,20021114,57,4.280701754385965,189.24561403508773,343,63,280
A3VQ77Z5SI8ES7,athena smith,20120731,22,3.909090909090909,39.22727272727273,3,2,1
A3VQFUAB6WQXMU,shovenose,20130724,26,4.423076923076923,48.03846153846154,7,0,7
A3VQUWY0ZRLFR0,"Arthur Zatarain ""Artzat""",20110624,25,3.8,174.4,20,2,18
A3VRU93Y1A6P27,Gooberdad,20130429,25,4.84,50.08,3,0,3
A3VS6IOPI47EC4,Simon H,20110403,21,5.0,50.476190476190474,2,1,1
A3VSHLS9K329RP,Potomac Hokie,20101129,25,4.48,31.0,5,0,5
A3VSVWP9Q8MJ9S,CarNut,20110926,21,3.7142857142857144,65.95238095238095,12,5,7
A3VSYUWJBQ479Q,Dathon,20100315,21,4.476190476190476,144.71428571428572,60,6,54
A3VTOLNB5N6FVP,jj,20060112,59,4.288135593220339,157.01694915254237,127,32,95
A3VTSPF7JQ80UQ,"B. McGregor ""BigMG""",20071201,24,4.416666666666667,125.95833333333333,31,15,16
A3VVFDWY855EEP,Brandon Elbers,20110105,22,4.681818181818182,88.27272727272727,5,4,1
A3VVKC910FN4EK,David Basham,20110401,22,4.7272727272727275,70.27272727272727,32,11,21
A3VVMIMMTYQV5F,Johnny Saigon,20070525,44,4.318181818181818,182.45454545454547,229,26,203
A3VVOQ5K6C4Y7C,HOME SLICE,20100826,37,4.594594594594595,99.16216216216216,28,7,21
A3VWU7S29LR2XX,Bryan S,20120625,22,3.727272727272727,78.22727272727273,27,3,24
A3VWWC9D61FTL5,Amazon Customer,20090419,22,3.6818181818181817,67.0,76,23,53
A3VX6DDDK0681Z,R. Overall,20060203,34,4.4411764705882355,191.23529411764707,200,26,174
A3VYCWBO41LI0R,Brother Randahl,20130324,30,4.166666666666667,68.76666666666667,3,3,0
A3VYKXHQDICC6,philo_vance,20020629,27,4.592592592592593,295.14814814814815,240,34,206
A3VZH0PWLQ9BB1,Tom B.,20060329,48,4.583333333333333,225.22916666666666,198,24,174
A3W06YJC2YACTH,R. Siegfried,20081205,24,4.166666666666667,157.08333333333334,43,7,36
A3W0B8CBKLB1DM,"Eddie ""Music lover""",20100620,23,4.956521739130435,103.21739130434783,50,2,48
A3W152L0OZZER6,Cool Phil,20100819,30,4.433333333333334,56.666666666666664,21,7,14
A3W1TQHFQN5YF9,Armando,20100827,22,4.681818181818182,33.09090909090909,6,1,5
A3W2Q3F909FHDP,J. M. Schalow,20060903,26,4.1923076923076925,272.5769230769231,91,8,83
A3W2UTN0BC4ZKD,"Heath Buckmaster ""_heath_""",20000623,40,3.8,475.825,1328,81,1247
A3W42GDZOBARMS,"J. Ball ""jdb2""",20120819,25,4.8,160.2,40,3,37
A3W4D8XOGLWUN5,"Michael Kerner ""Michael Kerner""",20040701,124,3.806451612903226,238.15322580645162,534,329,205
A3WFXFCLASQMP,"David Bui ""David Bui""",20061116,23,4.521739130434782,58.04347826086956,12,8,4
A3X0OABB0HCP2,rblaw,20040627,26,3.5384615384615383,152.57692307692307,72,22,50
A3XGHG3XSPSWJ,Ash,20111215,26,3.5384615384615383,39.07692307692308,8,4,4
A3YRIEUDJV27C,ravenous,20111117,27,4.111111111111111,94.4074074074074,49,5,44
A3Z3817Z6WTXU,Frank M.,20101102,21,4.904761904761905,57.19047619047619,7,2,5
A3Z9QN0RCOHEY,My2Cents,20090718,29,4.172413793103448,134.06896551724137,147,23,124
A3ZAWSQZPYCIG,bmores1,20120220,23,4.521739130434782,72.0,38,2,36
A3ZRUOFG0P5GM,Dana Kehr,20130321,27,4.7407407407407405,35.629629629629626,10,2,8
A404TOR0ATGXJ,A. May,20090315,23,4.304347826086956,40.391304347826086,3,0,3
A40JUONF1PO8,Vladimir Tankhimovich,20050306,21,3.8095238095238093,63.857142857142854,45,13,32
A40N5P6DG7FOL,AcornMan,20051231,21,3.380952380952381,80.52380952380952,25,7,18
A42GLWM4HVOSL,James Andrews,20100810,26,4.384615384615385,112.3076923076923,41,2,39
A42Z8BX1MR66O,CaptainBasic,20110725,26,3.8846153846153846,90.76923076923077,19,2,17
A44NZBXFQLXUM,"Dave Diaz ""Hermanaso""",20120811,21,2.9047619047619047,60.23809523809524,3,2,1
A450WKBT9ZIM,"Deipnosophist ""cw3rd""",20041110,30,4.6,37.5,4,2,2
A45D2LMO2GI50,Roger,20110528,23,4.478260869565218,70.8695652173913,19,4,15
A47D5C32VLQM2,,20110319,29,4.137931034482759,125.58620689655173,40,13,27
A48J4OYL4M4B6,MikeDVB,20111229,24,3.9583333333333335,78.25,60,26,34
A48V9754OZGMM,CraigB,20121121,31,4.838709677419355,46.29032258064516,7,0,7
A492TJ4AHEQ5D,Joe,20121204,30,4.066666666666666,47.166666666666664,6,4,2
A49N40Z126X2P,"William D. Charschan ""author  Cheating Mother...",20111209,22,4.863636363636363,49.68181818181818,4,1,3
A4BTCECGQAIUI,Amazon Customer,20120514,40,3.85,45.7,4,5,-1
A4C0E4KPCIXFY,Fred Flintstone,20130221,24,3.3333333333333335,184.5,87,17,70
A4D5B7Q8A7PA6,"Vynny ""Vynrod""",20050306,100,4.51,297.73,339,92,247
A4DLVVK8W2ZVA,"Artem ""REDNERD""",20100412,21,4.809523809523809,128.1904761904762,7,2,5
A4DSI9VRBED9N,Torako,20100210,43,4.8604651162790695,135.2093023255814,30,9,21
A4E9H23O2Q9SR,"Man Who Only Shops Online ""Mike M""",20121126,30,4.766666666666667,115.0,78,5,73
A4EKVQER3YGZC,Lovethefuture,20070903,24,4.0,262.1666666666667,55,8,47
A4FRO4ZM0C8HM,freeman,20110513,24,4.75,119.83333333333333,47,8,39
A4GGT6O0GQNV2,BKarno,19991221,47,4.361702127659575,389.21276595744683,421,31,390
A4GHPW9AAH1NY,Thule1,20080427,57,4.508771929824562,103.87719298245614,89,18,71
A4GI4654JA8NK,B. Edwards,20080513,31,3.935483870967742,393.2903225806452,597,64,533
A4GLR5U1NHQR8,"Jake ""Jack""",20060805,24,4.291666666666667,102.66666666666667,49,7,42
A4H4KYSM2KQ85,Erika Mitchell,20070523,48,4.458333333333333,437.8541666666667,248,45,203
A4HE1PQ4QTUYI,Murky,20070228,21,3.8095238095238093,243.71428571428572,49,7,42
A4HRXYAO7QP7L,Joseph D. Land,20101128,21,3.9047619047619047,290.3809523809524,45,19,26
A4HT7FH6PGPV6,dauntless,20120713,24,3.1666666666666665,240.04166666666666,28,16,12
A4HV1JDH6VNMG,Reece Ram,20130203,21,4.476190476190476,59.80952380952381,1,4,-3
A4IEUHNRFZO0,"Steven B. ""BodyCop""",20080531,59,4.6440677966101696,92.72881355932203,120,14,106
A4IFS6HW8MS1L,Drvajeep,20111229,22,4.7272727272727275,91.22727272727273,42,3,39
A4IL0CLL27Q33,D. Brennan,20060127,80,4.3,268.875,304,51,253
A4IM0ZAMQS34Y,Dave Carlson,20130203,28,4.428571428571429,52.607142857142854,4,1,3
A4J2D2R90W80Y,biding_my_time,20110420,26,4.653846153846154,117.61538461538461,16,0,16
A4JCG4NARPIMR,Albert Jurina III,20090816,32,4.3125,105.09375,234,37,197
A4JF3BCJO0VGI,"firewallbill ""firewallbill""",20030102,37,4.351351351351352,175.1081081081081,156,14,142
A4K1YGL2AXS9F,Tyson,20111221,28,4.821428571428571,110.71428571428571,19,4,15
A4KNTF8EEFAKK,Parrothead,20100422,28,3.4642857142857144,32.464285714285715,8,3,5
A4L0UD2AWHART,"Thomas W. Thorpe ""Tom""",20081202,27,4.814814814814815,53.407407407407405,26,14,12
A4N5U62XX152G,aophil,20091029,24,4.833333333333333,89.95833333333333,25,1,24
A4O7NPE5C5DS9,Brian,20120914,26,4.653846153846154,12.807692307692308,0,0,0
A4OPNK2K0EDLG,Richard Spafford,20071113,26,4.384615384615385,151.92307692307693,90,12,78
A4OSEUA98PPAA,Nonamemarine,20090610,26,4.423076923076923,94.3076923076923,26,4,22
A4OWA49OQXPTB,"DDBones ""Dave & JinMing""",20100722,24,4.666666666666667,74.875,6,7,-1
A4PD8GH3B9MDN,MarkHNC,20120616,23,4.434782608695652,90.78260869565217,3,7,-4
A4PSA9L4JXUJ5,Raymond Monk,20130322,32,3.53125,74.96875,16,28,-12
A4PYOAQ2GH8FQ,"sni511per ""WALEED""",20130926,24,4.375,60.375,5,2,3
A4R11BO5B9U9I,Dave in Connecticut,20070105,25,4.4,103.32,36,6,30
A4RASGC2BYMD5,"D. Hansel ""dhansel""",20080208,28,4.642857142857143,51.035714285714285,6,3,3
A4RL6XMNONZ6U,Nonsha,20111029,43,4.069767441860465,80.51162790697674,32,12,20
A4S2WAQVQR6PI,shore times,20050903,50,4.12,65.84,31,9,22
A4SD8F79JBYG2,"Kat Hooper ""Kat at FanLit""",20100617,22,4.2272727272727275,86.22727272727273,15,4,11
A4SSILU7KZ1XK,Zachary Tumlin,20110112,28,4.464285714285714,121.53571428571429,19,4,15
A4TU4M76Y09AR,Andy B,20120206,26,4.576923076923077,60.03846153846154,4,0,4
A4U27URFECK1U,"Chris Damon ""Classic TV & Tech Guy""",20090602,57,4.087719298245614,812.5964912280701,429,47,382
A4UFU4WKYEUGO,Rhonda Roberts,20070705,26,4.653846153846154,334.2307692307692,129,29,100
A4UGMKUSX9XHI,Robert Stone,20071207,79,4.772151898734177,226.2405063291139,515,31,484
A4VEKNHHOZIMJ,"Kris ""Mountain Wizard""",20080120,27,3.7037037037037037,108.70370370370371,16,8,8
A4VUZC393WUCY,Phil,20121002,25,4.44,50.12,5,0,5
A4WEZJOIZIV4U,"Chuck Bittner ""Disabled comedian & gamer!""",20050105,202,4.534653465346534,331.8811881188119,4500,553,3947
A4WYCW63XR1UU,"Amazon Customer ""biz""",20101002,32,3.78125,166.34375,563,83,480
A4Z12I3D81BK8,Jonah,20130103,24,4.25,33.916666666666664,3,4,-1
A4Z7AYP2KIPVZ,"Maggie ""Maggie""",20120805,23,4.826086956521739,33.130434782608695,3,1,2
A5005FWY328KT,D. Decorte,20101126,29,4.551724137931035,122.10344827586206,25,8,17
A506HOOCVL8GW,"J. Kurz ""J. Q. Public""",20060227,86,4.5813953488372094,137.6860465116279,773,43,730
A50W36ATFDSNU,ND,20120405,30,4.766666666666667,192.63333333333333,22,6,16
A51OFQVC6O5YL,Michael,20120406,50,4.4,42.04,50,41,9
A51QW9KI70Q04,"Richw ""Rliege""",20030414,26,3.5384615384615383,255.76923076923077,110,4,106
A52Q80ABV68IJ,"Ashley D ""Silk""",20110218,24,3.7083333333333335,413.9583333333333,598,106,492
A53UQYV14N0D7,T Pynchon,20070208,26,4.384615384615385,106.38461538461539,17,3,14
A53YP4DF1EJES,"Evan ""Game Master, Gamer, DIY Enthusiast""",20110430,22,4.7272727272727275,43.27272727272727,0,0,0
A54NEOWDRAFW1,Chris,20100524,25,3.2,85.0,27,16,11
A54OVZ0FZOTM1,NickisratingstuffonAmazon,20090201,23,3.9565217391304346,143.52173913043478,86,12,74
A54S9CIUV5VNB,"Dave ""Sonic""",20080608,87,4.482758620689655,78.91954022988506,64,7,57
A54SG05AV6S4H,linnemeyerhere,20110117,61,4.950819672131147,53.721311475409834,29,20,9
A55CAYQ7Y6CJG,"Christopher J. Shaker ""cjshaker""",20020611,25,3.8,129.96,122,39,83
A55LS2HWPQB0Q,"Jill Florio ""Green RVer""",20100607,39,4.3076923076923075,270.6923076923077,32,11,21
A55PCTJ6NINET,"David K. Watson ""DKW""",20050219,43,4.046511627906977,443.6046511627907,727,45,682
A567HBSX35U7X,Call me KID,20110322,40,3.925,177.325,56,16,40
A56IAIR71TPP5,Palavering,20070909,34,3.911764705882353,112.91176470588235,52,38,14
A57Q87B0TC9IJ,Derek G,20020119,36,3.3055555555555554,429.0833333333333,139,38,101
A5834FSAH2HZQ,Amazon Customer,20120426,28,4.0,177.53571428571428,156,22,134
A583JQOKI24QV,"J. Savio ""Very Savvy""",20120131,21,4.0476190476190474,66.47619047619048,33,4,29
A58437AUQICZF,"J. J. Burtch ""In Life, Try to be the Type of ...",20101116,37,4.864864864864865,464.05405405405406,159,10,149
A58F10T4OE58C,"S. Montgomery ""green dad""",20070808,22,4.090909090909091,131.4090909090909,92,15,77
A58N07M0ZCYMB,Valentina,20040508,49,4.653061224489796,106.63265306122449,112,29,83
A58ONS9WNBT9F,"electroman ""EM""",20100301,36,4.388888888888889,241.88888888888889,197,53,144
A58P1TUC17EL2,"Jason Stanhouse (Jason@stanhouse . com) ""J+H ...",20121225,24,4.708333333333333,108.08333333333333,4,1,3
A599O3M1DJKUR,Just a Guy,20140625,22,4.7727272727272725,54.13636363636363,3,1,2
A5A4374R8I7NB,PWB Esq,20110406,43,4.162790697674419,299.25581395348837,54,2,52
A5BXA4BQOK0S2,"Kristopher D. Michaels ""The Nightwalker of CA""",20130203,22,3.909090909090909,117.5,6,4,2
A5CDMTW6JKV5G,"Dr. Wilfredo M. Viray ""Wally""",20080207,53,4.754716981132075,258.7358490566038,3626,67,3559
A5CTPK3K8OWOG,"I love Amazon ""Cash""",20101204,21,3.857142857142857,51.904761904761905,12,7,5
A5F4JI8IHZQKF,JBF31643,20120205,23,4.478260869565218,100.6086956521739,4,3,1
A5FS50VW0GWEE,"Baseball ""Johnny""",20041220,25,4.16,234.92,102,151,-49
A5FU4AL6W444J,Anthony Essmaker,20121126,22,3.727272727272727,40.0,5,1,4
A5G3GY4XV6E7A,"Cowboybob ""CB""",20081024,24,4.625,91.66666666666667,14,7,7
A5GPH59NDWJRB,Jenna of the Jungle,20080618,50,4.06,204.34,39,8,31
A5H2S8FNZ15O5,C. Pultz,20101029,23,4.478260869565218,57.30434782608695,17,4,13
A5IALBY2QXSS,Syrus54,20110327,24,2.5,110.16666666666667,30,236,-206
A5II29J0V20A1,pseudonym,20050910,24,4.333333333333333,112.66666666666667,36,9,27
A5JLAU2ARJ0BO,"Gadgester ""No Time, No Money""",20000428,351,3.8518518518518516,264.6296296296296,9890,1596,8294
A5K5DIDKAML5C,"Lisa M. Hendey ""Mom, Blogger, Podcaster, Author""",20071005,34,4.5588235294117645,177.2941176470588,441,37,404
A5KFCV8X8N7E9,dest81,20120423,21,3.857142857142857,176.8095238095238,35,2,33
A5KMMY627T3W,Kate Stokes,20060131,128,4.5390625,210.6484375,1334,113,1221
A5MCDQ60DWUEV,Paul Lewis,20090707,57,4.543859649122807,155.57894736842104,122,23,99
A5MTZTDSIBX09,Colby McGehee,20140203,21,4.190476190476191,68.85714285714286,6,7,-1
A5N0QU8JBRVQQ,"Christy N. Butler Photos ""CNB""",20070417,29,4.758620689655173,131.9655172413793,29,5,24
A5N8T6UJU6VNW,B. Miller,20091114,29,3.2758620689655173,47.51724137931034,104,26,78
A5NA8I02DWUXE,"Robert E. Keto ""moesgrill""",20110831,22,3.6363636363636362,70.9090909090909,14,4,10
A5NYUBEKXFLX5,"B. Babb ""kites0852""",20021219,22,3.9545454545454546,216.86363636363637,134,26,108
A5Q1FK0FWU7DH,TC,20071223,65,4.2,265.1384615384615,462,45,417
A5QDZEOIMQ4LW,"Joe Crescenzi ""From CouponPages.Com""",20020921,44,4.704545454545454,213.02272727272728,533,24,509
A5RESRBCJXMOM,Sean,20101201,23,3.652173913043478,99.6086956521739,23,2,21
A5SIBQZJ2G8YL,Veniero,20060126,21,3.2857142857142856,60.76190476190476,34,15,19
A5T1AJ2TYYT2U,David Johnson,20100503,23,4.3478260869565215,251.52173913043478,29,3,26
A5TGLWEDF4IXV,"V. Goulette ""SunsNut""",20110411,30,4.4,79.86666666666666,6,1,5
A5U5T6EWH90O0,Lauri M,20110524,24,4.125,124.41666666666667,11,10,1
A5V97TZZOSUUK,Ziontrain,20071122,21,3.2857142857142856,166.57142857142858,63,14,49
A5VJUBG4HK80,Grandpa54,20070704,33,4.484848484848484,105.33333333333333,38,40,-2
A5WXMP1BROF0J,Len,20120810,26,4.8076923076923075,65.73076923076923,21,2,19
A5X1B2HBQUR3P,"Vikram Ramanathan ""Live to Learn""",20111229,24,4.166666666666667,134.58333333333334,6,4,2
A5X444UZBWXW2,"Robert Marshall ""Sheriff of Tucson""",20070510,23,4.173913043478261,56.52173913043478,15,14,1
A5X6PJANY4XW4,"Tcat ""Loves Amazon Over Wally World""",20060925,44,4.75,106.68181818181819,51,9,42
A5X8M6WYSIF84,David S.,20131216,38,4.105263157894737,25.5,10,9,1
A5YTGBQJ6Z2EO,Yuval,20130204,23,4.434782608695652,34.73913043478261,7,1,6
A5ZGJBOPDRVQL,Charles,20121228,32,4.5,60.8125,10,12,-2
A5ZSA8AOEW76C,J. Thomas,20120401,22,4.454545454545454,131.27272727272728,16,1,15
A5ZW1R47LT4HM,"Mike Shea ""The Goob""",20071016,23,4.695652173913044,235.04347826086956,80,10,70
A61UIWC9N8CJK,Consumer Advocate,20110318,32,4.34375,184.46875,197,17,180
A63P73MGD9OSF,R. M. Smith,20100610,23,4.739130434782608,53.34782608695652,6,1,5
A64A14YBQOD2H,southleft,20081031,27,4.185185185185185,196.1851851851852,63,48,15
A64LEAZ2QF8L2,Stu Redman,20091223,64,4.90625,124.8125,22,8,14
A65KIP6M5WZFR,Some Guy,20021126,29,3.5517241379310347,136.31034482758622,247,34,213
A66RJA6OE8ELD,Chris,20101018,22,4.590909090909091,135.27272727272728,9,0,9
A680RUE1FDO8B,Jerry Saperstein,20050327,352,4.471590909090909,327.78409090909093,6634,478,6156
A688RIZ2POWSQ,"L. Jenkins ""Many hobbies in Texas""",20060830,25,4.32,171.72,28,18,10
A68I27YTWAHAY,Eric Lucier,20130130,27,4.888888888888889,24.333333333333332,3,2,1
A68I93HI9W6LD,JJ,20060119,42,3.357142857142857,167.8095238095238,310,82,228
A68UDKZFN2238,Wideglide,20120828,30,4.4,41.233333333333334,28,38,-10
A699FV6YEAWJ2,David Ruether,20130130,21,4.476190476190476,332.95238095238096,57,8,49
A69ZC6I3VP2B4,CONSUMER Advocate,20111022,32,3.59375,88.0,7,2,5
A6B85SQ9387IJ,L. Allston,20100419,26,4.461538461538462,68.42307692307692,42,8,34
A6B92PTV0Z1SU,"P. Kingsriter ""R.N. Guy""",20030131,22,3.8181818181818183,253.5909090909091,30,8,22
A6BDU7UEVIQXO,"Mariusz Jurgielewicz ""melastmohican""",20101022,22,4.590909090909091,42.45454545454545,3,0,3
A6D91KPQGIDKZ,"Jim R. ""Photo man""",20060201,30,4.6,95.6,44,27,17
A6DF9OQYVGS8X,adg44,20120510,29,4.551724137931035,106.0,18,6,12
A6DPEGBB5XFJW,"K. Smith ""OutlawPlayer2""",20101117,33,4.696969696969697,49.36363636363637,9,3,6
A6EYTU1TZ1IGH,Vitin,20120507,25,4.52,26.16,5,5,0
A6FFR67MAB6U3,Peacefrog,20110901,32,3.625,124.84375,313,108,205
A6FGO4TBZ3QFZ,Albyati,20120506,22,4.818181818181818,62.31818181818182,19,22,-3
A6FIAB28IS79,Samuel Chell,20010326,367,4.228882833787466,401.3269754768392,7188,536,6652
A6GNN25N3M7E9,Larry Epperson,20090119,26,4.846153846153846,78.96153846153847,14,5,9
A6H0BSFKAXB5X,Scooby Doo,20100118,22,4.2727272727272725,105.0,33,16,17
A6HOWM08PLFZ5,Michelle Rayburn,20101211,41,4.170731707317073,234.17073170731706,56,10,46
A6J8D9V5S9MBE,Curtis G,20040106,42,4.214285714285714,235.0,273,59,214
A6KGOJ4B23GQ5,Michael Stanley,20140227,23,4.6521739130434785,25.695652173913043,0,2,-2
A6KL17KKN0A5L,K. Harper,20100521,53,4.679245283018868,115.86792452830188,125,10,115
A6MFQD6NAUXKA,Anna,20110313,24,4.166666666666667,73.91666666666667,9,1,8
A6NYQDBUFI5P,"DBChas ""DBChas""",20100819,22,4.2272727272727275,328.04545454545456,24,9,15
A6PGY3XAJSYH2,"John E. Drury ""jedrury""",20100906,32,4.375,96.25,16,2,14
A6QG9LM5WL0AQ,"C. Irish ""Read On!""",20101110,23,4.739130434782608,282.95652173913044,137,21,116
A6SZZSMX7DQG1,Elly Sparks,20110523,22,4.363636363636363,239.0,45,14,31
A6TBR6L2D4XKC,Marvin R. Doering,20040410,50,4.08,56.68,172,131,41
A6TU9CU9VJA0D,OSU_Engineer,20101206,24,4.666666666666667,137.5,47,5,42
A6VD6GFWOEG42,BlkIndianMale,20121215,22,4.090909090909091,83.5,6,7,-1
A6VPK7X53QNAQ,"AmazonDiva ""Keep Calm and Carry On.""",20040414,150,3.9266666666666667,397.2266666666667,6070,273,5797
A6VXZ1EEPRTLV,trebe,20021111,140,4.142857142857143,382.73571428571427,1007,74,933
A6WZVL0SRQAPY,Brian Driver,20120307,23,4.6521739130434785,396.60869565217394,16,2,14
A6XDZ1MJ0B1A2,Gene P. Louie,20080927,61,3.1311475409836067,224.0655737704918,551,120,431
A6XLG77BC9R8R,,20081107,64,4.25,211.34375,79,16,63
A6Y7658A04MTT,Perry M. Rogers,20131106,24,3.7916666666666665,206.95833333333334,318,41,277
A6YA25TZ6IDWH,Scott,20120215,23,4.6521739130434785,143.47826086956522,4,2,2
A6Z5D6RNFVHEP,Joe Cho,20090113,32,4.65625,88.0625,26,10,16
A6ZPLVAUQ6695,"neurotome ""neurotome""",20000610,28,4.607142857142857,334.89285714285717,615,67,548
A70CKQ0ZITPIC,Cbeee,20100124,24,4.375,46.041666666666664,4,25,-21
A70NFM6KHU24F,Trevor Burnham,20081209,36,3.8055555555555554,165.27777777777777,147,43,104
A70YGMFQTPYEC,"Victor ""Bluetooth Rocks""",20050430,26,4.576923076923077,244.5,235,36,199
A710LV6FL7FAC,seulater,20111117,24,4.291666666666667,154.08333333333334,114,27,87
A71GYL954Z1I9,Seeking pixels,20090119,24,3.9166666666666665,45.791666666666664,13,9,4
A71QM36DDW82O,"E.D.S ""budget consumer""",20070128,22,3.6818181818181817,95.9090909090909,11,8,3
A71RNLTHLVSDJ,"Matthew J. Liptak ""lip89""",20041108,29,4.068965517241379,289.3448275862069,187,51,136
A72KEKIG7WATK,Usagi3,20130209,27,3.6296296296296298,64.70370370370371,16,7,9
A74UT8IQCM0I2,Bear,20120713,48,4.708333333333333,96.95833333333333,3,6,-3
A75XQ5F2VTLF2,,20101107,23,4.565217391304348,144.34782608695653,5,1,4
A7657U6RAV1BX,Ken L.,20121227,26,4.076923076923077,111.61538461538461,21,5,16
A768OB1LNE356,"Kevin ""k""",20110124,21,3.8095238095238093,160.61904761904762,14,3,11
A77TE0E6COHJ0,H. Goeller,20090326,23,4.695652173913044,83.21739130434783,16,2,14
A781ITP3HE2N5,"Michael Livote ""dragon2knight""",20110116,56,4.589285714285714,166.89285714285714,131,13,118
A7829CRHD25WU,"Majik ""FTW""",20080727,33,4.2727272727272725,222.15151515151516,179,28,151
A79372WBA9IJM,"Miss Kitty ""Timid Observer""",20110508,31,4.32258064516129,100.09677419354838,54,21,33
A7A45W0QP3O5O,"Alexandre ""Alexandre""",20070512,40,4.175,107.475,86,48,38
A7BADSLJWVDZV,Kyle,20121129,24,4.166666666666667,74.75,4,3,1
A7BQB93ZWUII3,Brandon Meyer,20090228,29,4.655172413793103,68.44827586206897,6,1,5
A7C1NWHUFQ44S,"James D. Sheetz ""jdsheetz""",20090925,21,3.9523809523809526,46.95238095238095,14,3,11
A7C77J4MH94B6,"Cowboy Bill ""cowboybill""",20080809,42,3.9047619047619047,140.47619047619048,185,26,159
A7D2TLDGXHQXS,Akamai22,20070706,27,4.814814814814815,217.59259259259258,50,2,48
A7EJERNB7IK3Z,CQ DX,20041201,83,4.228915662650603,222.73493975903614,995,64,931
A7EK88GF8N40F,Nicole S. Urdang,20090525,22,4.2727272727272725,79.22727272727273,20,8,12
A7EU2BWLLCJY2,"Claire Jordan ""Filmmaker - &#34;The Baroness ...",20080213,64,4.546875,225.6875,524,47,477
A7FDGFK0KN7QG,"shuTTL3bus ""shuTTL3bus @gmail .com""",20011112,48,4.6875,1140.0833333333333,5173,385,4788
A7GSAXOHLDDYP,"Harry T. Goodwin ""Hairy Wolf""",20060309,22,5.0,64.54545454545455,11,0,11
A7GXT5V1VL5UT,"J. Leigh ""JL""",20010709,36,4.166666666666667,189.97222222222223,552,81,471
A7HEZCAYG5JML,"DC ""David Ceremuga""",20110503,41,3.975609756097561,83.7560975609756,283,52,231
A7HPQEWKPSFJ6,jBj,20111224,33,4.363636363636363,129.27272727272728,61,11,50
A7HY1CEDK0204,Jor El,20131119,22,4.7727272727272725,40.95454545454545,2,1,1
A7IHKMJJC0ETT,"J. Obra ""Avid Review Reader & Writer""",20101014,21,4.666666666666667,483.7142857142857,46,4,42
A7JGEKN140F4S,"Keith ""kc31824""",20000514,38,4.578947368421052,129.68421052631578,326,27,299
A7JQDI5K9XZY8,Walleye Dave,20121204,24,4.416666666666667,95.70833333333333,22,21,1
A7KBAXO177NND,Wesley C. Brooks,20130102,54,4.462962962962963,46.81481481481482,7,7,0
A7L7RNNCJYW88,kamhighway,20110602,22,4.2727272727272725,100.0909090909091,33,9,24
A7M7JDSCN0HMM,Paul Q,20050718,42,4.238095238095238,112.69047619047619,179,15,164
A7ML81I8DD040,GeriZ,20131016,29,4.758620689655173,36.58620689655172,2,0,2
A7NKKP0FUGFHU,Koset,20130817,29,4.931034482758621,50.48275862068966,7,1,6
A7NUXXOKGQQKP,Thomas Serface,20090201,23,4.391304347826087,101.69565217391305,28,5,23
A7O7US1AVC8DH,Soas,20120329,23,4.913043478260869,80.73913043478261,17,8,9
A7OCP4P0S4YO8,"M. C. Carter ""cartertoggle""",20110823,22,3.6818181818181817,39.31818181818182,4,38,-34
A7OKY5E1AI1J0,Jordan Webber,20050811,28,4.928571428571429,98.67857142857143,61,15,46
A7OTTM22AV2VR,"Daniel Aberle ""Singed Phoenix""",20110822,30,3.9,299.73333333333335,112,31,81
A7OYYLL1PW2AH,Maximus,20110616,21,4.476190476190476,115.14285714285714,18,0,18
A7P7ETMXVALAR,Christopher Valdez,20111223,21,4.523809523809524,62.523809523809526,3,2,1
A7PGUZL6E1D1Q,Ryan G,20110109,22,4.090909090909091,147.86363636363637,21,24,-3
A7QMQBGJ2TCQG,Paul Garland,20070729,90,4.555555555555555,49.12222222222222,384,102,282
A7QRQRS715GA3,Walt,20130224,28,3.7142857142857144,105.89285714285714,14,6,8
A7QT04TT3PXOP,PJ,20060826,34,4.147058823529412,198.61764705882354,385,27,358
A7RFDGVXDYQLJ,"JJ ""avid reader""",20110627,27,4.333333333333333,97.74074074074075,17,15,2
A7RPKJEFYYG66,Charles Clark,20081028,22,3.3181818181818183,45.04545454545455,19,15,4
A7S2T9FBK5FG2,"Caballo ""Jorge""",20121030,29,3.8620689655172415,46.51724137931034,5,7,-2
A7SK91SE8UZE6,"jasonstuff ""jasonstuff""",20081210,27,3.5925925925925926,104.03703703703704,36,15,21
A7SSO0H5OJ0PU,Dgarl,20111205,22,4.863636363636363,33.81818181818182,3,0,3
A7U359NTX7VBZ,"Scott D. Espenschied ""ScoDal""",20110925,36,4.833333333333333,162.30555555555554,20,3,17
A7UMES58JMQHE,Technobabble,20120605,22,4.090909090909091,79.45454545454545,51,14,37
A7UPJYPAH73NC,Douglas Figueredo,20070119,70,4.357142857142857,177.3,124,44,80
A7UZVUGYYPSDU,Harold A. Bouton,20080208,21,4.714285714285714,52.476190476190474,48,6,42
A7V03VUWQLLI5,"Daruin Solano ""Daruin Solano""",20100201,22,4.590909090909091,45.0,37,12,25
A7V2VGPSKWH4W,Patrick Stakem,20070103,27,4.185185185185185,42.111111111111114,117,7,110
A7VHSWMVWRNUL,Saint Mary,20130211,27,3.740740740740741,50.407407407407405,4,4,0
A7VUKZQ5EP4N2,Corey340,20081116,21,4.095238095238095,295.2857142857143,130,32,98
A7WBN2UA742J5,Nickie S,20131202,24,4.75,110.16666666666667,5,1,4
A7XVZ7JWJFUE5,bert,20120311,31,4.193548387096774,69.74193548387096,7,9,-2
A7Y64ICNNWLZ2,"David Monroe ""Derpity herp derp.""",20101117,31,4.258064516129032,258.83870967741933,64,12,52
A7Y6AVS576M03,gobirds2,20001003,37,4.72972972972973,103.13513513513513,558,71,487
A7YMD8MSOBO1I,Sharon Beverly,20100620,22,4.136363636363637,286.5,123,15,108
A7Z2J9V37ABCO,Justin,20131121,49,4.551020408163265,67.12244897959184,12,7,5
A804B6XUF6V28,John Regan,20121121,25,4.12,49.0,12,6,6
A80JWH5US7F6T,J. Wollens,20090203,30,4.466666666666667,173.63333333333333,346,45,301
A80Y1OBPWHVJJ,,20140713,23,4.086956521739131,19.565217391304348,1,0,1
A81M9AEYSQMF9,Morkgto,20130726,22,4.545454545454546,29.5,5,3,2
A823L2YB2FKBC,Dan Eppinger,20061020,28,4.5,167.25,129,28,101
A84FLVDK2R5JF,"Nathan M. Rose ""Movie Guy from FlickDirect""",20071003,94,4.287234042553192,72.63829787234043,80,73,7
A858GFQ1RXFKF,"Tracy S. Dryden ""TSDragon""",20091103,24,4.291666666666667,120.91666666666667,58,8,50
A85WY5ZDT8GXW,Woodie,20080203,36,3.8055555555555554,124.75,44,50,-6
A87CILADRIZW0,W1ll1am,20110506,47,4.723404255319149,58.4468085106383,14,1,13
A87N6UTYA6NOB,"B. Clark ""G35""",20090203,82,4.329268292682927,130.29268292682926,80,13,67
A87W2NKSYDMD6,S. Epstein,20000629,29,4.0344827586206895,305.48275862068965,328,27,301
A89Z4G9S94K3Y,Kevin Osborn,20080710,25,4.16,168.68,48,6,42
A8ANJNZAZQ6IQ,"Guitar Operator ""Guitar Operator""",20120708,37,4.108108108108108,307.0810810810811,97,4,93
A8AO9Z7V3SCIS,GadgetGuru,20110510,23,3.6956521739130435,68.0,26,33,-7
A8C8W7GO4RX78,M. C. Hall,20091111,27,4.62962962962963,65.66666666666667,12,5,7
A8CIFOCCN9G1P,"Longhorn ""go Texas!""",20110605,25,2.84,237.32,74,18,56
A8CKH8XB33XGN,Dave the Pear,20120128,91,4.252747252747253,73.64835164835165,22,19,3
A8CPQ7D8WSK2,Clever Name Goes Here,20070809,25,4.68,370.76,284,15,269
A8DUKFVG79KC2,Lauren Glenn,20090313,28,3.75,159.21428571428572,42,12,30
A8ETY0MLI9YQ1,Bob Sanderson,20120221,23,4.826086956521739,76.78260869565217,5,1,4
A8FKL1DHTHC12,Matt the Photographer,20110414,57,4.385964912280702,129.57894736842104,77,91,-14
A8FPP1EYJMQK8,"Philippe Jean Jorat ""Carpenter""",20080405,24,4.375,66.29166666666667,15,37,-22
A8G29WY725KQC,"T. Pendergrass ""History Dawg""",20080113,33,4.878787878787879,41.78787878787879,75,13,62
A8GR4PH5NW96V,Jennifer L. Rinehart,20100208,21,4.619047619047619,180.9047619047619,42,21,21
A8I7ZSX0J2BUA,"Brandon C. Diamond ""BDiamond""",20120404,47,3.9361702127659575,37.319148936170215,26,24,2
A8JHMCSJ2ZPG6,"K. Logan ""Mr. Shush""",20090311,21,4.666666666666667,141.57142857142858,6,3,3
A8LEFDO3AKIJP,"D. Salotti ""DS""",20120814,39,4.230769230769231,104.05128205128206,16,5,11
A8M5WJ8H1K4T7,Alex Alexzander,20071110,25,4.52,442.48,1959,80,1879
A8MXBXTJYMDQG,Anthony Casabianca,20090206,24,4.25,68.625,31,11,20
A8NMD12YXJKVC,"mmsumulong ""mmsumulong""",20110423,26,4.230769230769231,92.5,21,2,19
A8P6GIIQ6YQV8,Mikkel,20111128,44,4.2272727272727275,69.72727272727273,11,4,7
A8PUR3YT5LS76,BallaghMan,20071128,25,4.4,50.84,15,8,7
A8QYRG7TW491B,Thee~Classy~Gal,20080111,47,4.0212765957446805,81.48936170212765,15,4,11
A8SPPHKETDZ41,barbre,20040226,41,3.4634146341463414,138.9512195121951,211,63,148
A8TDR5HXUNQTX,"Patrick ""PCS""",20050502,22,4.045454545454546,289.77272727272725,59,7,52
A8TZ88OM8YOLW,MartyHansen,20010912,23,4.608695652173913,303.39130434782606,519,55,464
A8ULAPYGJ70PH,Carl Johnson,20071030,40,4.4,160.7,43,18,25
A8VPO4TPQTHZ7,Frank A. Terry Jr.,20110526,27,4.666666666666667,36.55555555555556,2,4,-2
A8WAYVOKYBLO6,Rane E Stark,20071224,39,3.6923076923076925,211.56410256410257,148,54,94
A8WEXFRWX1ZHH,"Goldengate ""Goldengate""",20060722,61,3.377049180327869,290.3606557377049,1646,142,1504
A8WWT8O05LCBM,Russ H.,20110523,35,4.4,121.28571428571429,15,4,11
A8WXLST0944GZ,J. Powell,20071216,46,3.3260869565217392,167.04347826086956,51,20,31
A8X478DM3KAWM,msn yin yang,20070522,54,4.222222222222222,79.9074074074074,29,13,16
A8X8D4BUY5DFU,Joseph M. Seda,20071104,52,4.25,51.69230769230769,187,43,144
A8YFJMSXIFDXW,mr nobody,20110207,21,4.476190476190476,51.04761904761905,10,4,6
A8ZEIMTD8NDOV,C. Kleist,20070910,25,3.88,149.0,98,29,69
A907V5E0QCBB1,andrew,20120316,22,4.681818181818182,172.8181818181818,25,8,17
A91451LWGKHON,Lindsey D Boozer,20121220,22,4.7727272727272725,109.36363636363636,4,1,3
A914TQVHI872U,An Educated Consumer,20070111,23,4.434782608695652,109.3913043478261,70,28,42
A91BVZEDZYEWW,"MP06011999 ""RESEARCHER""",20090615,22,4.363636363636363,207.22727272727272,84,23,61
A91JMW6Y6YMB5,Ricardo,20071217,23,4.3478260869565215,185.82608695652175,158,12,146
A91XC52Q1NUL6,Mark Demon,20111107,23,4.695652173913044,116.21739130434783,76,8,68
A923XAL9UCXIL,Ranty,20080903,29,3.9655172413793105,252.3448275862069,515,68,447
A92VR5THK15Z6,Whois1145,20100210,33,4.636363636363637,50.15151515151515,10,5,5
A937SB5J1H7O0,Cpt. Moonbottom,20130829,21,4.333333333333333,364.8095238095238,20,7,13
A93EEI4KTK5ZG,cameronfaust,20111018,21,4.380952380952381,59.523809523809526,7,1,6
A93LCEKKTMG7Q,R.D. Monsoon,20090222,23,3.260869565217391,314.4782608695652,166,42,124
A93PJD773AO07,Jammsac,20130526,27,4.444444444444445,30.37037037037037,3,6,-3
A93SRU78HLB2P,"Liz-ard ""person""",20120517,23,4.086956521739131,58.130434782608695,15,7,8
A94EFB6F2WH98,"Steve ""Steve""",20070731,21,4.0,42.523809523809526,11,8,3
A95A9XOSHTQKX,"YeahSoMaybe? ""computersandmusicperson""",20030929,32,4.3125,506.125,212,19,193
A95PWI4S6WHGL,"Dave ""Dave""",20090814,44,4.613636363636363,107.25,115,23,92
A969VLBBX8LQ7,George McAdams,20010322,21,4.0476190476190474,522.2380952380952,475,22,453
A96AON1A885W9,"UltraRider ""UltraRider""",20040112,34,4.352941176470588,54.0,7,14,-7
A96JD9312DHWC,"TorridlyBoredShopper ""T(to the)B(to the)S""",20031119,81,4.555555555555555,281.58024691358025,293,67,226
A96K1ZGW56S2I,"tvtv3 ""tvtv3""",20100216,31,4.451612903225806,250.09677419354838,49,5,44
A96TVYCTIM44J,Chust,20130420,31,4.774193548387097,56.32258064516129,7,2,5
A98SB5J3LLEJ4,fair review,20110525,29,4.551724137931035,99.6896551724138,30,8,22
A99AC7UERI09X,Milton E. Anglin,20070507,26,4.846153846153846,43.88461538461539,19,2,17
A99K7S15XOQ45,"Joe ""Joe Church""",20080730,35,4.4,140.77142857142857,35,9,26
A99RXN7BM9JV2,"Angel E. Valentin ""Photographer""",20100116,23,4.086956521739131,69.6086956521739,17,4,13
A99TG4Q2ZPW7S,"Blu-estLight ""MyEnglishIsGood""",20090925,32,4.4375,161.3125,466,29,437
A99TMXJYXUL55,Mark Z. Ciarleglio,20120622,26,4.461538461538462,54.65384615384615,19,2,17
A9A50VD2EU93F,John M. Wells,20071222,23,3.3043478260869565,136.43478260869566,310,151,159
A9AVOPGTAWJ1K,Gerry,20061018,21,4.333333333333333,202.23809523809524,88,6,82
A9BM9DY6EW9NO,joshmoutlon,20121029,42,5.0,39.357142857142854,11,0,11
A9BWUH9XKZ2DQ,"GUSR19 ""JimE""",20070328,33,4.575757575757576,46.75757575757576,36,10,26
A9C6O3H6RHU1H,Tom,20110603,29,4.448275862068965,100.27586206896552,12,2,10
A9DYWY9VOSP1P,"Lawrence R. Hudson ""Fatherhonda""",20020302,45,4.066666666666666,183.51111111111112,310,33,277
A9ELHLPXF7JKD,A. D. Lum,20000510,68,4.4411764705882355,289.3529411764706,1235,76,1159
A9FSJD6Z7QGJE,Gabriel Smith,20091116,24,4.125,133.45833333333334,203,41,162
A9GABRO29M0RA,Jeff Aski,20110226,22,4.181818181818182,176.4090909090909,422,59,363
A9GIGJUB98JNR,"Chen Sun ""WebAndNet.com""",20060903,37,3.891891891891892,166.56756756756758,69,29,40
A9GPCR9WJQCCJ,"Jim ""gearhead4""",20070313,24,3.5,126.58333333333333,13,16,-3
A9GTZU854XN0G,J. Tregaro,20090813,27,3.814814814814815,109.48148148148148,80,30,50
A9GWBCKURNXZS,"Charla ""WCS""",20130630,31,4.548387096774194,36.935483870967744,5,4,1
A9H9Q9VJB8OVS,Travinsky,20111219,32,4.125,99.15625,14,2,12
A9HR1VAVA865N,N. Zalog,20111229,26,4.730769230769231,84.8076923076923,38,6,32
A9J4UURM4OSDW,Michael Sandman,20030401,49,4.408163265306122,383.3469387755102,2472,77,2395
A9JFZ36PBLKTI,An honest reviewer,20130616,31,3.838709677419355,124.58064516129032,42,14,28
A9JWGWQUGB57H,Derek white,20120917,31,4.354838709677419,86.74193548387096,21,3,18
A9K96NWZI6ZKY,"Alan ""Alan""",20090120,26,3.923076923076923,172.6153846153846,29,15,14
A9LKB0MUQIVG,Harmless Gryphon,20040608,30,4.1,268.03333333333336,2720,101,2619
A9LNWA25IM2DX,"R.Suarez ""R-Suarez-""",20080619,81,4.1234567901234565,400.0617283950617,437,57,380
A9LZ6MRFYI6US,Nor'easter,20120814,25,4.2,63.84,7,4,3
A9MSL7WHLDC3O,"Steven Adamczyk ""Steve""",20101128,23,3.9565217391304346,213.30434782608697,33,3,30
A9NOZ2HSXI4YJ,"Ken ""Pop""",20090408,25,2.92,48.12,11,19,-8
A9P4Q7KX35RS2,L. Jones,20071114,30,4.633333333333334,54.9,12,4,8
A9PKYI8B9V9VB,"V. Vanderbent ""always curious""",20040223,23,3.739130434782609,167.82608695652175,261,47,214
A9PP3WNSG6TO9,Lare,20090220,24,4.708333333333333,77.41666666666667,75,9,66
A9PSPAXL7YIU8,Derrick,20120910,22,4.7272727272727275,91.0909090909091,12,3,9
A9Q4H18ZB2FVS,J. Fox,20130419,23,3.9130434782608696,71.04347826086956,12,1,11
A9TJ1ZSTUF9BV,"Phasr ""phasr""",20070114,39,4.564102564102564,33.56410256410256,10,1,9
A9VE14G2BW0V3,"Ryan N ""Ryan""",20131215,32,4.65625,108.96875,8,6,2
A9WBRCVLUZDUC,Coketogo,20140408,21,4.9523809523809526,19.80952380952381,2,0,2
A9WH4UX4OVGW1,"Nick Chill ""Nick Chill""",20080430,22,4.681818181818182,113.72727272727273,136,23,113
A9WRLOZQHHXE5,MEW,20140112,22,4.818181818181818,127.5909090909091,23,2,21
A9X2MLWQOALBW,S. Dang,20030406,27,4.185185185185185,232.22222222222223,128,11,117
A9Y4J1FD0O74Q,Sacha Potter,20101227,26,4.230769230769231,253.19230769230768,50,11,39
A9Y5O2R4D6EH5,Careful shopper,20050726,103,4.058252427184466,350.9611650485437,1319,134,1185
AA1H57BMNYYSN,Lane,20101221,30,2.8333333333333335,92.43333333333334,24,22,2
AA1ZYCEKJGG3A,"Nuri K ""nuri""",20100726,31,4.387096774193548,122.64516129032258,30,3,27
AA292EN15N5OW,Raymond Bibbs,20110804,24,4.458333333333333,49.625,5,4,1
AA3EFAVNZ9NWH,Ruthann,20101226,26,4.769230769230769,54.76923076923077,2,7,-5
AA3FTJYJYX55C,Robert Brown,20130422,51,4.0588235294117645,127.54901960784314,21,3,18
AA49OZ5Q2AG7R,Mike,20110313,22,3.8636363636363638,54.59090909090909,16,6,10
AA6176V2HKG16,"Scott Turner ""EngineerBoy""",20070907,34,4.117647058823529,194.0,69,12,57
AA67YKPROAME0,Lance,20120126,24,4.791666666666667,111.16666666666667,28,2,26
AA6K9WCIIUR4M,Jim Law,20130613,34,4.4411764705882355,65.6470588235294,8,1,7
AA75INOMAHULX,tadesegetahun,20130119,32,4.84375,31.03125,8,7,1
AA7P2NEC94K79,J. Pappan,20060221,41,4.2439024390243905,326.0,346,28,318
AA8JEQP5MBJJQ,"E. Lauber ""Serious about the book""",20090911,26,4.3076923076923075,47.07692307692308,7,4,3
AA8RBTN3J2F5H,R. Kent McVety,20100629,44,4.795454545454546,108.8409090909091,19,6,13
AA91O96C1Z18W,"Amazon Customer ""sunnyside44""",20010303,51,4.431372549019608,139.8235294117647,149,51,98
AA95DWUI3ODU,E.Barroso,20081105,45,4.066666666666666,56.51111111111111,82,41,41
AA98O5326L88T,"Aaron Silverman ""DJ Kuul A""",20080410,23,4.0,243.52173913043478,116,14,102
AAA0TUKS5VBSA,Nerd Alert,20090331,90,4.266666666666667,290.23333333333335,665,96,569
AAAQ1ZLUMTE2Y,creators ID,20131204,21,4.238095238095238,131.85714285714286,1,1,0
AAASGF96NSGUR,J*,20121105,23,4.3478260869565215,89.3913043478261,17,1,16
AABQ639S3SESX,BMP,20130314,25,4.36,107.12,65,7,58
AAEHOTZ1GRAUX,Jim Bernheimer,20110728,30,3.566666666666667,124.4,37,32,5
AAEVGE52KL0DJ,Tim,20110430,58,4.603448275862069,247.72413793103448,228,23,205
AAFQ08975CO3Z,JO,20110201,22,4.818181818181818,36.81818181818182,3,3,0
AAITWK3XHLI45,"Mark Goodwin ""Mark E. Goodwin""",20040714,23,3.391304347826087,196.69565217391303,48,118,-70
AAIU4V0FTRZ2N,Jorge J. Coelho,20090209,23,3.9130434782608696,492.04347826086956,289,35,254
AAJ1IYOUIHWF,D. Sun,20040123,32,3.5,179.625,171,62,109
AAJGG6HSSJZNF,M. V. Damiano,20070812,30,4.266666666666667,111.2,24,12,12
AAJIGWE242MSN,C. Stoneham,20041201,34,3.4705882352941178,302.97058823529414,497,66,431
AAJSQ8KWBU9U6,Mr. Rob,20120320,21,4.333333333333333,282.3809523809524,19,4,15
AAK5EKPY6Q0ZU,"count_zero ""ALC""",20060420,27,4.074074074074074,87.55555555555556,57,15,42
AAK6SOEJY30YG,Steven L.,20110507,48,3.9791666666666665,693.3333333333334,191,49,142
AAK7M9P1GEYWV,The Professor,20061204,34,4.235294117647059,123.82352941176471,54,31,23
AALR6CRH97JG1,"Amazon Customer ""NoClue-Really!""",20110604,46,4.369565217391305,319.10869565217394,113,17,96
AANO0VWL96ANQ,Jon R. Helms,20051015,26,2.9615384615384617,179.1153846153846,33,24,9
AAO3HB5GFT0IN,Ellis D. Rodriguez,20100924,23,4.260869565217392,178.2608695652174,26,8,18
AAOLRI08WOX02,Little Guy,20121128,22,4.5,54.31818181818182,7,3,4
AAOYSXSQU36FL,RoodyPoo,20121208,23,4.913043478260869,65.43478260869566,8,1,7
AAPPWNP9FWVWS,"Kathlyn Storey ""Kathlyn A Storey""",20061230,24,4.083333333333333,247.58333333333334,31,12,19
AAPRKGY5ZZ9XQ,"Lawrance Morrissey ""Beer & Coffee Snob""",20031211,25,4.32,341.68,236,13,223
AAQ9NJ480N9W5,P. Mulloy,20130227,89,4.550561797752809,32.674157303370784,9,4,5
AAQHZBILZ1B60,"Photoknut ""Photoknut""",20090408,26,4.846153846153846,86.1923076923077,15,0,15
AAR7CEPXYJA0T,"D. Mccauley ""Techie""",20100505,81,3.6296296296296298,95.82716049382717,144,148,-4
AARHLUIV2NNI2,William Bagley,20071229,28,4.571428571428571,554.8571428571429,242,20,222
AASZ0Q2E091DL,Richard R. Harewood,20100711,30,4.3,82.23333333333333,13,6,7
AATWFX0ZZSE6C,Faja4x,20060607,50,4.34,105.66,41,15,26
AATXK33K48V2C,"edward riddick ""katholmetal""",20081107,23,2.782608695652174,150.6086956521739,31,19,12
AAU5M4X3I03RD,WBoweIII,20120421,21,4.333333333333333,75.76190476190476,16,5,11
AAUNRE1TXXFSK,"Andrei Rusan ""ANdrei""",20100205,24,4.541666666666667,67.70833333333333,4,5,-1
AAUXZRNDAPH2D,"Clay Welsh ""welshc""",20100816,27,4.222222222222222,131.44444444444446,26,5,21
AAV3HU72C3R3G,Picturesque Music,20041113,25,4.0,346.52,611,31,580
AAW4JYVF4B845,Percy AllanO,20111126,40,4.15,53.375,22,47,-25
AAW7X3GRD8GY9,S. Barrett,20100307,56,4.464285714285714,71.0,50,11,39
AAWBS2IBQ0VAU,TP Reitzel,20100321,38,3.710526315789474,226.94736842105263,136,23,113
AAX5JSZIIUJ1S,Sturchionix,20130416,21,4.523809523809524,66.28571428571429,3,0,3
AAXAKFQEAQPWC,"2manytoyz ""2manytoyz""",20070708,51,4.666666666666667,61.490196078431374,30,11,19
AAXG160ES9P7G,Joe Pillera,20011105,32,4.90625,80.875,92,11,81
AAYB56GHHGB6R,D. Fox,20130403,37,4.648648648648648,196.97297297297297,65,4,61
AB07GJWJBDAQ2,S. Andrews,20120907,23,4.434782608695652,502.39130434782606,76,11,65
AB094YABX21WQ,J. Gregg,20100107,61,4.508196721311475,78.9672131147541,126,22,104
AB0Y33G717HOU,nsv,20080319,41,4.024390243902439,364.7560975609756,103,21,82
AB2QLDYMBY6YQ,Lynn,20121016,24,4.916666666666667,36.666666666666664,3,2,1
AB399AECXCDT8,"Patrick Regan ""Patrick Regan""",20100722,21,4.809523809523809,223.61904761904762,23,9,14
AB3F8IUK4NX4B,Anthony DeMore,20120104,34,4.911764705882353,111.5,60,11,49
AB4OR4Q9QZR3G,O. carrig,20100120,40,3.875,92.6,56,35,21
AB7T1DDG1HUOD,Naz,20111120,21,4.0,433.76190476190476,41,12,29
AB8AYATYO2EQ0,D. Valentine,20090506,26,4.730769230769231,37.88461538461539,15,7,8
AB8BVO0F3UKKH,Brian,20121129,26,4.961538461538462,58.76923076923077,22,7,15
AB8R8Y6OQV619,M. Ward,20110211,24,3.3333333333333335,52.458333333333336,14,9,5
ABAPF3XY1W6JX,TucsonShopper,20050817,41,4.536585365853658,370.5121951219512,755,102,653
ABB0A4D18DAC9,Second Nature Customs,20130228,22,3.9545454545454546,65.04545454545455,2,3,-1
ABB9MFBMQCD2C,S. Palmer,20090531,26,3.923076923076923,236.46153846153845,115,21,94
ABC68JUCPTVOE,"A. Fabbri ""afabbri""",20070307,40,3.925,213.35,303,55,248
ABDR6IJ93HFIO,"Daisy ""Daisy S""",20060812,152,4.907894736842105,333.42105263157896,5883,258,5625
ABDX7H5LA2IB0,Speedy,20080623,27,4.703703703703703,170.96296296296296,29,7,22
ABE5E8B3J7MKY,Jacob,20130925,56,4.821428571428571,43.69642857142857,9,4,5
ABFY4JR6IZFJ4,Taylor,20020326,25,4.16,152.0,87,8,79
ABH9D1TEOJ56E,jemaerca,20030613,40,3.95,321.15,2949,126,2823
ABIOKXT7U5YO0,"Jorge ""JT""",20100703,25,4.76,174.92,121,41,80
ABIVKBMSIPEDY,Kiyo M.,20050807,134,3.925373134328358,351.7985074626866,1041,116,925
ABIW740ZIEX6T,chewey,20120217,37,4.702702702702703,258.1621621621622,124,30,94
ABJ2HFAOLOGG3,nom de plume,20120130,26,4.153846153846154,79.1923076923077,23,19,4
ABKMVAM7J0XRU,Donna F.,20080722,24,4.416666666666667,106.375,58,22,36
ABKR7RC02WQLU,asdf,20110523,29,4.620689655172414,102.86206896551724,147,12,135
ABKUJX7YJZ3DA,"Mark Fellows ""Gadget Guy""",20040928,21,4.095238095238095,307.8095238095238,1330,48,1282
ABLYY7000Q9W1,Robson,20071027,22,3.1363636363636362,90.45454545454545,148,29,119
ABM0Q995KC344,"Deal Seeker ""Tony""",20090420,22,4.7727272727272725,166.4090909090909,9,3,6
ABMF4UC4Z00NT,trlamb,20080703,69,4.478260869565218,93.46376811594203,130,15,115
ABMN74TBW5UWE,Sidehop,20061212,49,4.510204081632653,353.2448979591837,214,18,196
ABMNX856X89CS,t.g. randini,20100715,49,4.36734693877551,103.61224489795919,88,46,42
ABNMD6670TV53,"R. Kolin ""Third Degree member since 1991""",20060518,43,4.093023255813954,185.3953488372093,168,25,143
ABOTQXNUBA1MM,Mark F. Braun,20060721,34,4.617647058823529,144.7058823529412,99,29,70
ABPP6J9PWJ25O,"Mike Curl aka RedonKiLaus ""Redonkilaus""",20110205,24,4.791666666666667,54.333333333333336,15,2,13
ABQEDHBG91BBR,There's No Stopping Space Vikings T. Edwards!,20070709,31,4.161290322580645,292.19354838709677,176,23,153
ABQU4N1Y7CIOW,Rodney,20110820,27,3.3703703703703702,151.44444444444446,42,12,30
ABQWEL10KO46C,Maiaibing,20021202,21,4.095238095238095,230.47619047619048,68,10,58
ABQWMANK4AR63,"John S. Dean ""John""",20020917,171,3.982456140350877,602.2163742690059,3264,257,3007
ABRCMQ9PO4T73,ASHEL S HUSTON,20130306,26,4.461538461538462,61.07692307692308,4,2,2
ABS2A1OWX5Q8,Fred Adelman,20130130,36,4.916666666666667,65.72222222222223,10,3,7
ABSYIF0ONC2AF,Lee,20051023,63,3.761904761904762,333.3333333333333,170,67,103
ABT82RWRGGZPK,"Dean ""http://web.mac.com/deank812/iWeb""",20041006,25,3.72,158.16,253,336,-83
ABTUNH7645QJL,Peter Reeve,20070922,22,4.454545454545454,182.95454545454547,58,20,38
ABU4LUKJU2QOY,Rusty Sly,20111111,46,4.804347826086956,99.6086956521739,74,8,66
ABU9XU71CASVB,Jimbo,20100205,35,4.142857142857143,238.17142857142858,296,23,273
ABUE0ALHKWKHC,Kiwi,20090619,54,4.814814814814815,158.44444444444446,90,19,71
ABUIRVLVTPFTZ,Marcos S. Aranha,20110108,27,4.074074074074074,31.814814814814813,42,27,15
ABUWUTWYZ8V1R,"Justin McBride ""TheGame21x""",20100226,28,4.142857142857143,755.2142857142857,519,86,433
ABVO9I9CCHRY9,Aakash Verma,20110112,23,4.478260869565218,126.30434782608695,4,1,3
ABVUI9GWVE5WW,Wobbles,20090922,21,4.0,98.23809523809524,41,18,23
ABVYGB2TKBO8F,"J. Donaldson ""Cal-diver""",20050110,122,4.385245901639344,328.23770491803276,1163,57,1106
ABW1G60W83B63,Danny V.,20110827,32,4.5625,46.75,8,2,6
ABXANRX4GPYRZ,hdtravel,20060517,82,4.317073170731708,96.08536585365853,619,453,166
ABXEFUVFKQLXT,"Matthew Parker ""I'm Batman""",20070112,33,4.424242424242424,84.03030303030303,34,5,29
AC0XZVJ918CJT,MJH,20121105,28,4.714285714285714,47.214285714285715,20,7,13
AC11GZAL5N99C,"missed ""mist.""",20060426,35,4.057142857142857,147.34285714285716,71,22,49
AC1YLEFC9AN5X,"M. Kelley ""mpkelley20""",20061020,58,3.9482758620689653,472.2413793103448,344,71,273
AC2278WPK3EU,Earle Williams,20110204,25,4.72,28.04,0,1,-1
AC22WC81PO65T,justmescotty,20101103,26,3.4615384615384617,82.88461538461539,6,69,-63
AC4XV78EJG1QB,Anne,20100919,26,3.730769230769231,356.2307692307692,74,41,33
AC4Z1ESFAVGNH,"Richard J. Mcgrath ""RichardMcGrath""",20100410,29,2.689655172413793,102.03448275862068,35,12,23
AC5HBS78GVA5I,Traveler4632,20110206,22,4.181818181818182,27.863636363636363,18,3,15
AC62SNVRI158P,"traderje ""traderje""",20081216,27,4.0,180.40740740740742,13,12,1
AC6CDB9KAFIJ0,"Steve of NorCal ""Spaceridder""",20120425,27,4.555555555555555,129.85185185185185,22,6,16
AC6LV5D2RKTIR,"Michigoon ""tech geek""",20040312,21,4.333333333333333,273.1904761904762,313,9,304
AC6Z7DP1Z5GHD,AWBoater,20070219,82,4.390243902439025,297.9756097560976,723,30,693
AC84VPM3281GV,Nando,20120712,25,3.68,127.0,15,3,12
AC8C9PT59CDW1,M.A.R.,20110808,36,4.666666666666667,62.19444444444444,9,0,9
AC8RCBKYQDOV0,N. Schweitzer,20040926,23,4.043478260869565,221.56521739130434,1834,110,1724
AC8YM4BB5LVOM,"Christopher Kuhn ""Christopher Kuhn""",20120517,25,4.52,138.24,130,39,91
AC922QV2PKD1K,D. Sherlock,20100503,33,4.0,87.12121212121212,12,11,1
AC9QEWWN4W9MC,Michael Chang,20120720,58,4.448275862068965,56.36206896551724,10,4,6
ACBTRDBXC322U,Mike,20130211,21,4.142857142857143,187.76190476190476,10,2,8
ACBYRARB15WL7,Walter W. Ware,20070513,27,4.62962962962963,73.44444444444444,27,12,15
ACCRTG2GO2ZAU,gogolac,20120804,22,4.2272727272727275,34.45454545454545,9,3,6
ACCUPJZUVRNT1,D. Woodruff,19991225,21,4.619047619047619,170.9047619047619,127,15,112
ACD6N5D1Q9KSD,Jaxter,20110129,28,4.571428571428571,50.785714285714285,6,16,-10
ACDJBTUIODRUR,"J. Mcghee ""V_RocKs""",20070213,36,4.694444444444445,188.11111111111111,32,13,19
ACDKUREJ2RKNQ,David L.,20090822,22,4.590909090909091,269.77272727272725,206,7,199
ACDZ7TXNS156I,ukswrath,20110927,21,4.761904761904762,49.57142857142857,3,3,0
ACEA95FQS1AVP,Jem,20071106,21,4.0,293.23809523809524,124,15,109
ACEB83MWVDWLB,William B. Partridge,20100414,21,3.619047619047619,571.3333333333334,2955,373,2582
ACG5SOTV11K7Y,Jpoe1977,20130314,23,4.608695652173913,42.78260869565217,13,2,11
ACGBJPEZC9VRL,Router user,20070610,36,4.305555555555555,102.08333333333333,37,2,35
ACH055GTTIGC9,"Robert of Niagara ""Robert""",20050211,32,4.53125,47.96875,94,17,77
ACHCC3FF7ISFH,BigAl64,20121007,29,4.896551724137931,44.6551724137931,11,4,7
ACHNM2BX18F1N,Mikesuper26,20101012,26,4.538461538461538,88.03846153846153,27,4,23
ACHTDPEQYSEQL,mhnstr,20030106,76,3.8815789473684212,529.8684210526316,842,78,764
ACISLJANCZZ6L,John E. Pombrio,20020919,29,4.517241379310345,272.9655172413793,582,51,531
ACJ9N7ED37HXS,"kstars ""truth-seeker""",20101118,23,4.434782608695652,134.0,15,8,7
ACJJAZXYC9K6X,"William A. Fuller ""The Old Bald Dude""",20080602,38,3.8157894736842106,128.97368421052633,65,16,49
ACJT8MUC0LRF0,D. Fowler,20100321,126,4.809523809523809,446.8968253968254,340,29,311
ACL0T7X1THPAV,"Bryan Cass ""Bee Ry Boogy""",20051108,45,4.222222222222222,348.73333333333335,546,74,472
ACMHR8V810O63,An old soldier,20070722,22,4.0,124.45454545454545,35,7,28
ACMRDAKUXXN5D,paul,20070712,23,4.391304347826087,63.73913043478261,10,1,9
ACMXHJV1KCOSV,wildcatgoal,20071213,30,3.1333333333333333,235.23333333333332,97,65,32
ACP9S40H3SHY1,Alloveramp,20120621,37,4.891891891891892,62.75675675675676,32,29,3
ACPV29SBTSTBS,"Robert ""rob_squared""",20131213,44,4.613636363636363,38.31818181818182,4,2,2
ACQYIC13JXAOI,Tooncesmom,20080718,78,4.461538461538462,272.7435897435897,407,72,335
ACRSBYVX737SS,snackdaddy,20101121,24,4.416666666666667,54.708333333333336,17,3,14
ACS10ZOB8XCGO,Jazzman,20121016,27,4.296296296296297,110.5925925925926,21,3,18
ACSCECQJQNT5I,TimTime,20091205,26,3.076923076923077,136.30769230769232,108,63,45
ACSEVXT6SHGTB,Rob,20120604,23,4.608695652173913,73.21739130434783,2,1,1
ACSX5AIZE3MJ9,Values Privacy,20030404,58,3.7241379310344827,205.8793103448276,431,86,345
ACUL2NEZAYUNG,Outta Control,20100417,23,4.739130434782608,124.56521739130434,28,8,20
ACVDL5QRCOPE1,D. H.,20030912,46,4.586956521739131,127.71739130434783,47,15,32
ACVQ6OMN2T773,S. Mayo,20050108,35,3.342857142857143,206.28571428571428,314,45,269
ACWI476GB6NT3,John S. Kjellman,20101002,35,4.942857142857143,116.68571428571428,25,2,23
ACX56BUIRXVTI,E. Ongerth,20100626,27,4.444444444444445,152.7037037037037,26,8,18
ACY9QYNDFLVBI,G. Farnsworth,20081101,74,4.702702702702703,273.3243243243243,392,32,360
ACYE8A0ULH8EX,John R Kucharski,20130310,21,4.523809523809524,46.714285714285715,28,5,23
ACYJ8CBX52FTG,TinkerMan,20080302,22,3.409090909090909,257.09090909090907,78,21,57
ACYMT1PL5FO9C,Reverie,20050218,34,4.294117647058823,110.76470588235294,63,8,55
ACYR6O588USK,"Groovin' guy ""music historian""",20080116,32,4.84375,185.0,75,30,45
ACYZXQ2JKPZKT,N. Hyland,20050829,60,3.65,276.81666666666666,203,256,-53
ACZ3LXCXN3RNQ,"HAPPYWOLF ""DISCOJAB""",20081112,22,4.136363636363637,154.4090909090909,49,45,4
ACZ4YI6UWRVOG,"Tell It Like It Is ""music lover""",20080123,37,4.648648648648648,107.02702702702703,97,16,81
ACZA9VXF7M84,M. G. Smith,20120308,36,4.0,85.77777777777777,11,7,4
AD05LV5A1SLER,"eoneill ""Ed""",20060726,21,3.6666666666666665,59.333333333333336,11,5,6
AD0J5KK4WQXNS,OverTheMoon,20040126,38,4.552631578947368,508.13157894736844,503,75,428
AD1MRUOBFE8FG,Selden Deemer,20090615,31,4.451612903225806,187.90322580645162,54,13,41
AD3EX5UG7UZPB,"Marcos ""proletariat""",20111101,24,4.041666666666667,233.04166666666666,104,6,98
AD4KIQJ587RRK,"F. Sealey ""Bonehammer""",20100524,24,4.791666666666667,69.25,14,13,1
AD6ZRUUUIVQPQ,B. Kim,20080621,22,4.181818181818182,163.0,27,1,26
AD73VMNYB8XVX,"S. Lee ""spamination""",20070422,43,4.3023255813953485,660.6976744186046,793,97,696
AD8DLOGHAXL,Robert Wurzburg,20090216,27,4.666666666666667,163.7037037037037,122,14,108
AD8SW8J7Z58QS,D. nguyen,20121211,21,4.571428571428571,41.23809523809524,1,3,-2
AD9Y4VOU9OB7P,Kent,20100611,21,4.095238095238095,130.9047619047619,67,9,58
AD9ZL63H0VKCZ,Amazon Customer,20110914,66,4.2272727272727275,42.333333333333336,32,7,25
ADAXXCMSLC0U9,JanewayCritic,20130228,35,4.314285714285714,67.25714285714285,23,4,19
ADAYT4YDXRSGY,Sais,20071220,25,4.88,63.32,50,15,35
ADBGPR5L7NVSJ,BooYaa,20080819,23,3.1739130434782608,56.73913043478261,83,50,33
ADCLKG10VPQKO,"Christian Bouchez ""VIP""",20070411,24,4.583333333333333,50.083333333333336,23,32,-9
ADDDFVHP3CSVA,Sistertex,20090508,30,4.266666666666667,181.76666666666668,19,10,9
ADE6RHHG0SWWM,Rick K,20121126,43,4.186046511627907,162.93023255813952,244,9,235
ADETB8KEATML7,"Joel Fritz ""Barrelhouse Solly""",20060713,24,3.75,76.625,7,1,6
ADEVBXUS0RSIR,"Alain B. Burrese ""Author, Speaker, Mediator, ...",20100527,23,4.478260869565218,333.95652173913044,33,8,25
ADEZOPMPKK146,Meli,20050124,27,3.7777777777777777,79.62962962962963,18,14,4
ADFLBRY00Y70G,M. Lohrke,20060517,30,3.8666666666666667,211.03333333333333,54,40,14
ADFLPF6FI3W0O,ASP,20091015,42,4.809523809523809,384.8809523809524,507,41,466
ADGO5A1QI41T,Soundaround,20121031,24,4.5,78.79166666666667,13,3,10
ADGOVXOE7QXXI,Amazon Customer,20091109,36,4.694444444444445,183.77777777777777,356,33,323
ADGR41H3B18M6,Scott Schiffmacher,20121208,28,4.392857142857143,78.07142857142857,4,0,4
ADHA1W879JNT0,dash-o,20010922,46,3.8260869565217392,119.04347826086956,148,29,119
ADHRZQ5I4BMMT,Robin,20110901,28,4.071428571428571,74.21428571428571,12,3,9
ADIEPB0AZ4RHE,Robert T. Johnson,20000515,25,3.76,173.8,172,55,117
ADKGE078JK8K7,"Vox Locus ""Vox Locus""",20090415,40,4.5,171.2,64,16,48
ADKXNP8VECJNO,MWCraft,20130509,22,4.954545454545454,86.5,5,1,4
ADKZ2C6WNK1GL,cduke,20061214,27,3.740740740740741,192.44444444444446,262,50,212
ADKZOXAOV8EXD,Doctor.Generosity,20060625,81,3.9753086419753085,395.5308641975309,2357,432,1925
ADLJYBOCPJAFE,Joecompute,20050930,22,4.090909090909091,64.31818181818181,47,41,6
ADLSTEHW1F5TO,"J. Murdock ""Web editor, wedding photographer""",20060311,37,4.513513513513513,98.83783783783784,151,10,141
ADLVFFE4VBT8,"A. Dent ""Aragorn""",20070310,431,4.296983758700696,472.1763341067285,19964,1128,18836
ADM2KFF1LEQIJ,siijiom,20111002,27,5.0,53.925925925925924,3,2,1
ADNV4SOGOMZXP,Toomuchnoise,20011125,29,3.7241379310344827,284.17241379310343,177,11,166
ADOR3TR7GDF68,F T. A.,20110308,92,4.304347826086956,58.869565217391305,109,46,63
ADOWRHG152JHT,Gary Washer,20080901,22,3.6818181818181817,131.86363636363637,46,9,37
ADP8ROI8NMNL2,Russell G. Moore,20071124,39,4.153846153846154,149.53846153846155,823,50,773
ADPKRJ2BSFJ0I,"Rolla Gravett ""Rolla Gravett""",20090923,55,4.781818181818182,395.6727272727273,1909,77,1832
ADQCQ7SL631JM,Caohu09,20120731,42,4.309523809523809,87.16666666666667,15,8,7
ADQM4H3YPICFF,Shyam Sundar,20070308,26,4.0,92.76923076923077,20,11,9
ADRH9RBV9NQS,Leopold Stotch,20130218,35,3.942857142857143,89.37142857142857,64,40,24
ADSROQOYIG7E4,Roy K.,20110826,26,4.1923076923076925,39.38461538461539,3,14,-11
ADSXIDO4TTTLA,"Rich U ""spousespy""",20101220,28,3.642857142857143,53.642857142857146,16,18,-2
ADVL2U934KERP,R. P.,20071207,22,3.727272727272727,148.36363636363637,41,15,26
ADVLRJS633OTD,"Susanna Hutcheson ""Copywriting for the Discri...",20030815,37,4.54054054054054,180.1081081081081,611,49,562
ADW43S8H5PDXQ,Curtywalk,20120620,31,4.967741935483871,34.25806451612903,5,4,1
ADWUJZ8865J2A,Old Codger,20100206,29,4.413793103448276,151.79310344827587,16,6,10
ADX6KUX4WWSJD,Jacob Thomas,20111102,28,4.214285714285714,97.96428571428571,1,5,-4
ADY00MBEP8ZYT,RphZiggy,20110415,21,4.809523809523809,72.57142857142857,29,6,23
ADY836HK6QSYR,"ardnam ""ardnam""",20100114,25,3.8,77.44,15,18,-3
ADYRLMDROBAXW,"K. Heim ""Klaus M. Heim""",20071115,34,4.705882352941177,122.38235294117646,143,18,125
ADZCAIKS5G8MM,M. Rainey,20081220,22,4.090909090909091,52.54545454545455,80,18,62
ADZEWNYAKTAWG,jimintexas,20091016,31,3.225806451612903,138.48387096774192,48,6,42
ADZF3QDGSZE7K,"LA Photo Ltd ""Photographer""",20091105,81,4.148148148148148,111.96296296296296,314,39,275
ADZIJQN6MNRAB,TRFB,20071223,29,3.793103448275862,231.72413793103448,101,62,39
ADZKP93810RSP,Aileen Chen,20061227,26,3.730769230769231,188.57692307692307,69,11,58
AE097AM7851QN,"Tonyzany ""tonyzany""",20040401,31,4.870967741935484,84.83870967741936,9,2,7
AE0BMVEVVU6DQ,"jp2code ""Joe Pool to Code .NET""",20031011,30,3.966666666666667,164.53333333333333,51,12,39
AE12AEJFCOGGY,"David Montgomery ""Book Critic""",20071022,28,4.0,113.96428571428571,14,8,6
AE2I87RNTD4TO,"Randy ""Frequent Amazon Buyer""",20111010,35,4.9714285714285715,71.57142857142857,39,3,36
AE2IDRV1J9E5I,"JeremyG ""JeremyG""",20101129,23,4.217391304347826,61.0,5,4,1
AE3NEOP21DAMR,"D. Ripp ""madredr1""",20100921,27,4.703703703703703,100.74074074074075,25,2,23
AE3PQYXY49FJB,Robert A. Schmidt,20090202,27,4.148148148148148,314.0,105,11,94
AE5CH27OYJ03L,Nite,20091105,29,4.413793103448276,94.34482758620689,30,4,26
AE5P348TMA3ZM,"baba ""dave""",20130710,33,4.181818181818182,32.696969696969695,9,2,7
AE5X7VOCIXCCD,Z. Wagner,20090820,40,4.425,426.6,694,65,629
AE6DDIKFMC2RY,uncle-buck,20020603,23,4.043478260869565,87.56521739130434,111,9,102
AE77GYKAKUIZR,thewaxtadpole,20100216,31,4.580645161290323,58.25806451612903,13,13,0
AE7J8067PMM1,"T. Lange ""Film Fan""",20130304,22,4.590909090909091,48.27272727272727,11,2,9
AE88D7OM7YU99,T. Anderson,20070622,65,4.0,170.66153846153847,225,70,155
AE982CUGWL9NO,"Jason T. Dameron ""Shaggy""",20090109,27,3.5925925925925926,44.111111111111114,6,11,-5
AE99FMA29NECB,cyber,20060416,26,4.5,111.88461538461539,56,9,47
AE9QWJETO90U0,"Hasan al-Basri ""hasan""",20080623,39,4.512820512820513,339.3333333333333,163,16,147
AEAFHD09X8044,PaceyPimps,20101112,76,4.118421052631579,46.36842105263158,24,32,-8
AEAPGAG8DXQLT,"Bruce_in_LA ""reader_in_LA""",20050820,35,3.257142857142857,177.9142857142857,537,25,512
AEASNN4Z1IWB2,Kristine Lofgren,20090113,42,4.642857142857143,333.6904761904762,102,25,77
AEB5O5LHW0TIX,John,20110805,25,4.4,146.8,15,3,12
AEC90GPFKLAAW,"Lisa Kearns ""Lisa Kearns""",20070126,37,4.5675675675675675,203.56756756756758,151,8,143
AEFTIUQHSVUFX,Joe Z,20110306,47,3.702127659574468,134.95744680851064,92,178,-86
AEGO6A1AFDTAV,aroundlsu,20120211,38,4.2631578947368425,75.8157894736842,19,5,14
AEGQWVR6KWBV,"Ron Cronovich ""Ron""",20050122,45,4.444444444444445,589.2222222222222,3481,155,3326
AEGW5F8A3RFXQ,M. J. Johnson,20090702,30,3.6666666666666665,90.6,39,18,21
AEIB3UR05OP7A,Tamriel,20131106,45,4.7555555555555555,206.55555555555554,15,3,12
AEIBNRIG1Q2CG,Ultimatum,20121011,23,4.521739130434782,108.21739130434783,25,5,20
AEIQ20BHN9JFI,Marty,20110814,31,4.580645161290323,108.74193548387096,102,18,84
AEJAGHLC675A7,John Williamson,20010305,210,4.761904761904762,607.7666666666667,3558,210,3348
AEL6CQNQXONBX,Cute Chihuahua,20081124,123,4.479674796747967,312.2032520325203,132,34,98
AELK0E5DK7LIZ,"Reuben Gathright ""rgathright""",20040316,41,4.536585365853658,306.2926829268293,110,30,80
AEM57NVIFQ8B9,FLYingG0D,20080216,27,4.962962962962963,185.33333333333334,45,2,43
AEN44U6T9R93,uktravailer,20071005,44,4.409090909090909,131.36363636363637,58,5,53
AENU742EV17J7,Calop,20120528,37,5.0,66.02702702702703,7,3,4
AENULRBQ2IE5I,Video Services Of Va,20100106,51,4.607843137254902,81.49019607843137,34,32,2
AEO637OEC31SO,A Customer,20071026,22,4.5,217.04545454545453,95,4,91
AEOCEVUWO5B7P,J. Page,20080120,24,3.625,688.875,1538,99,1439
AEOO3M4PS72NM,"John in SoCal ""J""",20110716,24,4.458333333333333,202.25,12,3,9
AEOSWWUZ6DO1G,Lisa in CT,20101115,36,4.25,85.25,28,12,16
AEOUQE9AUWJH3,Brian Northrup,20121213,22,4.363636363636363,92.54545454545455,4,5,-1
AEPJ23871S1Y5,The Resident Gourmet,20090916,26,3.8846153846153846,443.03846153846155,111,28,83
AEQYAG42F9128,BobL,20101129,42,4.476190476190476,92.23809523809524,17,5,12
AESPLVBQJCNC7,E. Kim,20071122,32,4.59375,459.6875,1943,55,1888
AETQIN7OH0RL9,"AllThingsTech ""JustBeNice""",20081227,49,3.4693877551020407,43.63265306122449,12,14,-2
AEUI462Q96CLU,bilbo,20110420,31,4.67741935483871,33.32258064516129,6,9,-3
AEUW6VD9XCVWD,Michi,20060306,26,4.346153846153846,240.30769230769232,412,15,397
AEVFEKNG7R7PM,The Bungler,20110302,21,4.095238095238095,96.28571428571429,18,2,16
AEWYUPCNDV7HY,"Modern Blue Argonaut ""No I do not have a shoe...",20070717,147,4.163265306122449,187.9387755102041,945,169,776
AEX12C4QA84BR,John F. Davis,20080727,24,4.208333333333333,64.66666666666667,27,6,21
AEX7F29JQ8HKB,"gn ""gn""",20090810,31,3.903225806451613,157.3548387096774,109,33,76
AEYKPDYE0CCG7,"WLF ""An Amateur Renaissance Man""",20081201,28,4.178571428571429,138.57142857142858,110,35,75
AEYNJAOO0AJ50,PLD,20110802,30,5.0,24.733333333333334,1,2,-1
AEZ0X08KA6GPH,"Michael ""Mike""",20070101,24,4.708333333333333,97.20833333333333,56,4,52
AEZJTA4KDIWY8,Herman,20130223,70,4.371428571428571,30.114285714285714,7,3,4
AF03NDXR2PIFX,B. Wilson,20060909,26,3.6538461538461537,356.3076923076923,131,15,116
AF32P2VFYIK9G,L. Vazquez,20100411,21,4.476190476190476,57.04761904761905,8,4,4
AF3BYMPWKWO8F,Joe MacBu,20050114,39,3.5384615384615383,176.89743589743588,178,36,142
AF3X7J0XC391L,"Stratiotes Doxha Theon ""2 Thes 2:15""",20071205,22,4.181818181818182,124.18181818181819,21,7,14
AF4YRU0KFXLIE,Jonathon,20081022,25,3.32,222.28,492,135,357
AF50PEUSO9MSV,Matthew J. Hodgkins,20100129,23,4.6521739130434785,73.65217391304348,18,12,6
AF5JLNO6H9GP5,"Mark Spicer ""Original Kings Fan""",20061106,26,3.6538461538461537,104.5,104,19,85
AF6A0DDUVY3DL,"Amazon Customer ""Brian L""",20060326,38,4.394736842105263,233.8684210526316,313,32,281
AF6XT53C8AEQF,Furball,20070121,36,4.638888888888889,88.11111111111111,70,13,57
AF76AAXINSF5E,"Jerry M. Hoffman ""Michael""",20090715,26,4.423076923076923,87.26923076923077,25,7,18
AF7AQHLX1UV1Z,Smoothbassman,20090623,39,4.487179487179487,155.66666666666666,182,35,147
AF7OI2CM20HQ6,James M. Bailey,20110304,22,4.2727272727272725,250.9090909090909,84,14,70
AF8SREA2XE7BJ,M. Karazim,20081123,23,4.3478260869565215,171.04347826086956,107,17,90
AF8XXTXR6MNL4,In the Middle of the Road,20051010,25,3.52,425.84,661,178,483
AFB7MSIPJIW68,Seph,20071224,36,4.0,146.30555555555554,56,4,52
AFBHHGKL81PDH,Papa Carlo,20080803,25,3.64,145.08,132,17,115
AFBUDZ63FOLVS,Nancy Famolari,20111228,29,4.896551724137931,169.27586206896552,57,10,47
AFCAZIM440BI4,troy groetken,20130111,21,4.476190476190476,29.904761904761905,4,4,0
AFCQ78N0GKHRZ,O. K. Maharaj,20090703,29,4.620689655172414,38.172413793103445,20,1,19
AFD4A8X2O85BX,"Nuke X ""Nuke &#62;&#60;""",20120202,23,4.608695652173913,119.73913043478261,34,3,31
AFDJGY68CQL2X,"Snail Dealer ""Snail""",20040425,47,3.851063829787234,244.87234042553192,101,28,73
AFE0AGQT50MBJ,KV Trout,20080518,30,3.966666666666667,249.26666666666668,144,32,112
AFFFKYHS1HICH,Mystri,20120329,27,4.7407407407407405,112.22222222222223,7,1,6
AFFVUZEGP1FDQ,"Morrigan Alexandros ""The Opinionated Me""",20021215,65,3.6615384615384614,231.76923076923077,70,32,38
AFH23MGAX2QS2,Heather moakley,20111210,33,4.606060606060606,42.303030303030305,10,3,7
AFH97KY1SBP2C,"Rivadeneira Luis ""Luis Rivadeneira""",20080326,45,4.2444444444444445,80.33333333333333,66,13,53
AFHF6LCXF2ZQJ,"K. Johnson ""Therios Pendragon""",20121229,22,4.545454545454546,147.77272727272728,37,12,25
AFHIUAR14924K,Marshal Shlafer,20130104,34,4.411764705882353,183.8235294117647,67,5,62
AFHYEO3Y1IIDD,maximum verbosity,20040929,57,4.192982456140351,259.9824561403509,199,48,151
AFICF7DKHTQ87,tabby,20070518,76,3.9210526315789473,127.88157894736842,147,71,76
AFIHZGX5DMIXS,Rich P,20081224,40,4.4,82.075,83,14,69
AFIR57I2Y901O,"G. F. THOMAS ""fredth""",20041119,35,4.228571428571429,169.37142857142857,441,74,367
AFJ6ZVBQG4LRK,Too Cold in Madison,20040919,22,4.2272727272727275,121.31818181818181,173,19,154
AFJIUOK9Z2DCB,J. Gonzalez,20081210,21,3.4285714285714284,170.04761904761904,101,90,11
AFJOSH1UTYUAK,"Amazon Customer ""Gadget Guy""",20080705,29,4.172413793103448,114.34482758620689,105,12,93
AFJQ74JJ2MFHY,"MD ""deek139""",20070901,36,4.194444444444445,107.11111111111111,29,9,20
AFLDLQHPSLAG2,F. Lum,20071210,29,4.137931034482759,94.6896551724138,32,22,10
AFM2J3HJNPIHV,E. Hansen,20120222,44,4.045454545454546,128.0681818181818,75,12,63
AFM65NU0UXIGP,"Ashton P. Johnson ""Zepaw""",20100517,23,4.434782608695652,84.95652173913044,28,2,26
AFM7FK7NFEKFZ,"Mark D. Schnittman ""mschnit""",20040906,42,4.785714285714286,195.35714285714286,219,25,194
AFN1L4WPOV13K,75mrclean,20121124,31,4.709677419354839,39.74193548387097,11,1,10
AFN32PGTZ31MV,B. Capossere,20091213,24,4.0,277.9166666666667,20,6,14
AFNG8O2DXRCUV,Amazon Customer,20100929,88,4.431818181818182,174.86363636363637,245,15,230
AFO6ZX2WU4DQ6,Sean Thomas Brady,20051112,24,3.7083333333333335,100.79166666666667,248,42,206
AFOI8LFZOXMFX,Audio Nut,20130313,27,4.37037037037037,298.5925925925926,63,11,52
AFPQPO5INP7C3,923,20090819,32,3.4375,39.25,28,58,-30
AFQBS241UKPAZ,J. Gitzlaff,20011212,51,4.03921568627451,283.4117647058824,1302,85,1217
AFR9GYKAHM37U,"J. Ciriello ""AdWhois""",20081004,66,4.606060606060606,242.04545454545453,100,18,82
AFSVO2X2ECRD2,chad d,20070429,22,4.181818181818182,160.27272727272728,98,28,70
AFUGKBB4J1NI8,Mainspring (Texas),20090320,33,4.121212121212121,203.72727272727272,20,5,15
AFUL9B8GMK9ES,Click,20130128,21,3.9523809523809526,150.57142857142858,35,10,25
AFV1DRHE0S4NN,D. Mutti,20101107,27,4.296296296296297,75.07407407407408,38,14,24
AFV2584U13XP3,Rich(Anime&Games Will Always Prevail!),20080924,30,4.633333333333334,210.9,34,11,23
AFX603VBYFH32,"PhotogDog ""KMW""",20081018,22,4.818181818181818,175.36363636363637,102,25,77
AFXN7YRQIBTP1,Spion,20090411,21,4.523809523809524,63.285714285714285,18,8,10
AFXTKAO0CB354,C. Weaver,20090216,56,4.607142857142857,219.53571428571428,91,7,84
AFYHI7VU26AWL,"T. Young ""Know it all""",20060726,22,4.681818181818182,248.6818181818182,107,17,90
AFYPYQAFA31JU,"Sam M. Tannenbaum ""Sam""",20091217,38,4.131578947368421,255.68421052631578,183,34,149
AFYQ9V4XBVCJ1,The Rothwells,20070104,25,4.12,185.44,52,24,28
AFZDEQJQZRY0M,"Zyx Zy ""Zyx Zy""",20111129,24,3.5416666666666665,49.791666666666664,9,7,2
AFZJNYR931ZCN,"The Lunar Staff ""Moonlight Entertainment & Sales""",20100325,28,4.321428571428571,167.57142857142858,36,8,28
AG0PM9IAHQ06C,Photographer,20080221,50,4.46,157.84,84,12,72
AG1OL1K3SFURN,W. Munro,20070509,36,2.9722222222222223,194.91666666666666,517,96,421
AG1X2EJ1Q7K3A,Dan G. Hiris,20070619,24,3.2083333333333335,155.66666666666666,89,51,38
AG2F4CZ5SUIG,L.N.,20120514,22,3.5,96.72727272727273,12,4,8
AG2YXYIQ8TLTA,"CandysRaves (and Rants) ""CandysRaves""",20090604,59,4.101694915254237,226.27118644067798,400,47,353
AG35JCCQWDRCS,M. Winchester,20061109,93,4.623655913978495,69.3763440860215,70,18,52
AG3G6Z8MA7KT6,Erica Reid,20061223,24,3.875,401.1666666666667,42,21,21
AG3PVU7DCXZTK,"Coffee Infusion ""coffeeinfusion""",20070312,22,4.181818181818182,446.3636363636364,106,9,97
AG4LBEYRCWT9S,RumPunch,20110827,33,4.363636363636363,43.72727272727273,29,22,7
AG5WSXI52FPKH,"Janet Mieses ""Janet Mieses""",20061202,49,4.081632653061225,115.12244897959184,55,39,16
AG6JJG6UOKBX,Dr. Rob,20080207,43,3.883720930232558,222.41860465116278,28,5,23
AG6TX1ZJHLMO7,"W. Dietrich ""WD""",20081205,72,4.388888888888889,170.80555555555554,175,43,132
AG7EF0SVBQOUX,"WriterGirl ""WriterGirl""",20020915,79,4.493670886075949,109.0126582278481,143,11,132
AG7UPJV2IDKTO,D. Thornton,20100724,22,4.0,72.22727272727273,22,12,10
AG82E6H4S6OS6,Bob,20090116,21,4.523809523809524,174.85714285714286,56,5,51
AG8E2F0G98ZTB,Fritosgirl,20080825,36,3.9444444444444446,226.33333333333334,52,23,29
AG8YP2XTC5X1I,JG McClung,20120516,44,4.5227272727272725,87.13636363636364,16,3,13
AG90OGHDGOOVH,David Stapleton,20050522,45,4.4,244.11111111111111,279,71,208
AG9G4VUJB6709,waetherman,20070706,27,4.0,393.6666666666667,242,23,219
AGA6B9FHJ6HY0,D. McNevin,20060303,24,4.208333333333333,263.6666666666667,88,16,72
AGA7LFNS3YUXC,Leslie,20110725,22,3.9545454545454546,134.0,11,3,8
AGABK3PVA79PH,J Prince,20110919,36,4.333333333333333,40.5,16,4,12
AGATRDOFW48DK,"D. W. Moore ""Enthusiastic Amazon Fan""",20071011,47,4.0,144.4255319148936,319,79,240
AGBI77112XBJ8,Lars Tarsim,20120504,28,3.6785714285714284,65.42857142857143,9,3,6
AGC3LVDTAXMS4,Chris,20090404,34,4.794117647058823,74.08823529411765,117,20,97
AGCN38LIJZM3K,piratesmvp04,20100203,27,4.037037037037037,232.25925925925927,36,9,27
AGEKVD8JPZQMT,"M. Rodriguez ""Cnyper""",20071111,64,4.078125,166.3125,76,32,44
AGET557COBM9W,Mike Stearman,20130530,21,5.0,108.42857142857143,12,5,7
AGEWOMQ90BV8R,J P Kazarian,20110507,44,4.2727272727272725,202.47727272727272,44,5,39
AGF7UR8Y6TA7O,Jeffrey Chandler,20100407,28,4.678571428571429,221.78571428571428,103,15,88
AGFSSC5DBY2HU,GX,20080914,65,4.153846153846154,124.95384615384616,70,39,31
AGFUJAPEIOEXR,"Hermin Hollerith, Maker of Tacky Wreaths in t...",20061003,22,3.8636363636363638,341.3181818181818,90,10,80
AGFW667QNHDOY,S. Lipson,20030829,38,4.052631578947368,147.6315789473684,62,32,30
AGG0HXKRG5HGO,"umeweall ""Packrat""",20070130,25,4.52,203.92,32,38,-6
AGGAQLXPVGM5D,Eagle Vision,20050309,101,4.455445544554456,333.5742574257426,942,54,888
AGGDI4VWPPZ6J,Lfmiller,20090705,23,3.739130434782609,243.69565217391303,21,14,7
AGH2LG47Y3B1S,Bob Smith,20070626,21,4.095238095238095,116.9047619047619,41,13,28
AGHXKB22N9DYR,Steven N. Tidwell,20100327,22,4.636363636363637,86.77272727272727,7,2,5
AGHZXQL9F94T9,"superman2k3 ""superman2k3""",20011120,60,3.6166666666666667,190.6,2642,471,2171
AGILRZOT49R0V,Kyle Swenson,20140310,40,4.475,48.075,4,1,3
AGJ0DW8O7D9FL,CMac -Amazon Addict!,20121226,28,3.4285714285714284,138.78571428571428,18,6,12
AGJHZ41VBGK51,Matt,20121103,34,4.735294117647059,68.82352941176471,28,15,13
AGJP7N8ZXPTJ6,M. Cox,20050525,23,4.478260869565218,59.130434782608695,208,21,187
AGJRUK27RBVYS,Ivy,20050608,73,4.273972602739726,212.0958904109589,178,70,108
AGKEC06AD4DRQ,KRob78,20110221,31,4.612903225806452,182.29032258064515,42,4,38
AGKUAO9LYVRWS,steven,20130111,22,3.5,41.77272727272727,3,3,0
AGLN54GTQYW7E,ableekertomorrow,20111101,21,4.619047619047619,46.857142857142854,7,0,7
AGLT3L7ALL4O4,"Dennis J. Marko ""DennyJMark""",20100123,47,4.9361702127659575,42.212765957446805,13,6,7
AGLWD7FVS8E1L,"BasicTek ""Tim""",20100803,25,4.52,141.4,15,3,12
AGLWST5RM8LIZ,"SpinChin ""Spin""",20050115,37,4.27027027027027,74.48648648648648,18,15,3
AGN4YVQ5VDDFZ,jesse,20121023,21,4.142857142857143,211.95238095238096,40,5,35
AGNMQ4QQK7LUY,Aron Hasler,20131122,23,4.913043478260869,124.30434782608695,13,3,10
AGOH8N902URMW,"Zeb ""zebra01""",20050720,119,4.512605042016807,75.00840336134453,256,156,100
AGOPJZFEL0Q1E,"Zube ""kile25""",20041028,34,3.764705882352941,312.02941176470586,595,95,500
AGOS889EYCZ6I,Memaw 43,20121010,34,4.794117647058823,46.55882352941177,81,23,58
AGPCM2O0UCMTX,"Kenneth Chen ""Ken""",20071201,25,4.48,175.72,49,14,35
AGQ47IY7KG18W,"mg New York ""mg""",20081003,22,3.0,320.77272727272725,36,12,24
AGQIQ1TEW7H5R,P. M. Gross,20060219,22,4.0,266.09090909090907,1583,59,1524
AGR1V15L6FLMA,The Goat,20110207,67,4.477611940298507,291.5820895522388,949,62,887
AGSC327PXS3W6,"D. Musicant ""Muse""",20080215,22,4.363636363636363,422.95454545454544,29,5,24
AGTCIEB44ZATU,Marcelino Maldonado,20120523,23,4.3478260869565215,50.91304347826087,10,5,5
AGU7QAWZOHQIN,Wellard,20050809,23,4.304347826086956,47.34782608695652,10,5,5
AGULX4C472DRJ,TA,20090816,31,4.290322580645161,57.32258064516129,3,1,2
AGUMYIY3DFG9G,"Tin WS ""Tin WS""",20111218,23,4.956521739130435,68.56521739130434,17,0,17
AGUR7X3147WQE,"V. Mekkat ""sparseseller""",20100525,26,4.5,61.69230769230769,23,6,17
AGV0RUQJHFW3S,cortezhill,20070921,23,4.739130434782608,325.04347826086956,22,29,-7
AGVB3UZIPFHEF,Sheldon,20000420,28,4.535714285714286,210.92857142857142,511,29,482
AGVDI7RLT24WJ,"J. Schwartz ""JMS""",20090510,28,3.5357142857142856,185.39285714285714,216,32,184
AGVWTYW0ULXHT,"Nathan Andersen ""Gadget lover and author of S...",20050302,224,3.9642857142857144,368.3794642857143,1168,132,1036
AGW89PD8KONRV,Jonh B,20110330,25,4.08,40.52,7,3,4
AGX2K0FMS0IVL,AC500Driver,20070615,49,4.163265306122449,89.44897959183673,123,41,82
AGXMC3ITWZASE,JDP,20061108,91,3.978021978021978,374.2857142857143,4033,180,3853
AGXV8E7XK9J6H,"Brian Koch ""Aspiring Photographer""",20060427,66,4.181818181818182,177.5909090909091,2211,117,2094
AGXY576DF2CJ2,zaskarmark,20120225,33,4.484848484848484,64.0909090909091,21,18,3
AGY4FYFIF9MV8,RooRoo,20101129,23,4.521739130434782,91.69565217391305,19,8,11
AGYBSEOZESADQ,IronChefMIk,20110328,32,4.4375,111.90625,9,2,7
AGYH5U11ZKPFB,kannibul,20110830,68,4.455882352941177,137.16176470588235,62,19,43
AH0AFSL6ZQ3I7,Stuff!,20120831,25,4.8,42.12,8,1,7
AH0IIQG2EFQRS,"Live to read "".""",20070323,27,4.703703703703703,131.0,47,7,40
AH1KJ45IQTM4T,Benjamin,20071001,25,4.24,244.12,90,44,46
AH1YEEL96S2ZH,HLN,20051027,21,4.190476190476191,251.71428571428572,300,125,175
AH222ZE7KMRK4,Erik,20110927,22,4.2727272727272725,97.04545454545455,2,2,0
AH3LF9RAD1O2V,Mark E. Armesto,20110929,49,4.775510204081633,35.204081632653065,9,3,6
AH3QW8UQ4ULZN,Batman,20110715,25,3.2,71.52,8,13,-5
AH5BCMZELZSKG,Dave,20081006,41,3.975609756097561,203.78048780487805,43,13,30
AH5CDC3T02Q2Q,S. Clyde,20071207,21,4.619047619047619,105.0,16,6,10
AH5FLKVQAG7F6,"C. Ozkurt ""deluxe""",20060726,30,3.8666666666666667,145.0,83,45,38
AH6LK8GMDVH31,"L. Allen ""MIX_MASTER_ICE""",20090303,23,3.9565217391304346,215.3913043478261,548,73,475
AH6OYB8SIKPE9,Gabriel Orellana,20121218,32,4.25,33.625,10,29,-19
AH79X9T2G9XSI,Micah,20070108,28,3.9642857142857144,235.85714285714286,159,58,101
AH8KXPIWHPMMR,"Joshua Driggs ""ZapWizard""",20090209,36,4.166666666666667,188.75,135,8,127
AH9AUW175XCVP,Sam Archer,20060203,24,3.4583333333333335,216.125,367,58,309
AH9FCFS4PCUVE,Kenneth,20060114,29,4.689655172413793,104.6896551724138,51,14,37
AH9TWUFZUPR8V,"Greg Vaughn ""Greg Vaughn""",20120202,28,4.5,60.142857142857146,9,4,5
AHA7D2A0EWVYR,Jer,20110322,28,5.0,45.5,1,2,-1
AHABEDNSQKM6H,"Scott Rose ""Computer Geek""",20020208,23,3.260869565217391,244.56521739130434,697,103,594
AHBJVK85QLGCI,JRod,20110112,31,3.6774193548387095,182.74193548387098,132,42,90
AHCK96KL7JVGW,"Lawrence M. Russo II ""Stargazer""",20020217,23,4.565217391304348,51.26086956521739,50,28,22
AHCNG15YD2Y8E,Floline Media,20110307,28,4.857142857142857,41.5,3,0,3
AHD3NZHDUZ5I6,"BarryG ""Editor""",20080224,46,4.130434782608695,196.2391304347826,245,53,192
AHDCFV4SRGJ95,R. Barrett,20080104,21,4.619047619047619,91.61904761904762,19,2,17
AHF4I1FSIHABC,John Lee,20090802,69,4.6521739130434785,47.01449275362319,100,34,66
AHFGCH8LANEZK,Dana G.,20090625,38,4.2631578947368425,264.36842105263156,56,15,41
AHGT53AWMWCSR,Stuart I. Riley,20110413,21,4.333333333333333,52.142857142857146,7,7,0
AHGYNZ1588WLB,Allen A Anderson II,20130429,26,4.230769230769231,24.96153846153846,0,1,-1
AHI30QTAFQMTW,Pol,20130418,24,5.0,22.75,1,0,1
AHIJR9QVBQFFV,jeff,20091107,21,2.4285714285714284,107.19047619047619,53,91,-38
AHIK7BUXFRMT8,David Bower,20070118,64,4.546875,269.40625,345,44,301
AHJ0U4V74OVIP,Bill King,20030516,25,4.6,217.44,138,40,98
AHJ1JXHUSF4ZP,Amazon Customer,20130723,21,4.476190476190476,123.57142857142857,4,1,3
AHJ3Y5H9NAPAO,ruthlmut,20120113,43,3.9069767441860463,51.18604651162791,26,7,19
AHJ4CB7OIWU4K,Michael Simpson,20100911,31,4.612903225806452,289.6774193548387,108,7,101
AHKMCPVQXC26G,techno,20071129,24,5.0,60.666666666666664,34,8,26
AHKOC7T4ZOGQL,Aussiebat,20071230,21,4.428571428571429,136.1904761904762,30,5,25
AHLDQ5UNL75KC,LisaNCentralTX,20120421,21,4.904761904761905,71.66666666666667,9,8,1
AHLF5V8B3Z8C7,-=Rudy=-,20130305,31,3.6451612903225805,202.96774193548387,18,4,14
AHLG6LQX62K83,JJ,20111206,22,4.545454545454546,42.09090909090909,16,3,13
AHN86VFJIJ2JP,Chicago Book Addict,20090219,43,4.232558139534884,388.0232558139535,139,26,113
AHNHLGKIZ2N3B,"D. R. Jeanclerc ""Reader, Listener & Obsessive...",20021219,61,4.0,335.1475409836066,463,28,435
AHO34W7GMCNAC,Nicholson,20090504,21,3.8095238095238093,179.1904761904762,72,20,52
AHPLBX6P72Y1F,murilo silva,20110801,23,3.739130434782609,12.0,0,7,-7
AHPV4F8IVSC39,"Douglas B. Moran ""Computer+History/Politics""",20090415,28,3.9642857142857144,1366.357142857143,3226,200,3026
AHQRU3MRORIWQ,"EMTP EJ ""EJ""",20070809,98,4.275510204081633,187.55102040816325,555,90,465
AHR86ZEYETLJI,Berny,20100929,64,4.59375,36.171875,39,7,32
AHRNDSKWH1YBT,M. Hertzler,20070626,23,4.3478260869565215,182.6086956521739,127,30,97
AHROSV6WJOEGY,"John Faughnan ""John G Faughnan""",20011201,54,3.314814814814815,226.24074074074073,609,106,503
AHS6PX6H22WW1,"H. Wang ""jwangamazon""",20040622,66,3.909090909090909,234.5151515151515,298,63,235
AHSZLG5LCYVBW,Ricky,20121029,22,4.409090909090909,78.9090909090909,7,6,1
AHT0OKUU37JEI,Jeffhdz,20050103,35,4.3428571428571425,206.82857142857142,408,40,368
AHT4UI0DBJSOY,"Robert Wittenburg ""hardbags dot com""",20121204,32,4.875,39.6875,5,1,4
AHUT55E980RDR,Neal C. Reynolds,20121006,23,4.260869565217392,51.34782608695652,4,0,4
AHVM1K3YGXMAE,"PC Guy ""Keith""",20070623,22,4.318181818181818,141.3181818181818,39,8,31
AHWWT58FO5TW4,Brandon,20101005,26,4.269230769230769,76.3076923076923,121,35,86
AHXV3DA6QJRPY,Michael J. Scott,20070830,25,3.92,125.56,80,12,68
AHY2KG32696ES,SL,20010207,27,4.222222222222222,296.4074074074074,874,65,809
AHZUV9VVAOO1Z,"anthony lang ""parent""",20100526,22,4.681818181818182,37.40909090909091,7,2,5
AHZXCNIUNEXVS,"Rilee James ""Rilee""",20120918,22,3.6363636363636362,147.0,17,2,15
AHZYI1KAJSQP6,Sardonic,20070312,34,4.205882352941177,221.26470588235293,64,28,36
AI0BCEWRE04G0,Stoney,20050913,64,4.359375,717.28125,717,47,670
AI0MFWI85NG0H,Edward,20101118,21,4.857142857142857,103.0952380952381,20,7,13
AI1J8UQELHK8L,B. Greenstone,20041017,28,3.642857142857143,98.35714285714286,111,46,65
AI1SBMID464QA,KC,20100910,26,4.0,73.03846153846153,20,6,14
AI1SSQELYZGLB,C. Hinton,20120601,26,4.346153846153846,44.53846153846154,2,2,0
AI2AOCTC8BQVZ,Aris Abeleda,20090106,46,4.586956521739131,39.04347826086956,23,6,17
AI31FF4LD7UNC,Man Friday,20121207,27,3.925925925925926,61.629629629629626,21,4,17
AI32AO3TTCTY7,Art the Science Guy,20070521,27,4.518518518518518,333.48148148148147,104,11,93
AI43VKPN5NF7D,"Edd Anderson ""ezduzed""",20070209,32,4.46875,133.375,41,9,32
AI45IA9VYM9EL,"Rob Iversen ""Blessings, Robert""",20050922,33,4.424242424242424,52.09090909090909,14,17,-3
AI4IVU5XKXPCU,BobG,20061001,22,3.6363636363636362,156.22727272727272,74,18,56
AI5EIS34J73QB,Sam,20080302,43,4.627906976744186,415.4186046511628,1286,106,1180
AI5OS4RQQIUMJ,Amy S.,20010914,34,4.088235294117647,256.1764705882353,379,25,354
AI8EMB0HUC6Z5,"Tyler Forge ""realist""",20040211,117,4.461538461538462,181.71794871794873,364,72,292
AI8HOA8K4QU2L,sloshbg,20101128,24,4.583333333333333,133.08333333333334,98,16,82
AI93LF8UZEBNX,"M. Bilberry ""The Oracle""",20111013,23,4.260869565217392,129.2173913043478,17,4,13
AI9OK9EA8JAUM,Sandy,20090804,24,4.333333333333333,206.75,150,34,116
AI9VYV5E5ZCBY,"John Conley ""Trinitydoc""",20111117,30,4.233333333333333,248.1,64,13,51
AIA5WY7MZG3J,"Leif Arnseth ""Larnseth""",20121126,25,4.84,40.6,9,10,-1
AIBRTGBN07D6A,Scott,20031228,68,4.029411764705882,483.55882352941177,1799,154,1645
AICYK7WZA9Y4Z,"Vaughn Seavey ""sportyinc""",20090327,30,4.466666666666667,92.6,32,9,23
AIDEC29YPOKIR,robk64,20120914,32,3.34375,121.03125,36,16,20
AIEEK7AHXKZCC,BeatleBangs1964,20100624,27,4.7407407407407405,126.48148148148148,38,27,11
AIEOH19T22OQC,R. Mok,20011122,23,4.478260869565218,174.82608695652175,81,12,69
AIFGQVI9S0Z1M,"R. Sauder ""Amateur Photographer""",20090202,21,4.9523809523809526,61.285714285714285,48,28,20
AIFIR7HW14ONC,USFA,20081114,31,3.6774193548387095,118.45161290322581,15,10,5
AIFLY2HF8NS8U,Andre Lawrence,20070908,80,4.475,309.8,829,118,711
AIIBD0NIYCK5K,"R. A. MYERS ""R A Myers""",20100802,28,3.75,53.357142857142854,5,1,4
AIIHOI3SOYJPT,"James Hatsis ""AHR""",20050814,27,4.481481481481482,85.77777777777777,412,37,375
AIIR8E34EDKCQ,- Kasia S.,20031225,23,4.478260869565218,138.3913043478261,51,20,31
AIJQU979J6UFY,"Nick ""whereishawkins""",20021021,152,4.296052631578948,243.05921052631578,1142,166,976
AIKDYQA4NKI7A,"Peter A. Johnson ""Uli""",20110402,30,4.633333333333334,149.1,43,9,34
AIKF0CR89YAKD,Rich Tefft,20101005,23,4.0,64.52173913043478,129,4,125
AIKGBCYBXVH8I,John L. Holt,20060508,27,4.481481481481482,169.33333333333334,99,8,91
AIL6VNBJC2MDF,"Amazon Customer ""owner, Victory Photos""",20090615,34,4.352941176470588,85.23529411764706,39,10,29
AIL8Q0STSY5Y5,Maximo R. Arratia,20121207,26,4.6923076923076925,91.46153846153847,7,10,-3
AILMTQNLB90RV,4lan,20120308,23,4.391304347826087,72.6086956521739,11,5,6
AILWN0QU28S1Y,Amber beach,20121231,32,4.65625,34.03125,7,0,7
AIM4GJ54RUZP0,iDex Media,20110922,25,4.64,67.96,19,3,16
AIN6TC48EL5HQ,Ken,20120828,21,4.285714285714286,60.19047619047619,21,7,14
AIO00LM9IL7FA,Empiror22,20130722,45,4.6,150.75555555555556,14,4,10
AIOPD46ZIV8K2,"Rick V ""Bargain hunter by day, shopaholic at ...",20030527,45,3.9555555555555557,436.0,1268,75,1193
AIOR855KQQPTN,greygeek,20110109,31,4.161290322580645,73.87096774193549,21,8,13
AIP0VIGQWIW90,"Candra C. Georgi ""mommy of many""",20071227,26,4.230769230769231,134.6153846153846,49,20,29
AIPIIXXMPQ8EC,Hunter,20111215,22,4.681818181818182,56.59090909090909,13,6,7
AIQF9JR56XHFO,Stephen,20111223,22,4.590909090909091,77.54545454545455,4,9,-5
AIQHYSPJHKUHB,OIObserver,20110725,26,4.730769230769231,207.8846153846154,150,29,121
AIQORT9402J1F,"B. E. Zimmerman ""bezimmer""",20070323,26,4.346153846153846,223.6153846153846,111,7,104
AIRZAEK6LLYQ,Slowleadmccey,20130715,23,4.217391304347826,82.34782608695652,4,4,0
AISSIRI0N0I57,Moe,20071226,22,4.2727272727272725,185.77272727272728,54,4,50
AIST7V8XF4A18,K.C. Cole,20070917,41,4.2682926829268295,211.14634146341464,302,68,234
AITU3Y0ZFAIN2,"Amazon Customer ""David P McIntosh, Sr.""",20130702,29,4.689655172413793,106.37931034482759,9,3,6
AIU93YMNWEKI7,"Gordon M. Verber ""Gordon M Verber""",20040124,32,2.875,351.0625,251,108,143
AIV7ZG68SDY2C,jcg,20110202,30,4.833333333333333,135.73333333333332,34,6,28
AIVU1J51MJ9O2,"Vaughn ""The answer man!""",20080714,37,3.5405405405405403,355.5945945945946,1034,56,978
AIXXEOGCBC4XL,"Snoosh ""snoosh""",20070322,28,4.678571428571429,172.92857142857142,54,5,49
AIXYLCK9HK2B0,Movie Fan,20060906,21,3.6666666666666665,130.66666666666666,44,48,-4
AIY1W4VEIIXTG,SE,20101123,21,4.904761904761905,38.142857142857146,2,2,0
AIYRZY7FRX2DX,Nathaniel Bannister,20130628,25,4.72,37.08,8,0,8
AIYX8VIO0EV13,John Guarino,20070207,23,4.6521739130434785,133.2608695652174,74,4,70
AJ00DXOOCDL2C,"Kaleberg ""one_kaleberg""",20041006,21,3.6666666666666665,181.9047619047619,37,34,3
AJ0HFDY5BB77Y,Michael Trotman,20030513,33,4.121212121212121,162.96969696969697,264,42,222
AJ1LU3RW7N0XG,"Jermey Moore ""Jermey Moore""",20090914,36,4.805555555555555,54.05555555555556,9,5,4
AJ22XNZC2377X,Kevin d.,20070614,32,4.53125,164.03125,54,24,30
AJ2ASPAWC0SLV,Michael L. Williams,20080613,23,4.304347826086956,57.78260869565217,15,14,1
AJ2ICMO59T3H,J. M. Taylor,20060328,40,4.225,486.05,300,16,284
AJ62SC0HYEKU,Capt RB,20041129,26,3.9615384615384617,408.9230769230769,824,182,642
AJ62Y7TMV60MO,Coffee Lover,20080630,21,4.428571428571429,78.33333333333333,49,4,45
AJ6H9ZV7TJUUT,lizellis,20040101,23,4.304347826086956,214.6086956521739,97,14,83
AJ6TMOHHFJJAJ,Ali Navaie,19990723,27,5.0,73.96296296296296,75,27,48
AJ6WCVOY4HP06,"V. nicholas ""vinnieme""",20011102,32,4.53125,114.78125,71,25,46
AJ7KOFJGTZL9B,Robert D. Green,20120106,28,3.6785714285714284,29.678571428571427,5,22,-17
AJ88Z1U0SS1IY,"Tim Warneka ""Leadership Expert, Keynote Speak...",20070218,22,3.909090909090909,157.5,781,81,700
AJ8SVXL3SJN7T,"Grider ""Just Horses""",20071214,23,3.9130434782608696,84.73913043478261,317,15,302
AJ9AE2BVND0GS,R. Phillips,20080311,40,4.5,179.875,132,33,99
AJA8ABXYA9B5O,John,20110220,24,4.791666666666667,48.083333333333336,59,1,58
AJAG2J6G119C6,Ron,20060212,28,4.5,184.89285714285714,48,7,41
AJAYKDFVFPIBS,Soohyun Yoon,20110404,30,4.333333333333333,84.36666666666666,46,8,38
AJBHBY6FHBP5N,Benchernif,20110922,34,4.5,148.2058823529412,104,11,93
AJC9NUPSUZAA8,Shaer,20090414,30,3.533333333333333,133.33333333333334,261,263,-2
AJCHGS1GND4OA,Bloose,20110109,31,4.451612903225806,171.8709677419355,27,6,21
AJCR7L4AXL2OG,J. KNOWLES,20070109,26,3.423076923076923,140.42307692307693,142,15,127
AJED3FAM7RGEB,Richard,20080125,23,4.956521739130435,253.1304347826087,423,14,409
AJEOFP6ZWY0MK,A. Kim,20080629,59,4.237288135593221,156.27118644067798,148,15,133
AJGZH8VFWTTIJ,J. Myles,20090920,30,3.1,202.0,91,37,54
AJHL7N62ROBOQ,Jamielee,20120713,21,4.285714285714286,48.333333333333336,6,2,4
AJHLJWTCLZVL,"Edward G. Dickau ""Ed. Dickau""",20090630,23,4.739130434782608,150.7826086956522,179,20,159
AJHP62V8IVMMN,"rprice54 ""rprice54""",20071029,22,4.090909090909091,292.0,264,13,251
AJJ4Z626IVKNZ,The Thinker,20090518,22,4.5,162.4090909090909,42,6,36
AJKNYHVQ554SF,"A. Sosa ""GRRROWL""",20110610,24,4.833333333333333,38.125,5,5,0
AJKOHFCVD85UP,"Radio Man ""yarns13""",20051225,29,4.310344827586207,603.9655172413793,1471,123,1348
AJL3U764D7NI3,"Jack H. ""-~-~ Jack H.""",20100127,50,4.7,92.44,204,24,180
AJLPNPDPR5HAB,Borat's Bad Brother,20100127,21,4.619047619047619,151.42857142857142,66,12,54
AJMT9QTS71UYR,"Amazon Customer ""'bent Rider""",20070214,23,4.565217391304348,39.65217391304348,7,3,4
AJNDPOWEMJXOM,Desert Peep,20100315,21,4.428571428571429,167.57142857142858,29,2,27
AJNNNF726KSEA,"Scott Peterson ""I.T. Sme""",20070103,29,4.448275862068965,313.2068965517241,144,23,121
AJNZQZVL8MG6P,nathan,20080330,26,4.5,227.1153846153846,133,8,125
AJP569L5Y2RJH,cruzer01,20121221,43,4.186046511627907,23.53488372093023,3,2,1
AJPKDAFL8B7MO,Charles E. Paddock,20120504,22,4.363636363636363,57.72727272727273,1,2,-1
AJQDIT55SZ3ZX,kindred spirit,20061117,46,4.260869565217392,167.2826086956522,133,32,101
AJQT7GBTWVU9Z,SlickBuyer,20110104,23,4.608695652173913,133.43478260869566,14,5,9
AJQU565NQC6C6,alacom,20110316,24,4.666666666666667,55.666666666666664,53,5,48
AJRPJN2EQ18B6,William E. Baldwin,20091109,29,4.068965517241379,42.172413793103445,3,17,-14
AJS95SB2XJXHN,Anthony5362,20120310,23,4.043478260869565,429.4782608695652,348,304,44
AJT2XS3UJ9WIK,"begoldn ""Ben""",20121115,35,4.628571428571429,44.142857142857146,6,1,5
AJV985MKGCIQ0,"Barbara Rhoades ""Jackie of all Trades""",20110513,21,4.476190476190476,160.14285714285714,17,8,9
AJX9A4Q19UTJU,eau,20041119,78,4.448717948717949,296.5,140,33,107
AJXDBMJBVUGSR,S. H. Wells,20100406,24,4.791666666666667,163.66666666666666,147,47,100
AJXEHSG4MZZ0U,Aaron Schug,20120318,33,4.9393939393939394,233.3030303030303,71,6,65
AJZ6BJ38MF78W,RL,20130106,28,4.392857142857143,45.142857142857146,29,2,27
AJZR37LXKSI7P,Dan,20101202,25,4.44,27.88,6,30,-24
AK0CENM3LUM28,Amazon Customer,20090625,38,4.078947368421052,347.13157894736844,76,19,57
AK1EZMEQ66HOO,"Michael D. Newcomer ""Photography Junkie""",20080808,30,4.2,216.9,286,30,256
AK1WNXTHNCG5V,"Mynana ""Nancy""",20080118,36,4.444444444444445,54.05555555555556,29,69,-40
AK2KBFOYR6YLQ,Christian,20070329,21,4.0476190476190474,226.42857142857142,101,16,85
AK3GKIV8DEY8B,ubat,20060409,78,4.641025641025641,268.97435897435895,860,73,787
AK3JYG6417WKU,Dayton56,20120714,37,4.135135135135135,110.5945945945946,64,5,59
AK4HKI46S49NA,P. Nguyen,20080618,21,4.285714285714286,118.42857142857143,188,15,173
AK6FTDBW6WCLC,"Kathy A. Pippig ""Author of Shape-Shifter Books""",20060719,36,4.416666666666667,157.11111111111111,129,17,112
AK8LOFYRZJJW0,C. Wollin,20090827,30,4.466666666666667,158.76666666666668,46,8,38
AK9BXHEXOOM6Z,John L. Miller,20110118,54,4.537037037037037,237.6851851851852,106,13,93
AK9FTWLCW09RR,Techie Evan,20100218,21,4.0,262.5238095238095,126,10,116
AKAQ6IK4NCK2B,klopez,20110901,21,4.285714285714286,39.476190476190474,8,2,6
AKAWRBIYP8S4B,Mr. Gato,20100124,21,4.571428571428571,92.47619047619048,6,3,3
AKBCJ2J6KA4K7,"Daniel Morrow ""value vulture""",20120811,22,4.909090909090909,49.59090909090909,2,4,-2
AKBVYIIHWI04B,Ron Texas,20070501,51,4.588235294117647,70.68627450980392,24,3,21
AKCDHGUSKVJ72,"LeelaFry ""Leelafry""",20131110,23,4.565217391304348,131.91304347826087,5,1,4
AKCZIJ6ZHE41D,"Jarucia Jaycox ""~A Pink American""",20080625,48,3.6458333333333335,176.625,59,25,34
AKDIEY3APNBR,D. Corbishley,20020826,34,4.735294117647059,46.88235294117647,50,11,39
AKEWAJI47QR06,DarcieMae1121,20110331,23,4.826086956521739,48.130434782608695,2,4,-2
AKFOHJ9R66KUN,"Amazon Customer ""With 2 rambunctious boys""",20121129,43,4.162790697674419,66.30232558139535,2,3,-1
AKFTR2Z33Y0BJ,Nelson Gruber,20100705,22,4.681818181818182,61.0,3,0,3
AKGQJ67FY4YDT,Chris,20130216,43,4.465116279069767,91.11627906976744,22,7,15
AKH6N84CBOBJ6,Eric Mars,20080603,32,4.65625,208.71875,313,51,262
AKHFY3VCNZL2W,Dan Huse,20060705,27,3.925925925925926,290.74074074074076,332,67,265
AKHWJ2V8KRZRZ,"Tech Weenie ""T. Weenie""",20081129,29,3.586206896551724,138.86206896551724,122,34,88
AKIXYRKZLI1XW,"Grimmace ""Grimmace""",20071227,28,4.785714285714286,59.25,18,2,16
AKJHHD5VEH7VG,Dominique,20081231,44,4.590909090909091,173.11363636363637,45,10,35
AKJV6HC44VD6I,Howard Blair,20120111,25,4.16,55.32,13,4,9
AKKQ4Z9P5H0RT,Robert B.,20130426,26,4.6923076923076925,91.76923076923077,7,1,6
AKKSHEGRQVQRK,Great Movie Addict,20040818,25,3.32,352.8,186,123,63
AKLO8S04YXCJC,"BetaTech ""Technology and Product Design Revie...",20111215,27,4.962962962962963,67.96296296296296,35,4,31
AKLUFVL8A311U,"John Bean ""beaner""",20070216,28,3.75,124.14285714285714,54,32,22
AKOMCT01A2S0I,Amazon Addict,20120208,21,4.523809523809524,144.04761904761904,91,12,79
AKP9TEMA1T01X,H,20101204,35,4.428571428571429,114.48571428571428,14,1,13
AKPYS9VSM3LNX,moose_of_many_waters,20071129,37,3.675675675675676,176.02702702702703,205,58,147
AKQHNTUAL056P,R. Larson,20080107,23,4.608695652173913,120.69565217391305,23,4,19
AKQU6FNNO6MWR,Photochic,20071007,21,4.190476190476191,98.47619047619048,52,7,45
AKR1784RF0DSA,Willem,20110527,35,4.314285714285714,37.885714285714286,5,4,1
AKRNGCDD9833G,Koveh Tavakkol,20090929,29,4.448275862068965,62.827586206896555,19,8,11
AKS2YNH0JVXW2,Mace Moneta,20110819,28,4.428571428571429,72.0,71,7,64
AKS623GKL5ZMX,mrooobaa,20090402,21,4.476190476190476,237.0952380952381,88,4,84
AKS80VIR3HK51,Doug Milligan,20030503,26,4.230769230769231,127.15384615384616,138,27,111
AKSFZ4G1AXYFC,"C.E. ""Frank""",20091222,53,4.264150943396227,136.67924528301887,154,21,133
AKSQNMIKOU01H,,20111213,53,4.264150943396227,125.9245283018868,37,5,32
AKT0Y6J9AK469,"GumbyTheCat ""Gumby""",20101231,21,4.857142857142857,351.9047619047619,47,1,46
AKT8TGIT6VVZ5,John Kwok,20010228,87,4.942528735632184,178.98850574712642,1618,408,1210
AKTRAFS0TWYDV,A. Pulido,20100216,25,3.68,46.04,12,7,5
AKTTQR1I1EGGP,SUPERDELL,20121113,28,4.392857142857143,104.0,43,26,17
AKU18EGFF6G02,Amazon Customer,20100101,44,4.5,166.11363636363637,397,16,381
AKU6UCK068L9H,,20120101,21,3.142857142857143,171.42857142857142,16,19,-3
AKVY3FDMU42ZA,Dwig A. Morales Aldana,20120928,24,5.0,41.166666666666664,2,2,0
AKWFWHW5ROIZS,R. Blacker,20080531,30,3.966666666666667,108.76666666666667,44,11,33
AKWP7LOOOF3NB,RW,20110306,25,4.44,204.0,72,6,66
AKX9EQ37PAYMY,Gepetto,20070910,64,4.65625,55.609375,67,14,53
AKXDZEBFFCAWA,Tutungzone,20111220,27,4.7407407407407405,59.81481481481482,4,3,1
AKXT3E60ZZQCY,Gadget-Guy,20121005,30,3.8333333333333335,113.2,29,29,0
AKYDGCKCY7H9F,"R. W. Milyard ""GearJunky""",20080318,33,4.212121212121212,137.3939393939394,85,16,69
AKZFA72JANYIK,J. A. Thomas,20080618,21,4.809523809523809,28.38095238095238,4,1,3
AL0U9DBGLCZ26,Moxy,20111007,23,4.0,42.47826086956522,5,5,0
AL1VDLRRY5UEP,hamid mazuji,20110528,21,3.3333333333333335,196.52380952380952,14,32,-18
AL1XV4L25FZ2S,GameMaker,20060618,65,3.9846153846153847,143.2,189,56,133
AL2J625PUH5VW,"Nicholas Winn ""E-Bike Enthusiast""",20060818,25,3.84,280.28,175,54,121
AL391IKGQ8SB,ReeViewinit,20101127,22,4.7272727272727275,76.13636363636364,31,1,30
AL3G7RTXMGLDQ,E. Sikorski,20101112,29,4.758620689655173,106.79310344827586,22,2,20
AL3MFYSK9HKCL,"Amazon Customer ""Not all who wander are lost-...",20080107,26,4.076923076923077,337.0,145,16,129
AL42PIIG5DXYD,"C. Arnold ""Multimedia shtick""",20080810,45,3.8444444444444446,199.3111111111111,67,12,55
AL4RXZBQFPJLE,dr. lowbrow,20060729,21,4.523809523809524,80.0952380952381,73,8,65
AL4YOB7KRVQ9W,T. King,20081202,42,4.761904761904762,84.71428571428571,52,9,43
AL51TV7OIZJ4G,"Joann L. Allen ""Jody""",20120919,24,4.291666666666667,38.5,5,5,0
AL59UPQT963PD,"Steve Walker ""Computer Guru""",20080202,21,4.9523809523809526,30.714285714285715,14,2,12
AL5CUWBFBMWYQ,"Jay ""jason_j_a""",20061026,62,3.629032258064516,185.83870967741936,480,54,426
AL6BBQ6E0V098,"David Rowell ""Kenfolk""",20101030,28,4.607142857142857,89.32142857142857,20,12,8
AL73NEC9YOLQB,John Q Public,20130409,21,4.857142857142857,40.19047619047619,6,0,6
AL8KY5MD92YE0,Stephen T. Porter,20061124,23,3.347826086956522,181.0,38,13,25
AL8U6FF27WZF2,"R. Cole ""areohbeeceeohelee""",20060816,23,3.4347826086956523,172.1304347826087,203,48,155
AL9WKVMRI6GFB,JMM,20100325,69,4.043478260869565,228.02898550724638,349,102,247
ALASXHUMAOVH9,"C. Antunez ""charlie""",20070514,21,4.428571428571429,34.523809523809526,10,2,8
ALDAF4VVLFRHP,Patricia Brouillette,20081216,143,4.538461538461538,85.20979020979021,227,19,208
ALDSX6IFBJQV1,"Not My Real Name ""Really REALLY!""",20030625,28,3.5,51.642857142857146,16,9,7
ALG2ICFVV11ZH,David Post,20120409,29,4.172413793103448,75.72413793103448,11,2,9
ALG4MGOY96EW1,H. A.,20110107,32,4.90625,167.8125,322,22,300
ALGI34BYWIXZG,Nishant Agarwal,20071013,35,4.628571428571429,226.02857142857144,199,31,168
ALHC64J88LVWO,Wayfinder,20101216,49,3.6530612244897958,252.87755102040816,414,48,366
ALHNJGPDV4EC0,cmarti,20111128,30,4.733333333333333,85.66666666666667,20,8,12
ALHWZSTAELK9I,Scott,20111231,32,4.53125,50.65625,12,2,10
ALHX1KDNFZX40,Jim Kavanaugh,20111004,22,3.8181818181818183,53.40909090909091,1,1,0
ALICSOW9JNXCD,"Ahmed Roberson ""A.Roberson""",20070506,30,4.8,102.46666666666667,108,8,100
ALK45J9W5YD2Z,Richard Raleigh Miller,20100907,23,4.478260869565218,81.34782608695652,9,5,4
ALK65O8KZWRTP,ercadm,20111004,25,4.64,206.4,26,5,21
ALL9XFM0Q1N4E,Monopoly J,20120515,25,4.6,51.44,12,2,10
ALMIAEBIQQMT2,"Steve ""SF Lover""",20100328,30,4.6,160.1,8,1,7
ALNE7Q71JFC0F,Meowcat,20071129,47,3.6382978723404253,79.31914893617021,196,60,136
ALNFAA0XTWP7G,Dik,20131204,26,4.5,46.76923076923077,10,19,-9
ALNFHVS3SC4FV,"Darena Shopz ""darenashopzatoutlookdotcom""",20080617,45,4.355555555555555,181.0888888888889,110,16,94
ALNH0LZHUYS91,"SeaScavenger ""GuyAtTech""",20090317,21,4.380952380952381,121.9047619047619,60,30,30
ALNYO7MW7ALT0,holson,20081212,23,4.0,73.69565217391305,14,4,10
ALQ4USPEQ9L5N,Shopaholic,20080712,74,4.162162162162162,212.64864864864865,243,35,208
ALRCAGJOJ9583,Gabriel's Buddy,20050131,79,4.189873417721519,324.2911392405063,354,41,313
ALS5SVPGWX1S6,Matthew Miller,20071009,21,4.095238095238095,137.0952380952381,85,10,75
ALT4TFZTMNY0J,"Ozgur Bozkurt ""ozzie""",20111104,32,3.53125,102.375,38,8,30
ALT6JYQLLRHU9,PDot4,20110820,23,4.086956521739131,38.78260869565217,14,5,9
ALULIUA0F7BCK,HM,20121204,22,4.590909090909091,173.4090909090909,43,5,38
ALUNVOQRXOZIA,Conrad B. Senior,20000621,70,3.5285714285714285,241.97142857142856,478,189,289
ALUTHT4U058KZ,M. M. Jackson,20040909,25,4.2,355.48,192,41,151
ALUV2YKWZENKK,bored99,20020720,44,3.3636363636363638,298.8863636363636,431,139,292
ALV1J4KEXAGIO,"Sir Michael ""cruising and musing""",20080714,27,3.962962962962963,87.74074074074075,31,13,18
ALV2NT16V4QR6,Howard,20060707,26,4.1923076923076925,119.92307692307692,109,8,101
ALVN2GRE2YCI4,JJ50,20120208,33,4.393939393939394,58.515151515151516,5,37,-32
ALVYD6HBLYI0W,"D. Johnson ""Chi-Town Dale""",20060106,34,3.411764705882353,350.5882352941176,156,35,121
ALWDAFXI10T2J,Joe,20100524,23,4.869565217391305,50.30434782608695,4,0,4
ALWIPFLEEH17M,"LinuxMan03 ""Jib""",20100308,24,4.791666666666667,131.58333333333334,29,10,19
ALWJ2CUC3AMWA,,20140720,29,4.379310344827586,19.17241379310345,1,1,0
ALXAQM2YIBQDG,servant74,20081214,32,4.5625,61.125,12,4,8
ALXDCS16EP3ZR,nel,20101224,38,4.921052631578948,25.68421052631579,13,7,6
ALY0PX65WSYZC,Bob G,20101221,28,2.5,207.39285714285714,318,34,284
ALYU98KL3VUGF,Enche Tjin,20080623,38,4.578947368421052,627.4473684210526,1368,60,1308
ALYZJ7W14YS26,iiiiReader,20110525,36,4.638888888888889,174.19444444444446,91,17,74
AM004PHO6F3FZ,gotta run now,20020606,22,4.2272727272727275,269.95454545454544,138,7,131
AM0QLU79O05JR,Book buyer,20050120,57,3.1228070175438596,65.40350877192982,297,1109,-812
AM1D8O2CRCAE0,"Ric Corless ""Ric C""",20061231,25,4.6,116.12,56,8,48
AM2PAP6COUV5J,Sreenadh,20100711,39,4.641025641025641,298.8974358974359,179,26,153
AM3XNQU9TZBD8,"G. Perez ""Always having fun!""",20080514,68,4.676470588235294,220.5441176470588,474,60,414
AM44PJKDQAIQM,"William ""Skeptic AstroImager""",20090328,24,3.3333333333333335,182.95833333333334,30,17,13
AM488EUDHF6Y4,"SG ""SG""",20080824,29,4.379310344827586,312.7931034482759,109,61,48
AM4B440XXHZOJ,"Brian C ""Bobazonski""",20100107,32,3.9375,160.96875,100,11,89
AM54L2VVKBQZO,S. Young,20101126,21,2.4285714285714284,114.14285714285714,125,70,55
AM5KHH0X4XO05,Joe H Stanley,20130204,24,4.708333333333333,43.125,7,3,4
AM6ZNP09P201W,Murphy,20090118,26,4.153846153846154,75.8076923076923,4,4,0
AM78WFHEBDBGM,Headless,20080714,28,3.9642857142857144,88.10714285714286,53,22,31
AM7U4FXXNE02I,Clockwork,20120507,31,4.129032258064516,26.677419354838708,14,17,-3
AM7VNKKUJK97J,"Judith A. Kling ""JKling""",20081212,22,4.0,110.22727272727273,18,14,4
AM8W6Y3HVXLZT,"D. P. Schroeder ""Paukenwirbel""",20061118,51,3.784313725490196,369.03921568627453,562,84,478
AM8W8U0WS9ROC,Land Cruiserman,20100422,24,3.9583333333333335,249.16666666666666,106,42,64
AM9APPMIE1BHZ,Sparky Jones,20070109,55,4.3090909090909095,176.03636363636363,286,51,235
AMB055OLLSUIG,Dan PCFL,20110826,22,4.7272727272727275,36.13636363636363,8,4,4
AMBFK6N4JS5Z2,V. Hutson,20090123,44,4.386363636363637,150.0909090909091,339,50,289
AMBJQQSRCAOHS,Jon Stall,20090801,24,4.916666666666667,101.58333333333333,23,8,15
AMCDIZ86RP7L,TFB,20071129,23,4.260869565217392,100.43478260869566,74,16,58
AMCPTON572D5Y,yungjeezy,20110701,24,4.25,68.04166666666667,31,17,14
AMENL0QOY5NVZ,candmakr,20111219,23,2.4347826086956523,59.56521739130435,27,44,-17
AMF9A7V2KG839,"Digital Photographer ""Used to Like Nikon,s""",20041012,27,4.074074074074074,146.25925925925927,584,137,447
AMFXXAOVV4CPJ,"4America ""4america""",20090105,47,4.468085106382978,93.87234042553192,29,25,4
AMGUWDM3XPEEB,M. Alexander,20090724,31,4.548387096774194,138.2258064516129,99,13,86
AMIGNB1M92Z7E,Roblife,20111107,23,4.304347826086956,187.1304347826087,18,13,5
AMITEU7SWPRL,"R. Talbot ""Honest Reviewer""",20071222,22,4.181818181818182,115.72727272727273,24,58,-34
AMJP4TN5PTOUM,L. Mateo,20100211,21,4.190476190476191,222.85714285714286,57,7,50
AMKNPIDFLRFMP,CS,20040404,61,3.918032786885246,174.44262295081967,438,59,379
AMKXRFHOQZCIQ,Christopher Miller,20001002,23,4.695652173913044,138.3913043478261,144,4,140
AMLXY5B95T869,J.C.,20070304,24,4.291666666666667,170.58333333333334,17,3,14
AMMCRB2V0D8EZ,"Rahima Willowbend ""KSA Kid""",20090620,22,4.7272727272727275,120.86363636363636,38,6,32
AMN59P8GDKYTZ,"Mike Khashaiar Kojoori ""mike kojoori""",20100805,21,4.285714285714286,96.95238095238095,21,5,16
AMO1CR5KN8T4P,"T. Arnall ""Terry Arnall""",20070518,21,4.0476190476190474,48.23809523809524,9,2,7
AMO1MLSIJSQOF,Ivan W. Ong,20070706,47,4.51063829787234,136.63829787234042,229,34,195
AMO9Q6HVHIQP7,junglecatimages,20120722,22,4.7727272727272725,62.0,1,0,1
AMOXREQFUZU1A,esmphoto,20090115,24,4.75,83.5,63,7,56
AMOYNXOULN53C,"K. Smith ""CakeLady""",20090221,37,4.756756756756757,43.891891891891895,33,9,24
AMP5WITG8PCCM,"Amazon Customer ""Ron Gillum, MD""",20070321,21,4.619047619047619,60.76190476190476,12,7,5
AMP7TQRWAIE84,"Adrian Cooper ""That Guy from Venus. :D""",20060327,21,4.0,253.0,69,22,47
AMPGRXQMO89X9,Faye L. Bowring,20080430,37,4.8108108108108105,119.27027027027027,32,3,29
AMPX3331B26QH,"just a thought ""gotta luv it""",20120410,30,4.4,53.56666666666667,106,9,97
AMRMK86X3PKXD,Kindle Customer,20070124,54,4.296296296296297,228.94444444444446,152,19,133
AMRRLOM3XFSXX,Philip Branson,20080417,23,4.391304347826087,100.26086956521739,12,1,11
AMS2CPERWN7JV,E. Byers,20061207,87,4.436781609195402,243.60919540229884,458,64,394
AMSL4QLBXAQP,isableandaking,20121229,27,4.333333333333333,113.44444444444444,25,6,19
AMSMYAP2CQPFL,Steven Gotts,20100917,22,4.136363636363637,116.5,43,11,32
AMTLBVBC3IVXU,Ara,20110430,22,4.5,84.63636363636364,10,3,7
AMUP8DYE7EAN2,"mateo52 ""invisible man""",20071014,81,4.012345679012346,497.85185185185185,473,96,377
AMVXR3NPL0GWX,Patrick Perdu,20100124,89,4.359550561797753,298.69662921348316,161,11,150
AMW1OYXWOGZGJ,"James Southard ""JoeCop""",20121124,35,4.857142857142857,34.628571428571426,10,6,4
AMWL7XIWIPXEZ,Twiddles42,20061230,45,3.8444444444444446,326.3333333333333,575,99,476
AMXX0V870OL00,"Christopher715 ""Christopher715""",20100315,24,4.083333333333333,144.20833333333334,65,26,39
AMXYPWNFH0LDG,"Computer Guy ""OTC""",20090610,32,4.5,67.75,58,10,48
AMZCZBK1EF1PV,Michael D,20000709,51,3.764705882352941,92.62745098039215,89,46,43
AMZIFSBB7K61,Borocay,20130902,33,4.363636363636363,68.33333333333333,19,16,3
AN0JK8OQLUC55,"yO ""yobridge12""",20041205,41,3.975609756097561,101.6829268292683,163,84,79
AN0N05A9LIJEQ,critters,20080910,23,4.043478260869565,102.8695652173913,18,9,9
AN1Q1N8V97OZ9,icecold0027,20110615,30,4.2,99.03333333333333,29,8,21
AN2IZT80ZUNJN,peederj,20110223,36,3.8055555555555554,249.97222222222223,177,58,119
AN30G4IKL1BMZ,Stanward S. M. Oshiro,20010428,24,4.416666666666667,127.25,89,8,81
AN3AYYNN2QCVE,AlfredoRodriguezPhotography,20120217,25,4.32,89.92,21,6,15
AN3MA6K3Y1F5X,"gadgetguy ""Gadget Geek""",20130515,23,4.391304347826087,93.91304347826087,13,6,7
AN3SW7ZA7EB1H,"D. Hyatt ""Doc""",20080228,23,4.739130434782608,72.52173913043478,18,7,11
AN3XJ4BHFW0PT,Lem,20130125,27,4.222222222222222,54.148148148148145,44,13,31
AN4HRAGRHHX1H,"Amazon Customer ""thehomesteadinghippy""",20110526,21,4.333333333333333,72.71428571428571,14,9,5
AN6PWAVKI6SEA,"M. Everton ""yakmaster""",20080406,22,4.7272727272727275,58.90909090909091,66,2,64
AN81JUYW2SL24,Gearhead Mania,20030902,184,4.190217391304348,401.0597826086956,801,134,667
AN85G70HW0YQH,wewa,20071007,31,2.129032258064516,205.83870967741936,154,111,43
AN85OUBU89QFC,Justin,20130403,22,4.7727272727272725,43.86363636363637,3,1,2
AN8KSEOEJP4Y9,KHRHEE91,20110121,27,4.148148148148148,101.22222222222223,22,4,18
AN92S28RV1FQ4,Nicolas S. Martin,20030707,29,2.5517241379310347,154.0344827586207,540,204,336
AN9CP6J4JF91X,Thomas L. Ballard,20090108,57,4.56140350877193,145.71929824561403,55,67,-12
AN9J46667D80O,"Chris Swanson ""I'm just this guy, you know?""",20081124,47,4.404255319148936,178.89361702127658,47,26,21
AN9QQDRZXS52P,"marcelmib ""musician extraordinaire""",20100208,34,4.617647058823529,52.588235294117645,10,1,9
AN9WA4C5E7YY5,James C Young,20100718,34,4.4411764705882355,207.14705882352942,97,11,86
ANB0OKIDLNTZ,Allan R,20071003,28,3.7857142857142856,206.67857142857142,186,11,175
ANBNBM39RSVFS,Cramertivity,20050726,32,4.40625,215.46875,282,11,271
ANBTTR2QT4C7,Pro-gun,20111118,24,4.333333333333333,36.041666666666664,8,3,5
ANC36RGFR9HU4,primeguy,20110118,29,3.6206896551724137,245.89655172413794,111,26,85
ANE5FEA1TTRCJ,"Timm J. Phillips ""timmp""",20061220,26,4.576923076923077,61.92307692307692,23,2,21
ANEDXRFDZDL18,,20050928,41,3.682926829268293,191.53658536585365,144,33,111
ANEEEAYWYNO7G,"Hal B ""Hal B""",20080206,22,4.454545454545454,135.3181818181818,59,11,48
ANEXFROORI6F6,Pilchard,20090116,36,4.555555555555555,283.77777777777777,458,32,426
ANFJYYQ0P35CW,Chris Jaronsky,20070307,54,4.351851851851852,206.4814814814815,315,36,279
ANGH2JWPH9TDR,Ken,20090506,23,4.6521739130434785,54.0,94,430,-336
ANKZI4XNYZZQB,Drome,20090608,23,4.130434782608695,104.95652173913044,79,4,75
ANNHJND2MHUI3,"Isaac Salas ""=CRBF=gB^link""",20070312,22,4.318181818181818,80.63636363636364,21,6,15
ANO7EAXPYVRB3,T. Lewison,20101123,22,3.9545454545454546,172.0909090909091,213,40,173
ANOEOHRLK11P0,D L,20030107,34,4.205882352941177,275.1764705882353,302,21,281
ANQ5401ZLE2F5,BOGY.,20080227,34,4.529411764705882,286.38235294117646,482,46,436
ANQP6043FTSDJ,Nadar,20090912,21,4.476190476190476,111.71428571428571,31,22,9
ANR52RZ2TSBLP,Jeffrey Blake,20110215,35,4.2,67.0,22,5,17
ANRS196NKFVUU,Brian,20110612,64,4.921875,73.625,12,2,10
ANRV5P9XV6AON,"Fremen ""O""",20090920,26,3.0384615384615383,126.07692307692308,37,6,31
ANRXH0BVEAR6B,W. L. Holder,20050523,37,4.5675675675675675,193.54054054054055,516,33,483
ANS906E4EOXB3,Lilac Lily,20100322,21,4.095238095238095,151.8095238095238,39,19,20
ANSVB7OYSXZSL,"Amicus Curia ""pinbalwyz""",20100817,29,4.275862068965517,343.7931034482759,95,32,63
ANTGGAQYPSWHF,"owookiee ""owookiee""",20001221,45,3.977777777777778,163.46666666666667,611,61,550
ANTJICXHIXAPE,Ashton,20130125,21,4.523809523809524,61.857142857142854,5,0,5
ANTN61S4L7WG9,Sukru Tikves,20070923,66,4.242424242424242,266.1212121212121,111,52,59
ANTOV8XD0YB0W,benzido,20130506,37,4.54054054054054,49.08108108108108,8,20,-12
ANV2AKYYI04EU,"J. Horst ""cynical curmudgeon""",20050526,25,4.0,160.92,96,38,58
ANVQB8GKFDCRT,"T. Hiemenz ""seabreeze14""",20100203,22,3.772727272727273,113.13636363636364,111,26,85
ANW6EGY12V5XS,Henri Savin,20090812,129,4.077519379844961,234.7829457364341,506,143,363
ANX5EWEO7Q42S,"Blueflippy ""blueflippy""",20070927,28,4.321428571428571,44.857142857142854,26,5,21
ANXEW7IDYDJEH,"Hien Nguyen ""scatterbrained""",20110503,55,4.636363636363637,190.6,104,15,89
ANYC38I00IRVK,Jagga,20130104,51,3.843137254901961,31.50980392156863,6,6,0
ANZGC4YCEQC6W,Bobby L. Tefft,20090831,28,4.714285714285714,75.35714285714286,49,5,44
AO09RWV40IX78,"Mart Hyatt ""AMAZON BUYER""",20080501,59,4.593220338983051,162.96610169491527,154,19,135
AO2EURP2Y4JZM,Karl,20040828,60,3.9166666666666665,344.9,1091,107,984
AO2FXIAM4EKOS,David Tanaka,20090128,41,4.390243902439025,96.92682926829268,54,13,41
AO2INKUSNP8Y,Nicolas,20111002,25,4.68,71.64,10,3,7
AO2NK4CF57Z0F,pika2000,20090323,26,3.5,322.7692307692308,90,11,79
AO377Z7UORPJ6,"TheMountainMan ""TheMountainMan""",20111124,43,4.27906976744186,66.13953488372093,51,20,31
AO43A03C1LA0K,R. Starks,20070326,33,3.606060606060606,96.27272727272727,7,14,-7
AO4KJPY9BMJQL,C,20120830,22,4.954545454545454,55.72727272727273,5,2,3
AO4LJ777HXG8A,"Tom Suarez ""Cattigara""",20100511,26,3.8461538461538463,114.15384615384616,119,22,97
AO4RDTZLAGCJ5,"Mrs. K ""From the wilds of the Mojave""",20080425,25,4.04,134.08,20,12,8
AO5DDG05DHVIC,"Thomas ""tomsde""",20080405,34,4.176470588235294,199.6764705882353,54,5,49
AO5OP1O0FCYP8,troublef,20121216,42,3.9047619047619047,120.28571428571429,13,10,3
AO6EW7LZGP3V4,Islander,20010804,23,4.260869565217392,52.91304347826087,48,19,29
AO7ZZKIN0E9BM,DS,20121222,21,4.380952380952381,105.9047619047619,17,2,15
AO8F2P769YIA9,"John Huesman ""QPhysics""",20071120,21,4.142857142857143,275.5238095238095,122,4,118
AO8NH0BV82XIE,J. Luu,20011019,52,4.096153846153846,206.3846153846154,396,68,328
AO8RJE8TIFJZA,"PaganDeva2000 ""pagandeva2000""",20100422,28,4.035714285714286,160.60714285714286,52,19,33
AO9UNKQG83BUP,Book Fan,20050514,24,4.0,359.9583333333333,158,14,144
AOA7NY2649Z9I,"OnlineReviewer ""OnlineReviewer""",20101028,32,2.875,74.3125,146,112,34
AOAOARIH72UWI,jt,20050120,48,3.2083333333333335,191.8125,132,46,86
AOBSTWSH6UUL5,TravelNut101,20111022,23,3.8260869565217392,126.56521739130434,20,20,0
AOBWQX84JB0NV,R. van Bakel,20050224,25,3.52,408.6,1849,113,1736
AOC9BLNJLGXDB,Matthew,20121020,23,4.739130434782608,58.65217391304348,27,7,20
AOC9E0EFV3PPC,Dale D.,20090709,21,4.809523809523809,90.28571428571429,31,4,27
AOCBGDKF09QLU,W. McReynolds,20100506,23,4.3478260869565215,48.91304347826087,17,13,4
AOCY439A1FN4X,TheGuy,20110829,25,3.6,119.44,19,5,14
AODZQ5RTAM3EY,Eville_Empire,20110531,24,4.25,62.5,19,14,5
AOEAD7DPLZE53,NLee the Engineer,20061129,146,3.8424657534246576,429.7054794520548,13739,433,13306
AOEDWQLH2WKKW,"E. J Tastad ""ejt""",20040307,125,4.08,308.704,1770,145,1625
AOEDXOKYPII2Z,CyberCowboy,20120315,21,4.476190476190476,64.47619047619048,23,5,18
AOEP96629WHHA,A. Reid,20091103,35,4.3428571428571425,287.7142857142857,42,23,19
AOEUN9718KVRD,Marley,20080825,23,4.043478260869565,171.8695652173913,87,11,76
AOI2MD752ZWFU,"Joseph M. Baltrus, Ph.D. ""Balthazar""",20060727,34,3.8823529411764706,191.6764705882353,34,43,-9
AOINAOO0NQRGN,Sessue,20091003,43,4.3023255813953485,258.90697674418607,95,15,80
AOJ22IUQBZY9I,Jay,20101111,29,4.896551724137931,116.27586206896552,28,6,22
AOJA1LC8PN7K1,Jeff Chambers,20050822,54,3.759259259259259,225.11111111111111,449,101,348
AOJF59EUDPR7A,Richard Keller,20091025,30,4.466666666666667,185.73333333333332,51,7,44
AOJNSUBND8CK2,"pcaugh ""Pat""",20060416,28,4.75,117.64285714285714,36,5,31
AOKQW4B5OQUXF,jptsr1,20090421,23,3.3043478260869565,99.21739130434783,53,16,37
AOKQZVWCLONRH,Ursiform,20030719,35,4.0285714285714285,242.17142857142858,439,48,391
AOKS5JEGN6G,genocidal_maniac,20041212,27,4.037037037037037,193.96296296296296,18,8,10
AOMAEES2GYSH2,Ronald D. Coffen,20091025,41,4.146341463414634,167.5609756097561,115,9,106
AOMEH9W6LHC4S,Personne,20071103,132,4.068181818181818,270.95454545454544,640,123,517
AOMKUI325W2TJ,Alberto Vargas,20041218,26,3.8846153846153846,349.46153846153845,525,76,449
AOMQZAS76F3V3,Donald E. Fulton,20021006,27,3.814814814814815,552.1111111111111,199,24,175
AOMVLDY12N1CQ,Prof W,20110215,24,4.5,202.29166666666666,94,11,83
AOMWHMRZ0FA9F,"MadMiguel ""Mike""",20110216,29,4.310344827586207,108.72413793103448,17,8,9
AONLZKCAMSZ5C,nozama,20110715,22,3.909090909090909,64.5,15,1,14
AONUCJBC85BL,KindlePad,20040730,138,3.963768115942029,192.02898550724638,1000,155,845
AOP2ZRNSHY2Z3,"Andrew D. Lossing ""Go real.""",20100728,34,4.176470588235294,235.73529411764707,68,20,48
AOP6D2C2XWST,Seawind,20101204,21,4.380952380952381,72.95238095238095,11,7,4
AOQAOBNBA717N,Amazon Customer,20070315,26,4.769230769230769,60.88461538461539,37,8,29
AOQGSXVB4SFKQ,Robert D.,20130716,26,4.769230769230769,79.5,26,7,19
AOQGVVXK6BYI1,Ahmed,20110420,28,4.714285714285714,35.92857142857143,11,3,8
AOQLV2LSI9B2W,"Daniel A. Garrett ""Mr. Wizard""",20080516,38,4.684210526315789,141.28947368421052,87,25,62
AOSMNP09COOF6,"U. Pasha ""GenreX""",20111016,36,3.611111111111111,158.08333333333334,24,10,14
AOT3JG4GSS0QK,"Leslie R. ""Leslie R.""",20130812,25,3.96,32.56,3,9,-6
AOTMAME2XYZ65,ai chan1,20081116,30,3.8,110.03333333333333,25,12,13
AOTMP0OKJOUWI,"Emily J. Morris ""Backroads""",20100722,25,4.32,73.32,16,10,6
AOTZOHB2LZGYR,Sloan,20121106,48,4.520833333333333,79.6875,34,25,9
AOVMTR7PA8XB9,Bearwife,20060730,36,4.638888888888889,86.33333333333333,121,26,95
AOVROBZ8BNTP7,S. Potter,20001216,47,4.276595744680851,227.93617021276594,146,32,114
AOVTLYTHVDNUX,"Tradecraft ""Live by the Sword""",20100201,58,4.172413793103448,302.7068965517241,169,17,152
AOVZGOYP5LNPZ,Tracy H. Bolte,20110402,27,4.2592592592592595,78.07407407407408,51,10,41
AOWF9T81XMX2S,TronixSage,20100326,66,4.348484848484849,377.24242424242425,564,63,501
AOX29XHYEAKD7,Jay,20111221,23,4.6521739130434785,107.21739130434783,24,2,22
AOXDZSY5AGHEA,"ASG ""angryshortguy""",20021004,22,3.227272727272727,101.86363636363636,70,35,35
AOXPRY7BBHU9Q,Donald B. Bell,20070321,29,4.931034482758621,50.44827586206897,12,5,7
AOXSL69K4Q18L,R. Lewis,20070902,27,4.111111111111111,148.07407407407408,12,4,8
AOXXCWMIG217L,"Amadeus B. Klein ""MG""",20120426,26,4.076923076923077,256.38461538461536,195,33,162
AOY459LVUBKLO,Confidential Name,20130409,23,3.782608695652174,168.6086956521739,92,17,75
AOY9SZTMNQWAW,Mercedes,20061225,44,4.136363636363637,203.27272727272728,149,21,128
AOYAZN4MA0TVU,Virginia T.,20120604,24,4.541666666666667,26.791666666666668,4,5,-1
AOZ6FDBL9EX4J,Rachel Barr,20070717,32,4.65625,345.875,912,19,893
AOZBVGFIUY44X,"Marty German ""macs4e4""",20061105,28,4.035714285714286,208.92857142857142,66,9,57
AP04UMK9IEKVF,CMH,20081201,29,4.413793103448276,136.20689655172413,329,9,320
AP1335UV2ALB4,Taka Iguchi,20120502,21,4.476190476190476,40.80952380952381,1,3,-2
AP1W4AXZPI4KE,TheShadow,20070202,25,4.04,104.52,250,71,179
AP2NZAALUQKF5,Brett B,20111203,24,4.208333333333333,180.83333333333334,18,20,-2
AP37T7UPLQGWU,Casey Friday,20110111,40,4.6,157.625,135,10,125
AP37ZBVD77DUE,"M. Kaainoa ""Kekailoa""",20071231,33,4.090909090909091,337.42424242424244,71,7,64
AP53MVRC8ZEW2,"Rafael Matos ""video editor""",20100805,76,4.7631578947368425,38.30263157894737,23,30,-7
AP60EZKVIHI1J,Sheraz Hanif,20060310,28,4.464285714285714,60.92857142857143,67,96,-29
AP6DZJX8D1JNB,bob,20100813,25,4.44,22.96,5,5,0
AP6L54VTCJKCQ,"Ardeal ""Emi""",20060712,49,4.36734693877551,173.6530612244898,102,33,69
AP6M728REMY04,"vacuumtubejazzpro ""rich""",20030919,23,3.652173913043478,164.47826086956522,145,41,104
AP78Z2N34AM1R,"Krylos ""S.Ray""",20081102,26,3.8461538461538463,194.23076923076923,191,21,170
AP85QMV9WIZ73,K. S. Mathoda,20090308,29,4.758620689655173,105.51724137931035,23,0,23
AP8D74QD9LUUL,L. Steiner,20081130,33,4.515151515151516,120.3030303030303,53,8,45
AP8EXADSLHZET,"John V. Winn ""JonJonBear""",20111112,38,4.7894736842105265,70.78947368421052,11,3,8
AP9YDYTA4QM6W,MonJ,20110618,37,4.0,45.24324324324324,4,1,3
APASW0USALPXM,White,20080727,31,4.419354838709677,43.54838709677419,18,19,-1
APB1VAE7P1CAV,The Great One,20130319,21,4.285714285714286,29.714285714285715,0,1,-1
APBA7Y4SINS0H,&#34;switterbug&#34; Betsey Van Horn,20081030,31,4.419354838709677,306.5806451612903,354,74,280
APBB297H3ZA5E,Harry M. Shin,20070420,85,3.9647058823529413,307.4,1201,265,936
APBDZ88BBTN4F,R. McAdams,20030717,54,3.8333333333333335,396.5,218,44,174
APDPA11IZPYLN,"Sheila Chilcote-Collins ""Sheila Renee Chilcot...",20081217,31,4.225806451612903,171.8709677419355,28,14,14
APDZU24PSMOYE,Ponskippa,20090527,27,4.555555555555555,109.4074074074074,21,6,15
APEOS7GWN31A4,"H. Bowman ""Mailman""",20031013,40,3.925,74.925,86,131,-45
APFDM4RTT2E0B,Ricardo Avila,20140706,32,4.65625,8.78125,0,1,-1
APFEQMTX550NE,Clayster,20120725,34,3.911764705882353,155.2058823529412,583,20,563
APG2BHOAXPNEQ,Fritz The Cat,20110102,47,4.25531914893617,55.59574468085106,38,49,-11
APGH1HCSUVLIE,"John Fenton ""Techie runner""",20100719,22,4.681818181818182,178.77272727272728,253,13,240
APGPEJS55U2SF,Jeffrey Liss,20040125,32,4.59375,190.4375,234,22,212
APGQTZZ4ZFPHO,"BAF ""SalvationsJoy""",20091115,55,4.236363636363636,37.127272727272725,20,11,9
APH5FNOADM1N4,Doc,20130530,25,4.88,50.12,17,3,14
APHXWZJ22M17M,T. Stratton,20061206,31,4.709677419354839,84.06451612903226,62,25,37
API5JLBRT6FIN,KNSudha,20040726,27,4.0,205.14814814814815,68,27,41
APKBGB3JBWL5X,C. Hallowell,20080428,28,4.821428571428571,219.46428571428572,565,47,518
APMYPD97EHUUZ,"John H. Gruver ""brainactiv""",20070811,55,4.090909090909091,176.83636363636364,126,89,37
APN50UILUQ3FZ,"Neil Rosenberg ""The real Neil""",20080819,30,3.3666666666666667,216.53333333333333,138,16,122
APNTEHAMKO2HE,Dave,20130116,24,4.791666666666667,34.166666666666664,4,3,1
APOFQFXC8K645,Augustin A. Julien,20080324,30,4.733333333333333,49.63333333333333,11,12,-1
APOGXH3A74CM3,Damian P. Gadal,20021224,77,4.766233766233766,141.5064935064935,162,38,124
APOXJ8I6412IR,,20080320,24,2.4166666666666665,75.0,35,38,-3
APP8XWYYV4PAA,"Debra A Chong ""ECommerceMaven""",20020921,37,4.945945945945946,133.78378378378378,159,18,141
APQ3W7AZ4P1QP,Doc Jim,20120215,22,3.5454545454545454,134.3181818181818,98,56,42
APQQK1V695AUE,Ann E. Revelle,20070123,51,4.764705882352941,566.0588235294117,1894,64,1830
APRGEWSO0H82G,"Laron Taylor ""laronvonbaron""",20110103,27,3.185185185185185,76.14814814814815,24,44,-20
APRJDKS9CHS61,"Frankie ""Frankie""",20081119,28,4.285714285714286,297.17857142857144,470,45,425
APRNS6DB68LLV,"Rob Slaven ""slavenrm@gmail. com""",20130410,42,4.595238095238095,169.07142857142858,100,17,83
APRP8UBWTQ15J,Eric C. Anderson,20051219,30,4.133333333333334,235.36666666666667,67,25,42
APRU373UYVK2Y,J. N. Mohlman,20080206,32,4.34375,178.375,44,58,-14
APS831ZLF95PS,Thomas,20100104,35,4.485714285714286,164.68571428571428,23,2,21
APT7V2Z8MO6T0,AKVHutch,20111129,25,4.36,77.0,12,5,7
APTDRITW23DQF,terry,20121209,26,4.846153846153846,28.0,7,1,6
APUO3VISOOKDL,"S. Shin ""Double S""",20081205,24,4.041666666666667,101.91666666666667,230,19,211
APXC1CBSPBKCX,Fred,20111029,29,4.103448275862069,60.6551724137931,12,3,9
APXN17MQLCH7O,Bond,20120307,26,4.153846153846154,67.8076923076923,10,8,2
APY0PLR9RNL2D,"AmazonAddict ""Cody""",20130727,31,4.129032258064516,85.0,9,3,6
APZWKX3F1YX37,JAG,20090114,32,4.3125,101.9375,12,22,-10
APZZ1I14L7CHH,Ironman&Ultrarunner,20090623,26,4.6923076923076925,121.84615384615384,21,1,20
AQ105QY4LT0YY,"Mone Yevol ""Real Echelon""",20130103,24,4.75,76.16666666666667,6,5,1
AQ2FC1DLKVD8H,P. McWhorter,20100815,80,4.25,217.3375,1326,62,1264
AQ3BVPWA301ZF,"J. Foster ""jeff92k7""",20080314,22,4.181818181818182,245.72727272727272,43,4,39
AQ3IN3MRXQ5KH,IlPrimitivo,20020105,45,4.0,209.0888888888889,475,47,428
AQ3MJ8V783YYQ,"Bill Seward ""VMax12""",20050908,26,4.0,83.3076923076923,32,3,29
AQ4FO7EUSLUWZ,Wandra Arnold,20080410,27,4.296296296296297,67.44444444444444,5,3,2
AQ4P5VTU2RASK,Q5Grafx,20130628,33,4.333333333333333,55.121212121212125,19,3,16
AQ55H30MZSV0Q,John A. Lefcourte,20071210,42,3.4285714285714284,141.73809523809524,50,21,29
AQ64NMZDUVYN7,Koiphotography,20120507,27,4.555555555555555,85.74074074074075,41,14,27
AQ6AGWKWMTY8H,PeaTee,20070928,42,3.7857142857142856,289.1904761904762,311,61,250
AQ6UE5MKP9QQB,Puterwzrd,20130412,23,4.739130434782608,214.17391304347825,11,7,4
AQ6WXOXDZIYCS,"P. Jarvi ""pj6000""",20001226,21,3.8095238095238093,103.80952380952381,31,5,26
AQ6XS10RR7CE0,"Mike P. ""MAPRX""",20000201,22,4.136363636363637,62.45454545454545,123,44,79
AQ6YJM2J2LNOP,Book Fanatic,20110427,40,4.175,100.525,30,31,-1
AQ7YHU695MYTM,Amazon Customer,20120829,21,4.476190476190476,121.66666666666667,10,3,7
AQ8DIFLAIQMU2,Jose G. Balboa,20090612,28,4.535714285714286,69.0,25,6,19
AQ93SBYO5S7VM,He who spends too much,20080412,25,3.88,183.76,141,17,124
AQ9GVQAH3ZU0,G. M. Matthews,20011103,24,4.5,315.4166666666667,672,23,649
AQ9O2ACE8C9WS,Brian,20120401,25,4.36,367.2,20,2,18
AQ9YYLSAQ830Q,Julio A M Neto,20100502,36,4.333333333333333,91.33333333333333,7,5,2
AQB4DH57MSZSC,A Regular Joe,20070308,61,4.540983606557377,140.59016393442624,154,52,102
AQB6PNE4WGH7Q,Alan,20110218,21,4.238095238095238,115.71428571428571,16,3,13
AQB9Z4YQGBMA8,NotSoSimple,20121117,30,4.066666666666666,72.53333333333333,6,3,3
AQBKBWMXB8VI4,"Amazon Customer ""last1in""",20010309,22,3.9545454545454546,155.0909090909091,221,12,209
AQBLWW13U66XD,"Benjamin Belanger ""v dbl u""",20130630,21,4.619047619047619,88.0,3,2,1
AQCJWSMSURQI2,A Customer,20080730,67,3.8358208955223883,101.53731343283582,125,55,70
AQDAU8JEK6QC4,"S. Whitaker ""superman1979""",20070216,27,3.8518518518518516,95.92592592592592,35,6,29
AQDEGUGFEMZU,Serge C. Bakmeijer,20101226,21,4.761904761904762,86.66666666666667,16,5,11
AQE2B2QSZG0HY,Fredddd,20120804,28,4.821428571428571,132.14285714285714,18,3,15
AQF3D0KX5SFCM,"Touch Remedy ""TouchRemedy""",20050108,24,3.625,411.1666666666667,73,18,55
AQFZEKYP1P1LT,vharmy,20121220,35,4.485714285714286,48.0,10,13,-3
AQGVTJI4M3HCR,"Preston D. Robinson III ""Preston D. Robinson III""",20120719,22,4.5,65.18181818181819,11,2,9
AQHFH0L76GOPB,OmoPastor,20110522,27,4.7407407407407405,114.96296296296296,37,8,29
AQHJXW7L8PJGL,Joshtalgia,20110420,24,4.458333333333333,106.41666666666667,390,31,359
AQIBGC2OCCAHQ,"Patricia Murray ""trader54""",20111104,24,3.9583333333333335,42.083333333333336,3,1,2
AQIJ3ZEEVCIKU,Kaio,20070117,164,4.195121951219512,489.7378048780488,4434,186,4248
AQJ8OUFKGUJPW,S. Lawrence,20091206,23,3.6956521739130435,142.65217391304347,163,27,136
AQK01UMFP9MND,Douglas Kelban,20130220,28,4.464285714285714,44.75,6,2,4
AQKCWZ7MLOUDR,Julian Velasco,20081121,27,4.148148148148148,211.1851851851852,87,23,64
AQKH7Z5K2PLJW,"G. Bowman ""BOODIE""",20121123,21,4.714285714285714,61.76190476190476,22,3,19
AQL2WVOAADPE2,Ryan,20000505,28,4.0,87.67857142857143,159,18,141
AQLBLE6267RH0,Roger Maxwell,20090220,21,4.285714285714286,101.42857142857143,64,8,56
AQLL2R1PPR46X,grumpyrainbow,20090706,22,4.636363636363637,87.04545454545455,8,5,3
AQLM9KYDBQLRY,Firelock,20060626,24,3.7083333333333335,100.33333333333333,19,7,12
AQM0K7MBBT4AY,B. Rose,20080103,66,4.257575757575758,357.1363636363636,496,67,429
AQMUXDDCLJSSV,J. Peplinski,20040818,23,4.434782608695652,443.7826086956522,646,51,595
AQNSQW4495SG0,Ryan,20111124,46,4.173913043478261,160.08695652173913,49,16,33
AQOFHS4H4ELNU,EmbeddedFlyer,20080807,35,3.057142857142857,341.22857142857146,893,84,809
AQOY334UL0B95,Mark S. Johnson,20080831,29,4.068965517241379,167.82758620689654,23,5,18
AQPH7UFOWXFW,Stucco,20100922,36,4.111111111111111,136.16666666666666,141,18,123
AQQF13FLSTQKM,john,20101204,26,4.461538461538462,133.53846153846155,19,4,15
AQQWMOFESYDV3,"William Davis ""Movieguns""",20090313,22,4.2727272727272725,37.5,4,0,4
AQR4HPVSOPS08,Ryan Leafgreen,20130312,61,4.639344262295082,76.31147540983606,63,10,53
AQRN2I355LZ3F,RENAISSANCE MAN,20051115,26,4.0,162.07692307692307,42,18,24
AQSV34W54L0VO,rt66west,20120506,45,4.733333333333333,61.17777777777778,46,10,36
AQTZHNHSHUM8N,Alan Bruce Mccornack,20090114,21,4.523809523809524,128.9047619047619,58,6,52
AQV2XYGQDMU92,Singh is King,20070731,23,4.6521739130434785,85.1304347826087,94,18,76
AQVPI5QE4UXTD,"CPB ""Retired Army""",20071117,23,5.0,34.21739130434783,7,1,6
AQWSPFJS2ENQK,K. Hyde,20090226,29,4.379310344827586,329.6551724137931,40,7,33
AQX1V1UT92QO,Rod,20110813,25,4.16,47.96,18,6,12
AQXHMLLNSC4S2,Stephen J. Boone,20121227,24,4.583333333333333,162.20833333333334,124,9,115
AQYYUN3T7B0WM,Karen in Mommyland,20100629,22,3.6363636363636362,227.8181818181818,114,16,98
AQZBIM739YVLM,Sean W. Franklin,20110208,23,4.434782608695652,183.52173913043478,134,9,125
AQZH7YTWQPOBE,Enjolras,20080708,21,4.0,131.42857142857142,32,12,20
AR0GJX39FB0V5,Manash,20110722,36,4.0,33.083333333333336,11,3,8
AR16G2FPTTWJF,Michael Burke,20060224,28,4.035714285714286,47.42857142857143,13,8,5
AR18DH5SL9F73,David M. Lewis,20080523,51,4.117647058823529,92.76470588235294,113,15,98
AR1N5XSYL2FVM,"Jacob ""buy and review""",20120305,28,4.107142857142857,85.25,4,15,-11
AR1NP84PU84D4,S. Melvin,20090523,23,4.130434782608695,397.39130434782606,31,5,26
AR1T36GLLAFFX,Scott FS,20070331,42,4.285714285714286,184.28571428571428,96,22,74
AR2ETQ67PPXXR,Ed from Long Island,20130227,32,4.15625,38.21875,5,5,0
AR36NHA9Z5WGG,"Ambrose ""Software Designer & Armchair Philoso...",20100705,35,4.3428571428571425,141.34285714285716,23,8,15
AR3EVUQF0AC7R,morning fog,20081218,97,4.164948453608248,361.74226804123714,390,65,325
AR4Y501FFAJHM,"MardeeT ""MardeeT""",20120614,39,4.512820512820513,191.82051282051282,23,9,14
AR5UBWWTT2UQM,Thomas Ling,20091011,31,3.903225806451613,46.61290322580645,12,15,-3
AR5XJEZR0LWWW,Mark,20120517,38,3.6052631578947367,235.44736842105263,385,45,340
AR64CEBJWBICU,Amazon Customer,20050104,30,4.466666666666667,132.96666666666667,139,18,121
AR6APXLK7TJU2,L. Williams,20050821,48,4.333333333333333,309.875,458,60,398
AR6QTTIQ7P4DV,Jeremy S.,20120126,21,4.619047619047619,175.8095238095238,1,2,-1
AR6YFVMCYRVJH,,20100504,21,4.571428571428571,109.0952380952381,15,5,10
AR7449Y7NT77Y,Jeremiah D. Ostrosky,20111203,26,4.153846153846154,154.1153846153846,20,4,16
AR74YY08IP2WE,"Dave ""Dave""",20060203,107,3.607476635514019,296.69158878504675,862,219,643
AR8FTR1JSVUXI,James H Hunt III,20110721,22,4.590909090909091,114.54545454545455,6,1,5
AR8LWDT6TUKNZ,Amazon Customer,20120228,45,4.666666666666667,59.62222222222222,13,5,8
AR9I9VV1UM0AX,FAR,20051229,35,4.457142857142857,94.77142857142857,29,2,27
ARA16FJLTBFVB,Beard///,20110717,32,4.375,104.28125,139,13,126
ARADXCOUVBS09,Gavin Scott,20040506,37,4.0,283.56756756756755,416,46,370
ARAEWF3IQN3HM,Portland Ghosts,20101020,27,4.555555555555555,151.40740740740742,177,27,150
ARAGWYYUHANIQ,Adam,20130321,29,3.9310344827586206,42.793103448275865,17,19,-2
ARAKTT5M3DDYA,JustMe,20080924,27,4.2592592592592595,163.88888888888889,107,6,101
ARBCOEQNK389G,Mugopain,20120711,36,4.805555555555555,27.944444444444443,15,3,12
ARBKYIVNYWK3C,RST10,20060522,267,4.415730337078652,189.2546816479401,1602,119,1483
ARC5ASW9CUAGP,"C. Winton ""cwinton""",20060204,45,4.311111111111111,332.8222222222222,543,13,530
ARDB79V42CX6P,Boise Nelson,20120518,25,4.08,57.8,7,4,3
ARE9V31UFN860,"Paul R. Prescott ""MilDoc""",20091212,27,4.592592592592593,43.2962962962963,46,23,23
AREUKNK6M6YI0,Austin Duerfeldt,20130124,27,4.62962962962963,63.666666666666664,8,6,2
ARF6NZ2PH6MCB,Anthony Chester,20120530,23,4.565217391304348,52.95652173913044,7,8,-1
ARFPGL7OEATYH,USERBOSCO,20090424,33,4.2727272727272725,44.666666666666664,7,4,3
ARHH1P2PLAFSJ,"Dusty ""If you are living life like there is n...",20120515,36,4.388888888888889,167.5,14,8,6
ARI60NK07Q9D,"Jacob S ""JHN Live""",20070607,25,3.44,163.56,121,71,50
ARIA1F01A9YIC,David J Cavallero,20130104,22,4.863636363636363,28.454545454545453,2,2,0
ARIDN94LOCQFD,Steve Taylor,20070220,70,4.4,191.07142857142858,212,42,170
ARJ27NMILTKQ5,S. Hunt,20091003,36,5.0,27.833333333333332,15,4,11
ARJBEGYUGWV6U,Marshall Baker,20100601,34,4.147058823529412,40.6764705882353,19,6,13
ARJTCVHAEA6X6,Stephanie Eglantina Reynoso Pimentel,20130206,21,4.571428571428571,67.85714285714286,3,2,1
ARK5SAGVLW3FY,bunnyrabbit4,20041008,33,3.4545454545454546,291.27272727272725,161,49,112
ARL3MMBV85VTY,Skylark,20051123,25,4.48,271.92,58,6,52
ARL6YY38UY9B2,Amazon Customer,20080924,40,4.45,124.65,51,5,46
ARNSIMLKU7PT6,John Armstrong,20110621,29,4.586206896551724,139.48275862068965,25,11,14
AROQO2VDODT7,Branden,20100519,59,4.406779661016949,133.79661016949152,270,20,250
ARP0HXN46Z5VI,"M. Gentry ""Mike n DFW""",20020917,30,3.6,197.23333333333332,38,8,30
ARQ4HTA950LU9,BlueOwl,20070707,21,4.476190476190476,139.76190476190476,19,1,18
ARQ945F4OIWVI,PB2008,20080305,24,4.0,290.375,185,12,173
ARQPQ8LF5NTEZ,keysgirl,20090211,22,4.090909090909091,173.1818181818182,90,9,81
ARQXKR5RB00T3,M. Barnard,20130228,27,4.666666666666667,63.77777777777778,1,3,-2
ARR0AJC9XG874,Lucas Smith,20080828,23,3.6956521739130435,230.82608695652175,347,45,302
ARS0OAKTNX4I9,jon.scot,20130814,26,4.846153846153846,30.346153846153847,4,6,-2
ART0ANWA3X6DV,"Spike ""spikeman1""",20010521,23,4.434782608695652,115.08695652173913,37,10,27
ARTA78TP6H73D,"R. Angeloni ""slicktiger28""",20020103,66,4.0606060606060606,355.6969696969697,448,80,368
ARU1D08GSZMTW,J. Keeling,20070926,27,4.666666666666667,141.25925925925927,146,11,135
ARUD6G8XCU2BY,MonaVie User,20090613,38,4.7105263157894735,74.23684210526316,36,6,30
ARUDTZ5BNUHA6,"igen ""igen""",20061006,31,3.225806451612903,269.7741935483871,51,18,33
ARVD6Y9Z1E4D4,"G. Kline ""art & technology""",20051129,22,3.3181818181818183,393.1363636363636,278,20,258
ARW8VGT10JG60,"William Bash ""Someone Who Still Cares""",20110130,44,4.590909090909091,267.45454545454544,186,16,170
ARWG2TPGIYALV,"Andreas Hohl ""VaderVideo""",20100406,27,4.888888888888889,63.44444444444444,11,3,8
ARWKXFSG5DAFK,Michael0924,20110613,32,4.875,84.09375,29,11,18
ARX0KOX5Q01BJ,"Mike J. Cianciosi ""Mike""",20101227,49,3.938775510204082,50.53061224489796,12,11,1
ARX7Z3NI6O0F7,Lynn May,20071127,89,4.47191011235955,171.47191011235955,382,67,315
ARXU3FESTWMJJ,"Mary Jo Sminkey ""15 years of Amazon Reviews!""",19991201,126,3.634920634920635,355.64285714285717,2142,204,1938
AS11CDXS6W8VB,JMT2013,20130116,30,4.333333333333333,48.1,18,6,12
AS21S3XF7XEG1,Tom N,20071230,24,4.166666666666667,131.29166666666666,107,13,94
AS269J1OGZT1V,Dobber,20000703,78,3.8076923076923075,118.06410256410257,79,21,58
AS28WVBBZ3G99,Jeffrey E Ellis,20040326,22,4.2727272727272725,100.77272727272727,77,38,39
AS2GVS22GP162,P. Pieri,20101224,23,4.304347826086956,133.2173913043478,10,3,7
AS2II0671KT2C,"David Crowder ""computer geek""",20070922,52,4.711538461538462,41.09615384615385,47,17,30
AS44QEHT3KSPK,slaphappy,20091111,24,4.416666666666667,125.83333333333333,7,6,1
AS5IJXFUJQX5G,"JohnnyCaps ""Video Junkie""",20071019,38,4.657894736842105,97.10526315789474,60,23,37
AS68424YO3OL6,Dan V.,20090418,31,3.903225806451613,72.41935483870968,39,5,34
AS6SH2JM2YY3H,R S Cobblestone,20071104,32,3.8125,219.65625,34,12,22
AS7J4952JB5XR,JB123,20081222,45,4.022222222222222,192.86666666666667,153,36,117
AS7SB0A3QKVQV,SillyMoose,20090613,21,3.761904761904762,118.0952380952381,18,11,7
AS8984CRFM1OS,Amazon Customer,20111104,21,4.857142857142857,68.9047619047619,2,1,1
AS8C336DDLSO4,"Mr. Ben ""ctsamurai""",20060516,53,4.188679245283019,241.28301886792454,288,27,261
AS8VENYN17UTI,guriqbal,20131101,30,4.833333333333333,216.6,155,24,131
ASANNBOFH1O7Y,jobew,20100518,24,4.625,66.70833333333333,4,0,4
ASAWQWJ7AF5NF,Troy Edwards,20030520,38,3.8157894736842106,192.1315789473684,55,30,25
ASB4QQBKZD6W2,"R. Hammer ""rhammer""",20030316,41,3.731707317073171,288.8292682926829,219,60,159
ASB7THP27C5SN,"Charles B. Firth ""Chuck""",20120322,39,4.564102564102564,97.15384615384616,67,29,38
ASBJ67EWEBWTZ,gduncan229,20090509,43,4.232558139534884,38.627906976744185,4,0,4
ASCBJEPXTOU0V,Bacon,20121223,99,4.515151515151516,58.57575757575758,68,41,27
ASCM3206SVTO0,"Mad Dog ""maddog6969""",20020220,26,4.6923076923076925,204.6153846153846,470,46,424
ASCSHRBJ9Z04X,"R. Colley ""~~RC~~""",20090327,23,5.0,109.47826086956522,25,6,19
ASCU0TZ1WAAYP,A. L. Shultes,20111212,22,4.409090909090909,31.272727272727273,7,5,2
ASDWW4X3L41D6,"TurtleFace ""Nom Nom Nom!!""",20070822,22,3.8636363636363638,403.22727272727275,154,20,134
ASE0G3FRJA11D,Rashond Edwards,20130114,27,4.703703703703703,24.25925925925926,1,3,-2
ASEZTJV89KAYN,Kailua Steve,20050315,35,4.285714285714286,142.5142857142857,255,60,195
ASF3J4UYV34KA,Average Customer,20090317,44,4.159090909090909,51.36363636363637,62,11,51
ASFP250F22MDZ,But I'm feeling much better now...,20080704,57,3.7017543859649122,374.719298245614,703,119,584
ASFW4ZMNZJKDA,Mainiac,20080317,51,4.411764705882353,252.2941176470588,334,45,289
ASGN5WD3DI451,Mark P. McDonald,20100701,39,3.6666666666666665,300.0,220,47,173
ASH07EY7KRVU0,,20130728,34,3.735294117647059,31.61764705882353,10,2,8
ASHH9J1UNLN2F,frnk,20111013,27,4.222222222222222,55.888888888888886,4,22,-18
ASHJAZC9OA9NS,Stephen,20070616,45,4.666666666666667,108.77777777777777,239,14,225
ASHQ1R4U86773,"Ira Solomon ""Old Geek""",20030828,23,4.869565217391305,86.78260869565217,64,11,53
ASI2YMOFZ430X,Spencer,20131231,24,4.291666666666667,75.95833333333333,0,0,0
ASI69ZJZ1SNAG,John the Revelator,20110614,24,4.666666666666667,41.333333333333336,6,4,2
ASJLXOX1VD4DF,"Fermata ""D.S. al FINE""",20090508,74,3.7837837837837838,401.72972972972974,219,27,192
ASJSX783R5HTZ,"Preston S. Page ""Preston Page""",20070310,94,3.978723404255319,103.23404255319149,416,55,361
ASJZT7DM51QEM,"Patrick Holt ""txdragon""",20040208,51,4.117647058823529,106.90196078431373,47,30,17
ASKH6TPNTTAFS,Middle age tech freak,20040512,36,4.472222222222222,178.27777777777777,322,7,315
ASNW8MGNC91D2,"Tommy ""I want to feel good when I complete a ...",20111103,27,4.592592592592593,39.18518518518518,2,2,0
ASO6WWP4GLBBD,"Peter H. Smith ""missed the renaissance""",20120414,24,5.0,87.16666666666667,36,5,31
ASOOYVBM0UTF1,"Mark Heffernan ""Mark Heffernan""",20070216,21,4.761904761904762,120.95238095238095,29,4,25
ASP5ZEENZOF86,"Colin Povey ""cpovey""",20070109,32,4.53125,157.4375,37,3,34
ASPU6ADKLXPRT,"Morning ""morning""",20090415,25,2.48,72.68,41,47,-6
ASQ1EZGJX2YT8,Peter F,20110726,40,4.125,159.775,67,11,56
ASR7145BJLFIW,Terrance S.,20070329,44,4.0227272727272725,537.1136363636364,967,44,923
ASRA2UZ3JV87B,"Navarro L. Parker ""Motion Graphics Dude""",20041117,50,3.68,152.26,780,138,642
ASREZFXN55U2R,James R.,20120126,40,4.25,361.125,403,24,379
ASVBQ69SB38EY,Buddy Davis,20080222,37,3.6486486486486487,116.35135135135135,56,36,20
ASVLHEA1PVXP0,Ned Pendleton,20100624,21,4.333333333333333,64.66666666666667,9,2,7
ASVXVK0UVJ27,Nat L,20120319,21,4.333333333333333,147.33333333333334,17,3,14
ASWA0KKLPFBNA,shaft,20120704,23,4.869565217391305,53.0,5,2,3
ASWQ1KJQFJYWX,"Book Reader ""bob_spez""",20091007,23,4.695652173913044,227.69565217391303,47,4,43
ASY25YMTIC2A9,Steve,20010823,45,4.466666666666667,379.6222222222222,131,33,98
ASY4YLO36SK7E,NF,20120127,28,4.571428571428571,229.89285714285714,18,5,13
ASYBYIKFF5F73,Steven,20120402,21,4.809523809523809,45.57142857142857,4,5,-1
AT09WGFUM934H,John,20130627,95,4.326315789473684,66.85263157894737,40,35,5
AT0JL6GYAWG72,Daryl Gates,20041027,23,4.0,91.82608695652173,175,53,122
AT14ZGW24ICIC,Mike P.,20090309,25,4.04,104.28,185,10,175
AT27PB24FEQN9,gadget geek,20110426,38,4.578947368421052,46.05263157894737,17,5,12
AT28RL25Q2OLK,NyReckDiver,20000719,173,4.335260115606936,429.22543352601156,1427,213,1214
AT2J7H5TRZM8Z,A Customer,20011106,36,4.027777777777778,664.6111111111111,1663,68,1595
AT4DQRJGBK5,"Ronald C. Parker ""Ron Parker""",20080713,30,4.733333333333333,45.13333333333333,5,2,3
AT53ZTTO707MB,I Do The Speed Limit,20110622,66,4.590909090909091,329.8030303030303,111,38,73
AT5F1MKA8C2IZ,R. Gillis,20080424,25,4.36,43.0,18,0,18
AT67M5M451URR,Romanos,20120404,23,4.304347826086956,297.39130434782606,49,10,39
AT6CZDCP4TRGA,Eduarrdo Nietzsche,20021005,145,3.7379310344827585,249.7655172413793,2643,1085,1558
AT8TS7XTO8TIE,AlmostEverything84,20120122,34,4.470588235294118,85.58823529411765,6,8,-2
AT8V3JOZD3KWK,"volodoscope ""Artist by heart, geek by nature""",20061103,53,4.30188679245283,84.13207547169812,73,75,-2
AT9BM7G3JGKKM,tetvet6768,20080701,31,4.419354838709677,52.29032258064516,34,4,30
AT9U5ZE5OO84C,"M. Kooiman ""nerdette""",20050814,22,3.9545454545454546,343.8181818181818,101,26,75
ATA4YSJ4JCBTR,Nathan Venturini,20100923,23,4.739130434782608,97.69565217391305,9,0,9
ATAS1JU2SXBL4,Steve,20121219,24,4.25,158.75,9,3,6
ATBO1P0I7TQJ8,H.M,20110502,21,3.380952380952381,67.14285714285714,10,10,0
ATBRH3U3KP55S,"Timothy B. Elliott ""LatchJohnson""",20110206,23,4.304347826086956,297.2173913043478,21,3,18
ATCW6BDJJZKOE,M. Robles,20130327,22,4.409090909090909,88.4090909090909,11,5,6
ATDE9JYCPI0L1,Alyssa A. Lappen,20051105,44,4.159090909090909,133.63636363636363,403,27,376
ATDQ9CGCWTT8D,Hugh Jarse,20121101,42,4.190476190476191,77.83333333333333,22,6,16
ATFBVUXDIRXT6,D. Matheny,20070412,85,4.423529411764706,332.16470588235296,2715,109,2606
ATFLVVU3EFTOM,T. Farris,20051217,33,4.303030303030303,54.515151515151516,100,70,30
ATGUQI7FB188,RH,20080321,21,3.761904761904762,98.23809523809524,72,31,41
ATHSNRNFUSJU5,CJC,20120905,32,4.3125,81.625,10,4,6
ATHUN0PJ0MG0P,"R. Cross ""LVWolfman""",20090319,32,4.5,269.3125,200,32,168
ATI35LDGKQ8S4,Mr RG,20130108,21,4.190476190476191,58.523809523809526,0,2,-2
ATIA5ZPUDY4QE,Mark,20101207,22,4.545454545454546,71.31818181818181,17,3,14
ATIESTXNUFNSW,James,20130802,27,4.777777777777778,35.2962962962963,3,1,2
ATIMW8SYGAASW,Todd F. Fogleman,20040912,41,3.7804878048780486,40.292682926829265,15,10,5
ATIZ1TQJR6NHK,BSB,20120208,21,4.333333333333333,83.66666666666667,11,1,10
ATJE929ETFFNH,"Fred ""Fred""",20080211,45,4.111111111111111,388.53333333333336,216,40,176
ATJYSJ7U7NRZ3,RRRoger,20110530,28,3.8214285714285716,38.392857142857146,49,106,-57
ATK3WMMB7NN02,Austin Andersen,20140220,33,4.424242424242424,75.96969696969697,32,7,25
ATKFSP54JDDEO,Selwyn S. Elledge,20080125,26,4.884615384615385,61.96153846153846,11,3,8
ATLA5CJH0ZZHP,Terry R. Nye,20060228,36,4.305555555555555,325.27777777777777,175,30,145
ATLCEY1YIP1DG,"DM ""guitarbabe""",20101212,22,4.545454545454546,37.22727272727273,2,1,1
ATLHK23MET0CD,"Amazon Customer ""Golfaholic""",20110315,39,4.717948717948718,208.64102564102564,18,0,18
ATLSR3QVN9URK,Benjamin,20121224,22,4.5,89.0909090909091,9,2,7
ATLZNVLYKP9AZ,T. Fisher,20080126,34,4.0588235294117645,236.26470588235293,72,11,61
ATMQEI1LKR6VB,"Shevi ""FantasyWeaver""",20080910,51,4.235294117647059,302.7647058823529,195,35,160
ATMQFK1UA9QX0,Kevin Darmody,20130221,25,4.28,83.04,7,5,2
ATN4J5VS8Q0YM,Anna Hope,20070312,45,3.8222222222222224,234.82222222222222,122,28,94
ATNOI7E8GTIVE,"J. Ruvio ""KayakSurfer""",20100630,60,4.65,89.51666666666667,76,20,56
ATNQXW57ZUWNL,J. D. Bodine,20090102,24,4.25,116.41666666666667,5,6,-1
ATNRS5K5085V4,E. Derrenbacher,20100919,22,4.318181818181818,119.5909090909091,90,9,81
ATODGB1YOXUXY,John Elliott,20070207,21,3.5238095238095237,103.95238095238095,32,28,4
ATOKT8QYK967L,"Steve B ""Mac User""",20071004,54,4.222222222222222,156.27777777777777,295,47,248
ATOPUBVPVV4PY,Douglas W. Decampos,20080125,21,4.142857142857143,102.42857142857143,9,3,6
ATPFSP7ARPDXO,"A. Ioannides ""Ari""",20091219,24,4.166666666666667,335.25,385,45,340
ATQSZXM2F87L1,genesal,20110703,37,4.513513513513513,39.08108108108108,19,2,17
ATRB76NXCFVSL,"Robby Robinson ""Globetrotter""",20080704,25,3.6,47.56,20,5,15
ATRULTFPF9UPA,Christian,20100910,22,4.045454545454546,87.5909090909091,18,7,11
ATS2855497V0I,Glenn R. Howes,20010723,133,3.8421052631578947,438.70676691729324,5910,540,5370
ATSVUBE2115N1,Aaron Madden,20130306,26,4.538461538461538,30.307692307692307,17,8,9
ATUF77IHIKA08,Bahadur Mehmut Shah,20111106,21,2.9523809523809526,98.85714285714286,7,80,-73
ATUW4B272XLDH,wade,20140128,23,4.6521739130434785,40.34782608695652,7,1,6
ATW0Z57E2G30I,agnostic,20081122,24,4.625,91.54166666666667,99,19,80
ATWTKK5MU6RCI,M. Lo,20070402,38,3.6315789473684212,162.57894736842104,171,32,139
ATXRV6Z3N08ZX,Buckeye_Knight,20050823,37,4.108108108108108,290.0810810810811,278,27,251
ATY86XH2DJ4ZH,"Thomman ""gadgetfreak""",20070223,31,4.161290322580645,260.51612903225805,157,5,152
ATYA5H6H9J43F,AndThen,20120331,21,2.4285714285714284,154.0,35,12,23
ATYABHSTWNASF,"Solaris ""SUN""",20080521,25,4.52,83.76,30,8,22
ATYUQROTHLNYV,Laurel,20081115,38,4.2631578947368425,245.60526315789474,95,20,75
ATZJNEXX7LWD3,RG,20070918,70,3.5142857142857142,225.31428571428572,357,68,289
ATZOZEZJ831UB,trianj,20060810,23,4.521739130434782,73.0,12,3,9
AU11R9QF65EH3,,20120808,45,4.844444444444444,57.44444444444444,6,1,5
AU1EU8PNIOMXE,Dustin Kirkland,20131017,21,3.4761904761904763,35.57142857142857,27,9,18
AU1SKSAF00JJH,"J. Villeneuve ""jayvil""",20040719,40,4.25,204.1,232,29,203
AU1XYVSTA5PKW,howie,20110818,41,4.146341463414634,322.6829268292683,60,24,36
AU23IVEPBNZ4J,Skeitz,20130205,24,4.375,51.875,9,0,9
AU2UJF4I7KAWL,Braedon Freeland,20130714,49,4.26530612244898,40.08163265306123,4,2,2
AU3GYRAKBUAEU,Jon Norris,20040131,71,3.6056338028169015,382.7887323943662,912,206,706
AU4H7OG5UFDWO,"S. Gould ""gouldpjaks""",20021202,37,4.72972972972973,187.94594594594594,283,27,256
AU5U16YWAIYZP,Grant Brummett,20070116,37,4.621621621621622,1034.5945945945946,2754,183,2571
AU627A4UGIW6V,A. Gray,20020222,51,4.647058823529412,66.86274509803921,67,15,52
AU6JOR8JFYX1B,glass worker (hobby) guy,20121223,30,3.7666666666666666,40.1,13,7,6
AU90FZYTYG0FT,R. Ding,20070204,34,3.5588235294117645,589.2058823529412,393,159,234
AUB7W10GTWXF2,Nehal,20130131,28,4.285714285714286,49.785714285714285,6,4,2
AUBEFRFHJR64Y,SpeedingCheetah,20111009,82,3.9390243902439024,241.96341463414635,137,30,107
AUCIFMWP3DU8R,"R.S. Eisenberg ""Keeping it real since 1959""",20050719,65,3.9384615384615387,583.6923076923077,436,131,305
AUCISQA1YXX86,Confederate,20040502,51,2.6862745098039214,171.49019607843138,431,200,231
AUEY946M1L939,"John L Murphy ""Fionnch""",20061209,41,4.2439024390243905,366.0975609756098,141,38,103
AUGXK02BJ3GP9,S. Goncalves,20081031,29,4.379310344827586,60.86206896551724,35,22,13
AUITG1DJ3QUGK,E. Swope,20000617,82,4.121951219512195,480.0731707317073,342,54,288
AUK79PXTAOJP9,~ Kyle,20130105,48,4.666666666666667,43.229166666666664,5,3,2
AUKQYNHAWG6MS,Matt,20110312,25,4.6,172.28,173,14,159
AUKZP25K3OBL0,Mike,20100210,22,3.5,291.45454545454544,123,23,100
AUL97F9VWBK28,Frank,20071027,25,3.12,162.96,54,13,41
AULFLNWJP1QXY,Technology Guy,20060211,38,3.8421052631578947,240.28947368421052,749,56,693
AUNN3E6VGZNM3,"Julien Pierre ""Software engineer and amateur ...",20040822,36,2.9166666666666665,219.44444444444446,361,82,279
AUNP9U4RGIWLK,"Solomon Parker ""Solomon Parker""",20130515,28,4.464285714285714,64.67857142857143,7,2,5
AUNRZPHDEICF5,"David D. ""David""",20110620,27,4.814814814814815,62.925925925925924,14,13,1
AUO6LM2FGB9CY,eagle,20100327,25,4.88,84.44,26,2,24
AUOL8284BYMV7,David C. Veeneman,20011219,37,4.243243243243243,157.16216216216216,537,27,510
AUPCERMZ6ASML,JK,20101226,32,4.78125,71.53125,6,4,2
AUQ4YLHHS478X,"Mark FL ""Mark""",20090909,21,4.380952380952381,73.0952380952381,21,13,8
AUQL0H1CVZR7F,Carlos Garcia CCS-400097,20110516,34,3.9705882352941178,218.3235294117647,23,7,16
AUS5X6IMFLJBD,RatherBeReading,20090712,35,4.3428571428571425,154.17142857142858,129,36,93
AUSROBWTBQ2FX,Bryan,20120203,33,4.454545454545454,77.63636363636364,7,1,6
AUU4G4TASZUWV,"Nikodem Leszek Blach ""Nik""",20100826,42,4.738095238095238,152.47619047619048,46,12,34
AUUQIXCA8CQDS,Jopfef,20111019,21,5.0,95.28571428571429,5,1,4
AUUV3XDYB16X5,J. Busse,20120312,45,4.644444444444445,99.4888888888889,42,11,31
AUVOMF6CMI4O6,Mark Edgerton,20120630,23,4.478260869565218,40.130434782608695,2,12,-10
AUW5XC67E9MIL,"Cold In Seattle ""Penny Pinching""",20101020,22,4.636363636363637,428.22727272727275,130,22,108
AUW7BQWNO0DL,Rolaids0,20120717,22,4.681818181818182,66.63636363636364,18,6,12
AUWS4WEQ3GS53,Bill Staley,20040926,35,4.114285714285714,296.3142857142857,150,25,125
AUX9KZUUB3YCE,R. Nicholson,20021222,32,4.4375,310.0625,248,47,201
AUXE4JH175DZG,fasty buyers,20120617,24,3.7916666666666665,60.291666666666664,14,7,7
AUXG2XAHOMG22,Carol Wright,20130105,25,4.72,30.84,6,4,2
AUYAZMEO659OX,,20100722,38,4.342105263157895,88.92105263157895,10,1,9
AV0AKS7CENFOC,Mike in Texas,20120705,33,4.454545454545454,34.45454545454545,13,0,13
AV10H5K6VPQIJ,Ty,20120428,68,4.470588235294118,45.455882352941174,20,4,16
AV1F8VNJPLPTL,S. Smerud,20061211,33,3.878787878787879,151.24242424242425,58,31,27
AV1KOP8BCYZUJ,Mindcontrol,20100809,40,4.0,122.975,56,30,26
AV3E6XNTB4RV5,An Informed User,20090603,26,4.269230769230769,232.19230769230768,226,14,212
AV3XTMK5I2AWI,Canthespam,20060123,25,3.84,209.4,58,11,47
AV4XQWYQ3XLGD,Keith S. Napolitano,20080610,27,4.407407407407407,89.92592592592592,20,6,14
AV8MDYLHHTUOY,"Amazon Customer ""eyegor""",20030729,75,4.16,264.48,196,36,160
AV9PIER7NE448,T. Mccleary,20120925,52,4.865384615384615,152.17307692307693,144,27,117
AVAO6W0PEKK5X,James C.,20120611,27,4.592592592592593,104.22222222222223,17,8,9
AVAW0HU8BXXKT,zemes,20061205,33,3.8181818181818183,730.1515151515151,715,147,568
AVBLGXSWRN666,S. Jentsch,20010928,68,3.8676470588235294,482.3970588235294,484,46,438
AVDI31PI1JXV,N. Wilson,20091110,26,4.538461538461538,88.65384615384616,29,7,22
AVDW3OAVWWE05,Skyeye,20121123,21,4.476190476190476,76.28571428571429,29,3,26
AVFB9B931P1CJ,"M. Denis Hill ""whidbeypix""",20071124,42,4.5,139.5952380952381,77,9,68
AVFIQ58VHSFZH,Robert Warren,20060314,21,4.285714285714286,80.42857142857143,31,8,23
AVFJ327UXPXLF,"Jerry Helsing ""jlhelsing""",20070809,99,4.222222222222222,133.41414141414143,299,113,186
AVHN134ADVP4R,"A4Q96 ""Gadget Lover""",20090121,43,3.7674418604651163,119.6046511627907,83,12,71
AVJ6URCLNJQD2,Marc Strand,20110429,36,4.722222222222222,185.22222222222223,31,5,26
AVJJ2D4G5I0Z4,"Michael A. Behr ""mabehr""",20010629,27,3.6666666666666665,363.55555555555554,1075,98,977
AVJORH3ACR2A5,L. Gonzalez,20090227,54,4.666666666666667,28.425925925925927,13,37,-24
AVKXWBBVR4F8L,R. McLaughlin,20030302,25,3.44,145.32,149,76,73
AVL03EBQWSS0L,raaaaaa,20111214,26,3.3461538461538463,68.57692307692308,29,25,4
AVM6S1XR1YF4F,Ian Rushton,20080322,33,4.363636363636363,180.57575757575756,57,17,40
AVN4VRHONN7Y1,GO,20130226,25,4.6,95.32,12,4,8
AVNFTKAZDYM15,"K. alsanea ""Kliffy""",20070202,21,4.428571428571429,87.71428571428571,112,21,91
AVOFQL8D5NLUO,Macy Banton,20080313,25,4.56,194.12,90,2,88
AVOOU49YPVHGN,"K.G. ""Bulldog""",20100505,24,4.75,106.16666666666667,12,1,11
AVP1NL6GYMVR,RDSWY4,20080324,30,4.433333333333334,108.33333333333333,29,11,18
AVP67UR7LTCDN,Tom H Texas,20080512,24,4.375,92.125,20,3,17
AVPIWQ1RDOIUA,Ben Campbell,20070708,22,4.7727272727272725,128.86363636363637,52,33,19
AVPNQUVZWMDSX,"esanta ""esanta""",20040912,201,4.248756218905473,316.2636815920398,2155,231,1924
AVQVDSVXPCX2L,"Tobias Morgan ""Mr. Photo""",20091007,24,4.0,59.916666666666664,15,14,1
AVR7IAWO7Z0VQ,"E. Bryant ""Astro""",20100418,22,4.363636363636363,173.45454545454547,18,10,8
AVRV5S5L7MJNC,Maynez,20101130,22,4.5,32.86363636363637,2,4,-2
AVSD11L7NZG3I,Jay C.,20070525,23,4.521739130434782,88.43478260869566,30,9,21
AVSMRPI23DQI2,"HomerKSA ""Homer KSA""",20040310,66,4.46969696969697,217.54545454545453,247,110,137
AVTJEWTCJ3PBE,D. Henry,20100504,50,4.64,91.18,47,8,39
AVTLHLAY60BVA,subcell,20110414,28,4.035714285714286,128.14285714285714,25,1,24
AVU1ILDDYW301,G. Hearn,20080916,57,4.052631578947368,238.859649122807,200,63,137
AVUZM7BPEDA8A,Bruce Meyer,20131221,21,4.190476190476191,47.76190476190476,3,1,2
AVV7UXTHR0NWS,Robert Duncanson,20130227,39,3.923076923076923,117.64102564102564,7,6,1
AVXC6UHG42PPW,RafMan,20121206,27,4.62962962962963,104.55555555555556,9,6,3
AVXGN90BU95P8,"D. Buxman ""A Seeker of Truth""",20070803,31,4.548387096774194,85.64516129032258,55,35,20
AVXRBRRC1XXRE,Wolf I. Butler,20090812,25,4.32,303.88,177,13,164
AVYLD30R3GH5F,Kevin Williamson,20111002,24,3.6666666666666665,43.75,40,19,21
AW07NZ2EGA8PP,"Amazon Customer ""Just Jim""",20090413,41,3.5365853658536586,249.41463414634146,189,35,154
AW12F6FJ99WCV,Lalie,20110424,25,4.44,60.32,1,8,-7
AW3LX47IHPFRL,"Lologuy ""cracked PDA""",20070207,42,3.5714285714285716,217.16666666666666,113,88,25
AW3NHCEPDUHQQ,Software Maniac,20050330,22,4.318181818181818,72.36363636363636,69,19,50
AW3VZ5O895LRK,"carol irvin ""carol irvin""",20020203,34,4.264705882352941,220.88235294117646,179,26,153
AW45Y6HRFWI7J,Jimmie D. Ratliff II,20130421,22,4.636363636363637,44.36363636363637,11,1,10
AW4GC20Q3F1ZA,K. Rule,20020708,30,3.433333333333333,281.8666666666667,519,49,470
AW5JSQCHC2ZJO,Basil MacDougal,20080314,78,4.243589743589744,138.67948717948718,107,31,76
AW63IRQWH10GF,D. Snow,20081105,42,4.023809523809524,133.5952380952381,313,109,204
AW68KVDV7BBRS,"Joseph A. Nowak ""Prophotoman""",20040825,59,4.338983050847458,185.5593220338983,323,101,222
AW6A4PPENVZY3,"Li ""Amazon-Aholic""",20101213,64,4.375,79.8125,59,18,41
AW6FQE5QRF2LM,Tim Wachter,20120306,49,4.73469387755102,298.2040816326531,101,14,87
AW6J9IILGOZY3,Katawampas,20080305,71,4.309859154929577,258.16901408450707,236,42,194
AW73E7O2OTR2K,ThomasH,20061025,25,2.92,350.44,384,84,300
AW7BIYHXUIZ62,T.M. Reader,20110223,24,4.541666666666667,212.75,42,9,33
AW802ECRRLOSK,TBKHomeworld,20111231,25,4.52,107.56,44,8,36
AW8ESDU0C82O0,Cushman,20120608,22,4.045454545454546,27.954545454545453,3,7,-4
AW8UBYMNJ894V,"Cognizant Consumer ""C Campbell""",20080210,36,4.055555555555555,60.0,24,8,16
AWA3U2TAU0KYP,"Solom01 ""software user""",20110708,42,4.309523809523809,195.97619047619048,327,25,302
AWADEE8PYYO14,Janice R,20121130,21,4.9523809523809526,76.0,15,4,11
AWAGXL3EQM8NC,"D. Byrd ""cool cat""",20061205,24,4.416666666666667,73.70833333333333,44,8,36
AWB00UIW85BNV,Ahmed ghazzawi,20100808,25,4.0,56.92,28,19,9
AWBKHL9Z878SZ,Barcheck55,20121003,32,5.0,124.28125,15,10,5
AWBZAHKAN64CO,Thomas E. Curley,20080116,38,4.552631578947368,91.84210526315789,35,8,27
AWC8CTW8N2XVE,AWGamer11,20050418,41,4.7560975609756095,134.8780487804878,130,34,96
AWC97DS45VZA6,sean,20120305,30,3.8666666666666667,75.06666666666666,7,1,6
AWCJ12KBO5VII,Michael L. Knapp,20020606,33,4.424242424242424,131.36363636363637,49,43,6
AWDBH9MP36XYL,Gods. Work,20081127,25,4.56,159.24,67,50,17
AWFYD0JLWL6DG,Theresa,20121128,24,4.583333333333333,128.875,45,6,39
AWH2AY17ZU7W2,Jesse Baynard,20050903,69,4.260869565217392,325.8840579710145,784,63,721
AWHL379EE14K7,C. Pilot,20060216,53,4.547169811320755,161.32075471698113,72,13,59
AWIBPH03KPBHV,papajuan,20070207,38,3.710526315789474,73.63157894736842,166,17,149
AWIF8AR75LL9L,"Colorgirl ""Spreading color around my world""",20100617,23,4.434782608695652,480.4782608695652,107,15,92
AWJWCKB92RJX2,"Amazon Customer ""nopcbs""",20040829,52,3.9038461538461537,172.3846153846154,405,64,341
AWKF8G9RNSEWY,"R. Kanno ""rk4runner""",20110312,21,4.809523809523809,60.285714285714285,7,0,7
AWKTEWROKTL0L,"Amazon Customer ""Jer""",20100619,28,4.285714285714286,87.28571428571429,19,6,13
AWNBZSEZ9P8BE,Brian Connors,20090526,48,3.8958333333333335,355.125,124,64,60
AWNFFBJ6J1PSW,Robert,20070514,23,3.739130434782609,273.2608695652174,258,28,230
AWNJAY0M5UI70,ANK2,20101128,89,4.808988764044944,34.38202247191011,15,15,0
AWNWOMUT9HS2D,"J. Snavely ""jellybiscuit""",20051216,25,3.72,114.76,70,16,54
AWOIBT6VTHAO6,tartantyger,20090929,34,4.647058823529412,163.23529411764707,80,11,69
AWP1WU0NXZAEA,Bento Pereira,20110309,27,3.6666666666666665,175.62962962962962,52,33,19
AWPN47SSWK1JV,K. Nordhus,20080918,49,4.3061224489795915,57.97959183673469,76,26,50
AWPODHOB4GFWL,"Martin A Hogan ""Marty From SF""",20011220,260,4.403846153846154,250.98461538461538,2148,229,1919
AWPOWZJNQ2PHH,Brian McGrath the Carny,20120628,23,2.347826086956522,235.8695652173913,271,2855,-2584
AWQ28Q6L7K78X,Thomas Simmons,20110201,29,4.206896551724138,77.34482758620689,38,5,33
AWQY7V6872WNY,Alex King,20131220,38,4.394736842105263,61.8421052631579,9,17,-8
AWR1XFLN3HSYQ,Uncle Dale,20070514,25,4.04,57.56,9,3,6
AWRL9S3NFMQUG,Uncle J,20060116,35,4.057142857142857,426.2857142857143,761,111,650
AWSK1ZAEU1KFL,"Dale in Tenn ""Dale""",20100824,59,4.1525423728813555,81.11864406779661,93,34,59
AWTOK5EK2M1BF,"D-DUB ""Davids_in_Carolina""",20050428,32,4.09375,124.53125,343,64,279
AWUQ43W80B8ED,Tastinient,20071108,22,3.8181818181818183,180.27272727272728,104,14,90
AWUQVRX05ZBEI,SteveG,20101101,23,4.608695652173913,89.56521739130434,53,7,46
AWV2Z3QGCXBSS,albert,20130805,25,4.76,46.88,25,6,19
AWVBZUFM6E7DW,"Hyjanks ""Hyjanks""",20071228,21,4.0476190476190474,225.28571428571428,53,24,29
AWW5AOW8G0YBA,"Octavio Nio ""oaninor""",20080209,21,4.190476190476191,211.8095238095238,5,3,2
AWWBWAEQ8UUO0,Capcyclone,20130215,21,4.476190476190476,78.33333333333333,5,2,3
AWWXG1AHVW98O,"Loren K. Allston ""twin66az""",20110603,25,4.68,44.88,10,3,7
AWY4LMNAC9DWZ,ChrisMac12,20110207,22,3.8636363636363638,95.0,17,1,16
AWZR0O65DL2Q,Nameless Faceless User,20030202,52,4.25,352.0,821,66,755
AX05DBU8IRUWY,C. Schmidt,20110612,77,4.194805194805195,304.05194805194805,436,49,387
AX0WUHFVBIENH,"John Reitmeier ""John Reitmeier""",20080224,30,4.2,46.8,22,6,16
AX1Z5RQ1LWMM2,j-rob-82,20080607,29,4.413793103448276,290.62068965517244,183,34,149
AX27RYM65B3GI,TheTechGuy,20130128,35,3.3714285714285714,85.74285714285715,12,5,7
AX2KWKARYETJQ,Jim Twin,20080118,29,3.9310344827586206,79.44827586206897,24,4,20
AX39FFRXVUWMI,stepCHIILD &#34;Ryan&#34;,20111207,31,4.483870967741935,108.87096774193549,38,17,21
AX4DLEBHS9XEL,"Michael T. McCaffrey ""sumofan""",20080305,21,4.714285714285714,260.0,489,41,448
AX4EJPMBBNP90,T.S. Ward,20060927,24,4.25,137.75,58,18,40
AX4IT87INWPV,Sriram Chandrasekaran,20090526,23,4.304347826086956,66.69565217391305,29,11,18
AX4OUOYP645H8,Kyle Shell,20090704,35,3.6857142857142855,68.08571428571429,51,11,40
AX6EDFRUIIB26,"Dr. Dave ""Dr. Dave""",20120805,28,4.678571428571429,41.107142857142854,8,11,-3
AX6XVLRQFX2N1,Greg,20130408,21,4.904761904761905,161.14285714285714,9,4,5
AX7317G153T8W,"P. Colin McGraw ""AV, Computer & EnviroTech Nut""",20071129,105,4.3428571428571425,259.6190476190476,2075,174,1901
AX992WXG50MIK,Kuk,20030606,23,4.826086956521739,221.34782608695653,111,6,105
AX9DNX8UDPOUF,"Alex ""Alex""",20120808,25,2.92,61.56,4,2,2
AXAJXJZUL2J5P,D. Scott,20100303,43,4.209302325581396,306.06976744186045,113,31,82
AXARTAQU05PFL,"K. Hudson ""Technical writer""",20070107,29,4.0344827586206895,154.79310344827587,132,26,106
AXC02IGKBDL1Z,W A R,20140221,27,4.925925925925926,81.14814814814815,4,1,3
AXDJBA1LYQ4RR,chris,20130502,29,3.7586206896551726,103.86206896551724,18,5,13
AXFINZCCNA8NV,Widely Read,20121127,23,3.869565217391304,164.04347826086956,15,26,-11
AXFO241GZ4BYK,"M. Cheung ""mcmom213""",20070924,23,4.304347826086956,192.7391304347826,77,9,68
AXGLPF6X39874,John,20090504,22,4.636363636363637,67.77272727272727,10,1,9
AXHVINNKPBCFQ,J. Phillips,20121228,21,4.761904761904762,24.666666666666668,2,4,-2
AXI9CMCBP9FCD,Stephanie,20121119,21,4.238095238095238,49.714285714285715,8,7,1
AXIIG2W0PKN8P,Steve Danke,20120710,28,4.392857142857143,101.75,14,9,5
AXJ529STIZPYJ,Ben,20110817,21,3.9047619047619047,45.142857142857146,16,4,12
AXKOFQ3C2H0L1,"Todd Medema ""Entrepreneur, photographer, tech...",20101003,43,4.0,127.69767441860465,56,6,50
AXL5GGD8MPGWE,J. D. Rohne,20110907,32,4.53125,36.1875,11,3,8
AXM3B9IWNGPGI,xpolarbearx,20061027,21,4.714285714285714,181.71428571428572,76,4,72
AXMPNTJU89DYS,"The Electroacoustic Metallurgist ""Bill""",20130815,22,4.7272727272727275,259.04545454545456,21,5,16
AXNBI9L5LHH6X,"J. Cihak ""johncihak""",20021204,27,2.925925925925926,128.5185185185185,208,167,41
AXO4PQU0XG3TG,,20060704,36,3.5555555555555554,178.16666666666666,152,56,96
AXOY9UHP9HJNX,Shawn Castle,20121030,21,4.857142857142857,59.904761904761905,0,1,-1
AXP5593BSQTHR,David G. Martin,20080425,21,4.761904761904762,135.42857142857142,11,1,10
AXP7888CP2222,RTX,20120220,21,3.9047619047619047,50.57142857142857,3,5,-2
AXP8GO5Q3AXSA,Michael J. Descy,20050223,63,4.158730158730159,255.12698412698413,1287,151,1136
AXP9CF1UTFRSU,tada,20120317,24,4.5,45.416666666666664,5,0,5
AXPAIEE0732A9,Amazon Customer,20120412,39,3.5641025641025643,113.23076923076923,23,9,14
AXPI2DDXXLSYF,Brian H.,20100205,24,4.708333333333333,45.458333333333336,12,8,4
AXQJG7M1ARMKR,Rob,20130529,25,4.76,60.96,6,3,3
AXQORTTMV7YZA,LR,20120302,21,4.666666666666667,94.61904761904762,5,1,4
AXR3CV6A4FMBG,"McBean ""BJMcBean""",20070731,52,4.134615384615385,195.76923076923077,114,24,90
AXR9PC2II8UCB,"RC ""ZenSavage""",20120914,25,4.64,134.72,4,2,2
AXSA8A06M0PR0,"DelKar ""DelKar""",20120728,24,4.791666666666667,57.041666666666664,6,1,5
AXU3VKZE848IY,Chris Zee Shutterbug,20050414,75,3.8933333333333335,456.8666666666667,1532,145,1387
AXU8RH1DEV21H,"John Piquette ""John P""",20081222,46,4.869565217391305,57.391304347826086,23,8,15
AXUJFOFQZNTN,J. Tant,20130129,26,4.346153846153846,487.03846153846155,201,39,162
AXUM7P0TGMPL9,Joshua-1,20120523,21,4.238095238095238,84.66666666666667,55,3,52
AXVKMYWNIHK7W,"Terri ""3kids-at-home""",20100525,27,4.592592592592593,82.07407407407408,13,17,-4
AXWB93VKVML6K,Michael Hassey,20111201,27,4.481481481481482,71.55555555555556,27,2,25
AXWFTQDX24GB8,"Andrew A. Hughes ""Masqueman""",20080609,23,4.6521739130434785,103.56521739130434,16,6,10
AXYM52DNK6NDF,"Zachary Long ""Wedding Photographer""",20100305,62,4.451612903225806,172.30645161290323,207,27,180
AY1NUCXXJ5WD5,Hummingbirds,20051211,26,3.8461538461538463,181.92307692307693,252,26,226
AY20S8XS9799P,"Celeste Thoms ""Moviemaker330""",20050816,41,3.6097560975609757,162.2439024390244,48,18,30
AY2MHRRWC2M8X,"Christopher OConnor ""GC Photographers""",20071013,24,4.541666666666667,42.166666666666664,22,46,-24
AY3D7DG5L5WCK,"Edward Walker ""ednpatty""",20080921,65,4.553846153846154,119.0923076923077,44,25,19
AY3L8YBX9ET2X,"Mr. V ""excitingphoto .net""",20100105,24,4.416666666666667,82.375,51,8,43
AY3XPKRAMKKY7,C. G. King,20080717,44,4.340909090909091,414.95454545454544,499,30,469
AY40BONSSV2NF,Donald Owens,20121228,32,4.71875,30.75,8,3,5
AY417SGF5G5QZ,Hi-Tek,20080509,26,4.0,122.38461538461539,134,28,106
AY49JOXTLDOG2,Jeff,20060925,30,4.466666666666667,199.93333333333334,185,28,157
AY4EXFOO43C3S,"David Bradford ""David""",20070514,40,3.775,145.05,82,100,-18
AY4WE4ONB6HPR,Scott Rubin,20100526,23,4.391304347826087,117.56521739130434,32,13,19
AY5IL05TZPIZO,Hyun Yu,20040915,34,4.205882352941177,327.88235294117646,3448,77,3371
AY6A8KPYCE6B0,Tyson,20060928,111,4.045045045045045,280.6756756756757,286,86,200
AY6VXIWYGNATL,peanut,20110909,21,4.904761904761905,31.0,3,0,3
AY78J15EYR2EM,Philip G. Ruffolo,20140120,23,5.0,77.47826086956522,8,1,7
AY7A86YCLB6WR,"Bradley J. Thomas ""CHEMLIGHT""",20111229,24,3.9583333333333335,73.29166666666667,15,28,-13
AY7H713DX8AF,Marron,20100403,24,3.625,72.58333333333333,389,45,344
AY8RR5LJIYM8C,Rick Lobrecht,20080325,27,4.111111111111111,180.77777777777777,22,14,8
AY8S0ZSMVGYBG,Jore,20090222,26,4.461538461538462,164.73076923076923,79,5,74
AY91MQZZR750W,MichiganTraveler,20020902,37,3.945945945945946,97.97297297297297,118,19,99
AYA2I8YZTWWUE,Average Joe,20090208,25,4.2,137.52,52,7,45
AYAIWRR7Z6G4K,"Justin Seiferth ""Me""",20071030,22,3.1363636363636362,261.8181818181818,129,45,84
AYB4ELCS5AM8P,"John B. Goode ""JBG""",20081011,147,4.761904761904762,190.55102040816325,331,22,309
AYB8XLKTYMTTX,Beldini,20090225,23,4.304347826086956,179.6086956521739,60,11,49
AYC2EHUX63SP5,Rozanne Paxman,20121220,25,4.16,65.56,10,2,8
AYCAIHABPYWVJ,Ryuji Suzuki,20070301,35,4.0,256.62857142857143,550,48,502
AYCSG04ZCIU78,Peter Spaker,20111114,42,4.261904761904762,175.6904761904762,113,14,99
AYDP2ZB16KVB1,Josephdalepi,20130828,35,4.857142857142857,41.0,4,4,0
AYDQDYHNOZFR,Sevenhellz,20111118,27,4.0,79.11111111111111,23,15,8
AYENHM64A87Z7,Amazon Customer,20101013,31,4.903225806451613,211.41935483870967,113,7,106
AYFCMX6EMIPKE,Scott,20021231,24,4.25,125.625,84,44,40
AYG4VHP4V6VTM,Adobe Master,20080924,26,3.269230769230769,177.30769230769232,220,277,-57
AYGDY7QQHFQCY,William R. Hale,20100602,23,4.086956521739131,60.73913043478261,33,7,26
AYGEKID3G7DPW,Mat Van Gogh,20090909,41,3.6341463414634148,49.58536585365854,16,5,11
AYGEP8I4BQ3CK,choiceweb0pen0,20051028,23,3.6956521739130435,182.43478260869566,41,7,34
AYHN7ZQXLTJYS,Daniel Nguyen,20121226,33,3.5757575757575757,44.36363636363637,68,77,-9
AYINNKPX9D60N,Luc S,20100915,36,4.277777777777778,112.75,28,3,25
AYIYDQVHCFUFU,"JesusChrysler ""Brian__Buffalo""",20100123,22,4.7272727272727275,59.18181818181818,32,38,-6
AYL3CH1Y1DOB8,R. Asphaug,20050216,30,4.133333333333334,116.06666666666666,18,4,14
AYLCZ4EEZDMS4,chughe17,20120204,21,3.761904761904762,125.80952380952381,6,8,-2
AYLLSFYS3UP1H,gadget-o-holic,20120412,84,4.369047619047619,267.0,431,69,362
AYMD77ITD15PT,G. Ware,20010620,84,4.25,283.4047619047619,560,120,440
AYMK3MK7B903W,"A. C. Lima ""NAGUAL MD""",20070109,21,4.142857142857143,36.38095238095238,27,23,4
AYMYSI7ZL1XGS,"Randy Rathbun ""total nerd""",20021127,25,4.16,172.48,228,42,186
AYNAH993VDECT,bsg2004,20051206,77,4.285714285714286,525.961038961039,320,31,289
AYNRALJ4X1COS,Jon,20080324,40,4.0,129.7,45,27,18
AYO1146CBIV5C,Michael Yovkovich,20091019,60,4.433333333333334,189.01666666666668,82,21,61
AYOMAHLWRQHUG,Conspicuous Consumer,20040124,58,4.293103448275862,155.79310344827587,166,52,114
AYOTEJ617O60K,M. Krawitz,20090208,58,3.9482758620689653,78.98275862068965,17,16,1
AYP0YPLSP9ISM,Mathew T. Jordan,20120626,50,3.64,68.04,35,57,-22
AYPIF2S8P3RZT,Vyshtia,20051128,27,4.111111111111111,396.81481481481484,222,24,198
AYQ14XGJODM9J,Phoenixreview,20120519,24,4.708333333333333,36.0,4,4,0
AYQTCN95JY375,"Discriminating Buyer in Colorado ""Picky Picky...",20090122,24,3.75,158.04166666666666,68,24,44
AYRAS2X1L4WNY,M. Y. &#34;Photographer | Outdoor Enthusiast ...,20111126,37,4.027027027027027,459.2162162162162,175,11,164
AYS4UGU2YB0W4,Dennis Meek,20090716,49,4.551020408163265,227.40816326530611,215,32,183
AYTSQHF8MK44T,"Amazonian ""over the top""",20050728,29,4.482758620689655,321.6896551724138,433,40,393
AYUF7YETYOLNX,"Bryan Newman ""alaskanoutfitting.com""",20070926,48,4.416666666666667,301.7916666666667,124,20,104
AYVH38IWDR7B5,jw.hunter,20110302,25,3.44,76.64,11,14,-3
AYVW3O6W8S5S4,Johnny in Texas,20120216,40,3.975,102.45,24,9,15
AYW1TGDCP2OK6,MestaySS,20040722,21,4.571428571428571,208.42857142857142,354,32,322
AYW6DSYOKEO75,Patrick Matthews,20080501,21,4.904761904761905,43.61904761904762,27,1,26
AYWEI2JCRRJS8,"PatDis ""thewizzard""",20080303,29,4.620689655172414,149.31034482758622,22,39,-17
AYWIO6OYAGFGQ,"pm444 ""pm444""",19991229,27,4.407407407407407,401.1111111111111,814,35,779
AYXG0RN1CK0JA,Philey,20110811,21,3.8095238095238093,25.571428571428573,1,0,1
AYXL9PP6J3KA5,"Gene ""Gene""",20100315,22,4.0,82.5909090909091,28,8,20
AYZWH0EYHFTPG,JC,20120829,26,4.5,41.76923076923077,2,0,2
AZ0PCEZUTF5QO,"L. Berk ""Leah Lionheart""",20100218,42,4.190476190476191,182.26190476190476,79,25,54
AZ0SIZRQWN7RC,Amazonian,20041218,24,3.7083333333333335,264.75,358,40,318
AZ1ESO3H69NGR,Payerman54,20060319,24,4.291666666666667,75.79166666666667,31,27,4
AZ1P0VITRUJSY,BG,20080809,33,4.575757575757576,101.63636363636364,70,20,50
AZ2X2P045ZFH2,Tony,20121010,27,4.555555555555555,47.629629629629626,5,2,3
AZ34737QMSG8Q,"Ovieda Estrada ""Insight Seeker""",20110525,33,4.454545454545454,87.75757575757575,19,3,16
AZ4352XO4HH3M,Vee,20020622,39,3.769230769230769,232.30769230769232,332,21,311
AZ4EUUJVC8358,Kasia,20091217,32,4.15625,118.96875,192,20,172
AZ515FFZ7I2P7,Jerry Jackson Jr.,20020514,127,4.2047244094488185,274.2755905511811,1536,179,1357
AZ5A2S8UZ7RTL,Martin Smith,20120106,21,4.904761904761905,42.666666666666664,6,1,5
AZ61VB6SPTQWJ,G. Wolff,20070512,23,4.739130434782608,127.34782608695652,37,1,36
AZ6IH1XQZUTXM,J. Hault,20100402,21,4.0476190476190474,57.23809523809524,12,1,11
AZ714J2PAECSR,Dan T. L.,20110825,22,4.318181818181818,73.77272727272727,15,5,10
AZ7N0TLPDP156,"Radiskull ""Radiskull""",20080320,23,4.391304347826087,158.43478260869566,50,23,27
AZ80YRGIMCFQO,J. Sims,20101202,24,4.75,59.416666666666664,4,1,3
AZ8XSDMIX04VJ,"Lee ""07 Dyna Low Rider""",20020219,48,4.8125,171.72916666666666,148,4,144
AZA595ZPIG240,"Parker Knight ""Photo Geek""",20080827,45,4.822222222222222,97.82222222222222,60,31,29
AZAC3IORB10GD,"HP ""HP""",20100923,21,4.428571428571429,110.85714285714286,14,4,10
AZAC8O310IK4E,Hoppaguy,20061224,100,4.33,121.15,179,36,143
AZBXKUH4AIW3X,"Thomas Jefferson ""Independence Forever""",20130414,47,3.893617021276596,60.787234042553195,12,7,5
AZC56FKV07IOU,Gift,20101230,22,4.136363636363637,72.9090909090909,25,15,10
AZCE11PSTCH1L,yoyo,20110420,49,4.510204081632653,35.59183673469388,18,41,-23
AZCOE68N2HOCZ,zo1o,20101211,35,4.628571428571429,42.4,6,3,3
AZD8SMNGQI98O,"Daring Di ""Loves The Written Word""",20100607,31,4.870967741935484,58.483870967741936,16,16,0
AZE2ZP618W1EP,tall-latte,20060501,43,3.7906976744186047,220.74418604651163,121,44,77
AZFF4CX9MQ4AE,mrd,20120821,41,4.902439024390244,32.146341463414636,4,4,0
AZG6CV3B3279V,Christian,20130605,39,4.82051282051282,73.43589743589743,2,2,0
AZGGG49I1J5E5,Lots of Purchases,20130730,30,4.066666666666666,36.833333333333336,10,6,4
AZHGPE0NPPQVT,H.Neuman,20071226,23,4.6521739130434785,45.95652173913044,5,4,1
AZIMOGTBT3LPP,Chris Swiontek,20111204,24,4.125,116.29166666666667,42,8,34
AZJJX3JB5L490,"Student of Wisdom ""AbdulHakeem""",20120609,21,4.523809523809524,82.85714285714286,2,7,-5
AZJN0GTY8SK71,Captain Reynolds,20110411,26,5.0,100.73076923076923,22,0,22
AZKDLBTHU2BVZ,"Tony ""Tech Guru""",20080507,26,3.730769230769231,99.61538461538461,41,4,37
AZLWQV9SEZ1SS,KG,20110330,23,5.0,38.47826086956522,13,5,8
AZMY6E8B52L2T,"JP ""J.P.""",20111227,161,4.695652173913044,259.0372670807453,231,18,213
AZNUHQSHZHSUE,Corky,20031206,44,4.2272727272727275,143.0,100,20,80
AZNUNL2GIX0AP,"Kota ""Kota""",20110202,25,4.44,29.64,26,6,20
AZOK5STV85FBJ,"Kaelan ""frontier_ranger""",20090131,39,4.82051282051282,85.71794871794872,27,2,25
AZPOUCM043IY8,M. Koll,20130621,28,4.107142857142857,41.464285714285715,11,9,2
AZPZROZJIKBE8,D. Meulen,20111120,32,4.53125,57.09375,6,4,2
AZQGJ5CEAJGXB,"L. Coleman ""Geek Girl""",20091101,44,4.136363636363637,254.79545454545453,279,33,246
AZS0Q5ILAQBBR,Detroit4ever,20100914,31,4.161290322580645,95.93548387096774,53,11,42
AZSH7IFNZR62F,alex,20110718,21,3.0952380952380953,116.33333333333333,49,23,26
AZU2Z1Y81YR0T,"R. Whitaker ""The Rajah""",20090416,28,4.821428571428571,51.357142857142854,35,2,33
AZV2U6GU5QA6C,Stephen R. Walker,20110327,43,4.534883720930233,31.74418604651163,28,21,7
AZW7PDA9PBDO,"Cal Man ""Cal Man""",20041127,22,3.727272727272727,155.22727272727272,48,25,23
AZWQEM8GKXQ5Y,Enrique,20100712,33,4.7272727272727275,60.666666666666664,2,0,2
AZXFS8GCTSQ5R,NF,20040621,22,3.090909090909091,421.90909090909093,52,9,43
AZXQ0WME7X6UT,Richard Franks,20100501,23,3.782608695652174,81.1304347826087,116,35,81
AZXS6P5QWNMLC,Joe The Ox,20110222,25,4.28,85.72,6,2,4
AZYBZEVISD0YX,Engr. Jay Mendoza,20120326,26,4.230769230769231,295.4230769230769,161,17,144
AZYJE40XW6MFG,"Alan Manning ""Gamairidium""",20071010,43,4.325581395348837,84.86046511627907,75,24,51
AZZ2DEE2NTIM7,Richard Kaplan,20040502,39,4.769230769230769,188.94871794871796,487,23,464
AZZ5ASC403N74,"Blue Rose ""Blue Rose""",20110816,25,3.84,129.56,24,7,17
AZZX23UGJGKTT,Jim D.,20121021,22,4.545454545454546,133.0909090909091,62,7,55
AZZYW4YOE1B6E,tmybrgr,20091229,32,4.46875,130.71875,26,2,24
